,Date,Age,Game Result,GS,MP,FG,FGA,FGcent,3P,3PA,3Pcent,FT,FTA,FTcent,ORB,DRB,TRB,AST,STL,BLK,TOV,PF,PTS,GmSc,PointDifference,Player,2P,2PA,2Pcent
0,10/19/2022,26.08219178082192,W,1,38.233333333333334,8,19,0.421,1,5,0.2,3,3,1.0,0,5,5,11,5,1,0,0,20,24.8,8.0,Dejounte Murray,7,14,0.5
1,10/21/2022,26.087671232876712,W,1,39.61666666666667,8,16,0.5,2,5,0.4,2,2,1.0,1,8,9,9,4,0,7,2,20,17.6,17.0,Dejounte Murray,6,11,0.5454545454545454
2,10/23/2022,26.09315068493151,L,1,38.8,7,15,0.467,2,4,0.5,3,3,1.0,1,7,8,5,1,1,4,2,19,14.5,-11.0,Dejounte Murray,5,11,0.45454545454545453
3,10/26/2022,26.101369863013698,W,1,39.31666666666667,5,18,0.278,2,6,0.333,2,4,0.5,2,6,8,8,2,2,2,2,14,12.0,4.0,Dejounte Murray,3,12,0.25
4,10/28/2022,26.106849315068494,W,1,32.38333333333333,12,21,0.571,2,6,0.333,0,0,,0,4,4,5,0,0,0,0,26,20.8,21.0,Dejounte Murray,10,15,0.6666666666666666
5,10/29/2022,26.10958904109589,L,1,34.266666666666666,9,19,0.474,3,5,0.6,0,0,,0,5,5,6,2,0,1,3,21,16.8,1.0,Dejounte Murray,6,14,0.42857142857142855
6,10/31/2022,26.115068493150684,L,1,30.516666666666666,7,15,0.467,2,4,0.5,4,4,1.0,0,4,4,9,0,0,4,3,20,14.6,-12.0,Dejounte Murray,5,11,0.45454545454545453
7,11/2/2022,26.12054794520548,W,1,38.1,14,27,0.519,5,12,0.417,3,3,1.0,0,4,4,9,5,1,3,1,36,32.5,26.0,Dejounte Murray,9,15,0.6
8,11/5/2022,26.12876712328767,W,1,41.78333333333333,9,23,0.391,1,8,0.125,3,4,0.75,2,8,10,11,3,0,2,3,22,20.4,21.0,Dejounte Murray,8,15,0.5333333333333333
9,11/7/2022,26.134246575342466,W,1,32.05,11,24,0.458,3,9,0.333,0,0,,2,6,8,11,3,0,3,1,25,23.1,4.0,Dejounte Murray,8,15,0.5333333333333333
10,11/9/2022,26.13972602739726,L,1,37.81666666666667,11,20,0.55,1,5,0.2,3,4,0.75,1,5,6,5,0,1,3,4,26,17.8,-7.0,Dejounte Murray,10,15,0.6666666666666666
11,11/10/2022,26.14246575342466,W,1,34.7,5,13,0.385,0,4,0.0,0,0,,0,3,3,8,2,0,2,1,10,9.0,-14.0,Dejounte Murray,5,9,0.5555555555555556
12,11/12/2022,26.147945205479452,L,1,38.31666666666667,9,23,0.391,1,4,0.25,4,4,1.0,3,5,8,7,2,0,0,1,23,20.6,-21.0,Dejounte Murray,8,19,0.42105263157894735
13,11/14/2022,26.153424657534245,W,1,36.016666666666666,6,14,0.429,1,4,0.25,6,7,0.857,0,8,8,5,0,0,1,2,19,15.3,6.0,Dejounte Murray,5,10,0.5
14,11/16/2022,26.15890410958904,L,1,33.71666666666667,9,17,0.529,1,3,0.333,0,0,,0,3,3,5,1,0,3,3,19,11.9,-24.0,Dejounte Murray,8,14,0.5714285714285714
15,11/19/2022,26.167123287671235,W,1,40.35,7,18,0.389,1,6,0.167,2,2,1.0,0,7,7,4,2,0,2,0,17,12.1,13.0,Dejounte Murray,6,12,0.5
16,11/21/2022,26.172602739726027,L,1,37.31666666666667,4,17,0.235,1,4,0.25,2,2,1.0,1,3,4,6,1,0,4,1,11,3.1,-6.0,Dejounte Murray,3,13,0.23076923076923078
17,11/23/2022,26.17808219178082,W,1,34.983333333333334,5,16,0.313,1,4,0.25,4,4,1.0,1,6,7,4,3,0,2,2,15,11.3,7.0,Dejounte Murray,4,12,0.3333333333333333
18,11/25/2022,26.183561643835617,L,1,35.65,14,24,0.583,8,13,0.615,3,3,1.0,0,3,3,3,2,0,3,2,39,29.0,-6.0,Dejounte Murray,6,11,0.5454545454545454
19,11/27/2022,26.18904109589041,L,1,38.81666666666667,5,16,0.313,2,8,0.25,1,2,0.5,0,5,5,2,1,0,2,0,13,5.3,-13.0,Dejounte Murray,3,8,0.375
20,10/19/2022,25.07123287671233,W,1,33.65,9,12,0.75,2,2,1.0,4,4,1.0,0,8,8,1,1,0,2,3,24,20.1,11.0,John Collins,7,10,0.7
21,10/21/2022,25.076712328767123,W,1,36.233333333333334,9,14,0.643,3,4,0.75,2,2,1.0,3,10,13,0,3,1,2,4,23,22.0,26.0,John Collins,6,10,0.6
22,10/23/2022,25.08219178082192,L,1,38.483333333333334,3,12,0.25,0,7,0.0,4,4,1.0,2,8,10,1,1,4,1,2,10,9.3,-11.0,John Collins,3,5,0.6
23,10/26/2022,25.09041095890411,W,1,35.9,9,14,0.643,0,1,0.0,1,1,1.0,1,10,11,0,1,4,4,4,19,14.7,5.0,John Collins,9,13,0.6923076923076923
24,10/28/2022,25.095890410958905,W,1,25.166666666666668,2,4,0.5,0,1,0.0,0,0,,0,10,10,1,1,3,2,3,4,5.6,9.0,John Collins,2,3,0.6666666666666666
25,10/29/2022,25.0986301369863,L,1,31.416666666666668,2,4,0.5,0,2,0.0,0,2,0.0,2,3,5,2,0,0,2,3,4,1.7,-5.0,John Collins,2,2,1.0
26,10/31/2022,25.104109589041094,L,1,29.616666666666667,5,12,0.417,1,6,0.167,1,1,1.0,3,9,12,1,0,0,0,6,12,8.7,-24.0,John Collins,4,6,0.6666666666666666
27,11/2/2022,25.10958904109589,W,1,30.9,4,10,0.4,0,2,0.0,4,4,1.0,5,8,13,2,1,1,2,3,12,12.4,14.0,John Collins,4,8,0.5
28,11/5/2022,25.117808219178084,W,1,35.86666666666667,3,6,0.5,1,2,0.5,0,0,,1,4,5,1,0,2,0,4,7,6.4,-2.0,John Collins,2,4,0.5
29,11/7/2022,25.123287671232877,W,1,23.516666666666666,5,10,0.5,1,2,0.5,3,3,1.0,0,2,2,0,0,1,1,1,14,8.9,6.0,John Collins,4,8,0.5
30,11/9/2022,25.12876712328767,L,1,28.266666666666666,6,8,0.75,1,1,1.0,2,2,1.0,1,3,4,3,0,0,0,2,15,14.7,19.0,John Collins,5,7,0.7142857142857143
31,11/10/2022,25.13150684931507,W,1,25.733333333333334,3,11,0.273,0,3,0.0,5,5,1.0,0,4,4,2,1,0,2,5,11,4.1,0.0,John Collins,3,8,0.375
32,11/12/2022,25.136986301369863,L,1,33.483333333333334,2,6,0.333,0,3,0.0,2,2,1.0,1,5,6,0,0,1,0,2,6,4.7,-22.0,John Collins,2,3,0.6666666666666666
33,11/14/2022,25.14246575342466,W,1,33.46666666666667,6,15,0.4,1,5,0.2,3,3,1.0,4,5,9,0,1,1,1,4,16,11.3,13.0,John Collins,5,10,0.5
34,11/16/2022,25.147945205479452,L,1,31.983333333333334,6,12,0.5,0,3,0.0,0,0,,0,3,3,0,0,3,2,0,12,7.0,-17.0,John Collins,6,9,0.6666666666666666
35,11/19/2022,25.156164383561645,W,1,34.0,2,4,0.5,1,3,0.333,4,5,0.8,0,11,11,4,1,0,4,6,9,7.3,10.0,John Collins,1,1,1.0
36,11/21/2022,25.161643835616438,L,1,33.916666666666664,5,9,0.556,3,5,0.6,3,3,1.0,1,0,1,2,2,1,2,5,16,12.5,-17.0,John Collins,2,4,0.5
37,11/23/2022,25.167123287671235,W,1,31.85,3,12,0.25,0,7,0.0,1,1,1.0,0,3,3,2,1,1,3,4,7,-0.8,3.0,John Collins,3,5,0.6
38,11/25/2022,25.172602739726027,L,1,33.733333333333334,2,7,0.286,0,4,0.0,4,5,0.8,0,5,5,1,2,2,0,2,8,8.3,-4.0,John Collins,2,3,0.6666666666666666
39,11/27/2022,25.17808219178082,L,1,36.56666666666667,11,17,0.647,1,4,0.25,0,0,,1,13,14,2,0,1,0,3,23,21.0,-4.0,John Collins,10,13,0.7692307692307693
40,10/19/2022,20.835616438356166,W,0,14.35,1,1,1.0,0,0,,3,4,0.75,0,1,1,0,0,0,1,2,5,2.8,-1.0,Jalen Johnson,1,1,1.0
41,10/21/2022,20.84109589041096,W,0,11.766666666666667,1,4,0.25,0,2,0.0,2,2,1.0,1,0,1,0,0,0,0,1,4,1.9,-16.0,Jalen Johnson,1,2,0.5
42,10/23/2022,20.846575342465755,L,0,9.516666666666667,1,2,0.5,0,1,0.0,1,2,0.5,1,1,2,0,0,0,1,0,3,1.6,-6.0,Jalen Johnson,1,1,1.0
43,10/26/2022,20.854794520547944,W,0,12.1,2,4,0.5,1,2,0.5,0,0,,0,3,3,0,0,0,0,2,5,3.1,0.0,Jalen Johnson,1,2,0.5
44,10/28/2022,20.86027397260274,W,0,21.15,3,5,0.6,1,1,1.0,0,0,,0,5,5,2,0,1,0,1,7,7.9,15.0,Jalen Johnson,2,4,0.5
45,10/29/2022,20.863013698630137,L,0,16.583333333333332,2,7,0.286,0,4,0.0,0,0,,0,2,2,2,1,0,0,4,4,1.3,-3.0,Jalen Johnson,2,3,0.6666666666666666
46,10/31/2022,20.86849315068493,L,0,10.666666666666666,2,3,0.667,0,0,,1,2,0.5,1,3,4,1,0,0,0,3,5,4.4,3.0,Jalen Johnson,2,3,0.6666666666666666
47,11/2/2022,20.873972602739727,W,0,11.883333333333333,0,1,0.0,0,1,0.0,0,0,,1,3,4,0,1,0,0,1,0,1.5,-5.0,Jalen Johnson,0,0,
48,11/5/2022,20.882191780821916,W,0,14.816666666666666,5,7,0.714,1,3,0.333,0,0,,0,4,4,1,2,0,1,0,11,11.0,4.0,Jalen Johnson,4,4,1.0
49,11/7/2022,20.887671232876713,W,0,21.95,2,5,0.4,0,1,0.0,1,2,0.5,1,7,8,2,2,1,0,2,5,8.0,15.0,Jalen Johnson,2,4,0.5
50,11/9/2022,20.893150684931506,L,0,19.5,0,5,0.0,0,1,0.0,0,0,,1,4,5,1,1,1,0,2,0,0.0,-22.0,Jalen Johnson,0,4,0.0
51,11/10/2022,20.895890410958906,W,0,6.316666666666666,1,2,0.5,0,0,,0,0,,0,1,1,0,1,0,0,0,2,2.3,8.0,Jalen Johnson,1,2,0.5
52,11/12/2022,20.9013698630137,L,0,11.033333333333333,2,3,0.667,0,1,0.0,0,0,,0,2,2,0,1,0,3,0,4,1.3,3.0,Jalen Johnson,2,2,1.0
53,11/14/2022,20.90684931506849,W,0,14.533333333333333,2,2,1.0,0,0,,1,1,1.0,0,2,2,1,1,0,1,3,5,4.5,2.0,Jalen Johnson,2,2,1.0
54,11/16/2022,20.912328767123288,L,0,10.566666666666666,3,11,0.273,0,4,0.0,1,2,0.5,2,2,4,0,1,1,0,0,7,3.8,-5.0,Jalen Johnson,3,7,0.42857142857142855
55,11/19/2022,20.92054794520548,W,0,5.35,0,0,,0,0,,0,0,,0,0,0,0,0,0,1,1,0,-1.4,-8.0,Jalen Johnson,0,0,
56,11/21/2022,20.926027397260274,L,0,14.083333333333334,3,4,0.75,2,3,0.667,0,0,,0,1,1,1,2,0,0,2,8,8.6,5.0,Jalen Johnson,1,1,1.0
57,11/23/2022,20.931506849315067,W,0,15.65,4,7,0.571,0,1,0.0,0,0,,0,2,2,1,1,0,0,1,8,6.6,8.0,Jalen Johnson,4,6,0.6666666666666666
58,11/25/2022,20.936986301369863,L,0,12.683333333333334,2,3,0.667,0,1,0.0,0,0,,0,1,1,1,0,2,0,2,4,4.3,3.0,Jalen Johnson,2,2,1.0
59,11/27/2022,20.942465753424656,L,0,11.433333333333334,0,0,,0,0,,0,0,,1,4,5,1,0,0,1,2,0,0.8,-4.0,Jalen Johnson,0,0,
60,10/19/2022,24.08219178082192,W,1,37.9,7,22,0.318,1,9,0.111,8,8,1.0,0,3,3,13,1,1,3,1,23,18.7,16.0,Trae Young,6,13,0.46153846153846156
61,10/21/2022,24.087671232876712,W,1,37.36666666666667,7,24,0.292,4,11,0.364,7,7,1.0,2,2,4,13,0,0,6,3,25,14.9,5.0,Trae Young,3,13,0.23076923076923078
62,10/23/2022,24.09315068493151,L,1,33.266666666666666,9,25,0.36,2,8,0.25,8,9,0.889,2,3,5,9,0,0,1,4,28,19.7,-6.0,Trae Young,7,17,0.4117647058823529
63,10/26/2022,24.101369863013698,W,1,37.733333333333334,9,21,0.429,1,7,0.143,16,17,0.941,0,3,3,6,1,0,1,2,35,27.8,10.0,Trae Young,8,14,0.5714285714285714
64,10/28/2022,24.106849315068494,W,1,30.116666666666667,12,20,0.6,4,6,0.667,8,10,0.8,1,1,2,12,0,0,1,1,36,34.0,12.0,Trae Young,8,14,0.5714285714285714
65,10/29/2022,24.10958904109589,L,1,36.43333333333333,15,32,0.469,5,10,0.5,7,7,1.0,1,5,6,5,0,0,2,1,42,28.9,-13.0,Trae Young,10,22,0.45454545454545453
66,10/31/2022,24.115068493150684,L,1,32.45,3,13,0.231,1,5,0.2,7,8,0.875,0,0,0,10,1,0,10,0,14,3.7,-29.0,Trae Young,2,8,0.25
67,11/2/2022,24.12054794520548,W,1,27.866666666666667,7,22,0.318,2,7,0.286,1,2,0.5,1,5,6,7,1,0,1,1,17,10.7,17.0,Trae Young,5,15,0.3333333333333333
68,11/5/2022,24.12876712328767,W,1,42.35,9,26,0.346,2,9,0.222,14,15,0.933,1,0,1,10,2,1,5,3,34,23.2,-6.0,Trae Young,7,17,0.4117647058823529
69,11/9/2022,24.13972602739726,L,1,35.75,10,28,0.357,2,5,0.4,0,0,,1,3,4,9,2,0,2,0,22,14.3,8.0,Trae Young,8,23,0.34782608695652173
70,11/10/2022,24.14246575342466,W,1,33.06666666666667,7,21,0.333,2,8,0.25,10,10,1.0,1,2,3,7,1,0,6,0,26,15.3,16.0,Trae Young,5,13,0.38461538461538464
71,11/12/2022,24.147945205479452,L,1,37.75,8,18,0.444,2,7,0.286,9,12,0.75,1,0,1,11,1,0,7,1,27,18.4,-5.0,Trae Young,6,11,0.5454545454545454
72,11/14/2022,24.153424657534245,W,1,33.766666666666666,7,19,0.368,2,5,0.4,5,5,1.0,0,3,3,9,1,0,2,0,21,16.7,10.0,Trae Young,5,14,0.35714285714285715
73,11/16/2022,24.15890410958904,L,1,30.7,10,23,0.435,2,7,0.286,5,6,0.833,1,4,5,9,1,0,1,1,27,22.3,-10.0,Trae Young,8,16,0.5
74,11/19/2022,24.167123287671235,W,1,41.733333333333334,12,21,0.571,2,4,0.5,7,9,0.778,1,2,3,12,1,1,2,3,33,30.5,11.0,Trae Young,10,17,0.5882352941176471
75,11/21/2022,24.172602739726027,L,1,35.45,10,22,0.455,1,7,0.143,4,6,0.667,0,2,2,10,1,0,6,1,25,15.0,-19.0,Trae Young,9,15,0.6
76,11/23/2022,24.17808219178082,W,1,34.61666666666667,11,19,0.579,4,7,0.571,9,9,1.0,0,1,1,7,0,0,4,2,35,26.5,13.0,Trae Young,7,12,0.5833333333333334
77,11/25/2022,24.183561643835617,L,1,37.56666666666667,13,28,0.464,4,10,0.4,14,16,0.875,0,0,0,5,1,0,4,4,44,27.7,-6.0,Trae Young,9,18,0.5
78,11/27/2022,24.18904109589041,L,1,38.416666666666664,4,16,0.25,1,8,0.125,13,13,1.0,3,2,5,14,1,0,3,1,22,22.5,2.0,Trae Young,3,8,0.375
79,10/19/2022,24.87945205479452,W,1,32.13333333333333,10,15,0.667,1,3,0.333,1,2,0.5,1,2,3,1,1,0,0,3,22,16.9,12.0,De'Andre Hunter,9,12,0.75
80,10/21/2022,24.884931506849316,W,1,32.53333333333333,5,12,0.417,1,3,0.333,1,1,1.0,0,6,6,1,0,0,1,3,12,5.9,6.0,De'Andre Hunter,4,9,0.4444444444444444
81,10/23/2022,24.89041095890411,L,1,31.216666666666665,4,11,0.364,1,5,0.2,1,2,0.5,2,3,5,4,1,0,1,3,10,7.4,-2.0,De'Andre Hunter,3,6,0.5
82,10/26/2022,24.898630136986302,W,1,27.066666666666666,7,10,0.7,2,3,0.667,1,3,0.333,0,3,3,1,0,0,2,6,17,9.2,3.0,De'Andre Hunter,5,7,0.7142857142857143
83,10/28/2022,24.904109589041095,W,1,17.533333333333335,5,10,0.5,2,5,0.4,0,0,,0,2,2,1,0,0,1,4,12,5.7,8.0,De'Andre Hunter,3,5,0.6
84,10/29/2022,24.90684931506849,L,1,31.416666666666668,4,10,0.4,2,4,0.5,4,4,1.0,0,5,5,0,0,0,2,3,14,6.9,-5.0,De'Andre Hunter,2,6,0.3333333333333333
85,10/31/2022,24.912328767123288,L,1,22.333333333333332,4,10,0.4,3,4,0.75,0,0,,0,1,1,1,0,0,1,5,11,3.6,-21.0,De'Andre Hunter,1,6,0.16666666666666666
86,11/2/2022,24.91780821917808,W,1,35.15,9,21,0.429,2,5,0.4,1,3,0.333,1,2,3,1,1,1,0,4,21,11.2,22.0,De'Andre Hunter,7,16,0.4375
87,11/5/2022,24.926027397260274,W,1,39.31666666666667,6,13,0.462,2,6,0.333,1,2,0.5,2,4,6,1,0,1,2,4,15,8.3,12.0,De'Andre Hunter,4,7,0.5714285714285714
88,11/7/2022,24.931506849315067,W,1,23.916666666666668,3,9,0.333,0,1,0.0,4,5,0.8,1,5,6,1,0,0,4,3,10,2.2,1.0,De'Andre Hunter,3,8,0.375
89,11/9/2022,24.936986301369863,L,1,32.56666666666667,9,15,0.6,1,6,0.167,3,3,1.0,0,3,3,0,1,0,1,1,22,15.6,10.0,De'Andre Hunter,8,9,0.8888888888888888
90,11/10/2022,24.93972602739726,W,1,31.933333333333334,6,13,0.462,1,3,0.333,1,2,0.5,2,2,4,0,0,0,2,2,14,6.1,-4.0,De'Andre Hunter,5,10,0.5
91,11/12/2022,24.945205479452056,L,1,26.633333333333333,4,12,0.333,0,3,0.0,7,8,0.875,1,3,4,0,0,0,1,4,15,6.8,-12.0,De'Andre Hunter,4,9,0.4444444444444444
92,11/14/2022,24.95068493150685,W,1,35.18333333333333,6,15,0.4,2,3,0.667,10,10,1.0,0,3,3,2,0,0,1,3,24,16.0,10.0,De'Andre Hunter,4,12,0.3333333333333333
93,11/16/2022,24.956164383561642,L,1,34.46666666666667,4,13,0.308,2,6,0.333,3,3,1.0,0,4,4,0,0,0,0,1,13,6.3,-21.0,De'Andre Hunter,2,7,0.2857142857142857
94,11/19/2022,24.964383561643835,W,1,45.3,5,14,0.357,1,3,0.333,11,14,0.786,1,4,5,1,0,0,3,3,22,11.4,3.0,De'Andre Hunter,4,11,0.36363636363636365
95,11/23/2022,24.975342465753425,W,1,34.5,5,12,0.417,1,4,0.25,2,2,1.0,2,8,10,3,1,1,2,1,13,11.8,1.0,De'Andre Hunter,4,8,0.5
96,11/25/2022,24.980821917808218,L,1,38.06666666666667,3,12,0.25,0,6,0.0,2,2,1.0,1,4,5,0,0,0,1,4,8,0.1,-1.0,De'Andre Hunter,3,6,0.5
97,11/27/2022,24.986301369863014,L,1,35.28333333333333,6,14,0.429,2,4,0.5,4,4,1.0,0,3,3,2,2,0,1,2,18,13.1,-9.0,De'Andre Hunter,4,10,0.4
98,10/19/2022,21.854794520547944,W,0,21.116666666666667,6,8,0.75,0,0,,1,3,0.333,1,8,9,0,0,0,0,4,13,10.5,8.0,Onyeka Okongwu,6,8,0.75
99,10/21/2022,21.86027397260274,W,0,16.383333333333333,1,2,0.5,0,0,,1,2,0.5,2,1,3,0,0,0,1,4,3,0.7,4.0,Onyeka Okongwu,1,2,0.5
100,10/23/2022,21.865753424657534,L,0,23.383333333333333,4,6,0.667,0,0,,2,4,0.5,3,2,5,1,1,2,2,4,10,8.8,1.0,Onyeka Okongwu,4,6,0.6666666666666666
101,10/26/2022,21.873972602739727,W,0,21.3,5,5,1.0,0,0,,0,0,,0,3,3,0,1,1,0,2,10,10.3,-19.0,Onyeka Okongwu,5,5,1.0
102,10/28/2022,21.87945205479452,W,0,21.516666666666666,7,10,0.7,0,0,,2,2,1.0,5,2,7,2,1,1,0,2,16,18.2,10.0,Onyeka Okongwu,7,10,0.7
103,10/29/2022,21.882191780821916,L,0,19.216666666666665,3,5,0.6,0,0,,0,0,,2,4,6,1,0,1,2,4,6,4.1,6.0,Onyeka Okongwu,3,5,0.6
104,10/31/2022,21.887671232876713,L,0,16.25,3,4,0.75,0,0,,2,2,1.0,1,4,5,1,0,2,1,3,8,8.2,0.0,Onyeka Okongwu,3,4,0.75
105,11/2/2022,21.893150684931506,W,0,19.35,2,4,0.5,0,0,,0,0,,3,4,7,1,1,0,0,2,4,6.2,-2.0,Onyeka Okongwu,2,4,0.5
106,11/5/2022,21.9013698630137,W,0,17.733333333333334,1,2,0.5,0,0,,2,2,1.0,0,1,1,1,1,0,0,5,4,3.0,-4.0,Onyeka Okongwu,1,2,0.5
107,11/7/2022,21.90684931506849,W,0,22.0,6,11,0.545,0,1,0.0,0,0,,3,3,6,2,1,0,1,1,12,10.7,22.0,Onyeka Okongwu,6,10,0.6
108,11/9/2022,21.912328767123288,L,0,19.983333333333334,2,4,0.5,0,0,,0,0,,1,4,5,3,1,1,0,2,4,6.9,-17.0,Onyeka Okongwu,2,4,0.5
109,11/10/2022,21.915068493150685,W,0,21.25,5,6,0.833,0,0,,0,0,,2,9,11,0,0,2,1,5,10,10.3,-17.0,Onyeka Okongwu,5,6,0.8333333333333334
110,11/14/2022,21.926027397260274,W,0,17.133333333333333,3,5,0.6,0,0,,0,0,,1,4,5,1,0,1,0,5,6,5.0,0.0,Onyeka Okongwu,3,5,0.6
111,11/16/2022,21.931506849315067,L,0,20.5,1,3,0.333,0,0,,0,0,,5,4,9,3,1,0,1,2,2,6.3,-13.0,Onyeka Okongwu,1,3,0.3333333333333333
112,11/19/2022,21.93972602739726,W,0,18.65,1,2,0.5,0,0,,1,2,0.5,0,4,4,0,0,0,0,1,3,2.4,-8.0,Onyeka Okongwu,1,2,0.5
113,11/21/2022,21.945205479452056,L,0,19.733333333333334,6,9,0.667,0,1,0.0,6,6,1.0,3,7,10,0,0,0,1,1,18,16.9,-1.0,Onyeka Okongwu,6,8,0.75
114,11/23/2022,21.95068493150685,W,0,19.183333333333334,1,3,0.333,0,0,,3,4,0.75,2,5,7,1,0,1,1,4,5,4.6,1.0,Onyeka Okongwu,1,3,0.3333333333333333
115,11/25/2022,21.956164383561642,L,1,32.7,0,0,,0,0,,4,6,0.667,5,6,11,2,2,2,2,5,4,9.3,1.0,Onyeka Okongwu,0,0,
116,11/27/2022,21.96164383561644,L,1,33.65,3,7,0.429,0,0,,0,0,,3,1,4,0,1,2,1,1,6,5.7,-13.0,Onyeka Okongwu,3,7,0.42857142857142855
117,10/19/2022,26.052054794520547,W,0,18.033333333333335,2,5,0.4,1,2,0.5,0,0,,0,0,0,1,3,0,2,1,5,3.6,-6.0,Aaron Holiday,1,3,0.3333333333333333
118,10/21/2022,26.057534246575344,W,0,14.366666666666667,2,3,0.667,0,0,,0,0,,0,2,2,1,0,0,0,2,4,3.2,0.0,Aaron Holiday,2,3,0.6666666666666666
119,10/23/2022,26.063013698630137,L,0,13.7,0,4,0.0,0,2,0.0,2,2,1.0,0,0,0,0,1,0,1,1,2,-1.2,-22.0,Aaron Holiday,0,2,0.0
120,10/26/2022,26.07123287671233,W,0,17.783333333333335,4,8,0.5,2,2,1.0,0,0,,2,0,2,2,0,1,1,1,10,8.1,3.0,Aaron Holiday,2,6,0.3333333333333333
121,10/28/2022,26.076712328767123,W,0,27.866666666666667,5,6,0.833,1,1,1.0,3,3,1.0,1,1,2,3,2,1,1,4,14,15.0,17.0,Aaron Holiday,4,5,0.8
122,10/29/2022,26.07945205479452,L,0,24.05,1,2,0.5,1,1,1.0,0,0,,0,1,1,2,0,0,1,0,3,2.7,-5.0,Aaron Holiday,0,1,0.0
123,10/31/2022,26.084931506849315,L,0,9.216666666666667,0,1,0.0,0,0,,0,0,,0,0,0,1,0,0,0,0,0,0.0,5.0,Aaron Holiday,0,1,0.0
124,11/2/2022,26.09041095890411,W,0,24.45,3,7,0.429,1,1,1.0,1,2,0.5,1,1,2,3,0,1,1,3,8,5.5,-14.0,Aaron Holiday,2,6,0.3333333333333333
125,11/5/2022,26.0986301369863,W,0,21.733333333333334,2,4,0.5,1,2,0.5,0,0,,1,2,3,2,1,0,1,0,5,5.7,-7.0,Aaron Holiday,1,2,0.5
126,11/7/2022,26.104109589041094,W,1,24.733333333333334,1,3,0.333,0,0,,2,2,1.0,0,0,0,5,1,0,1,1,4,5.4,14.0,Aaron Holiday,1,3,0.3333333333333333
127,11/9/2022,26.10958904109589,L,0,10.35,1,2,0.5,0,0,,0,0,,1,2,3,2,0,0,2,1,2,1.3,4.0,Aaron Holiday,1,2,0.5
128,11/10/2022,26.112328767123287,W,0,23.666666666666668,2,5,0.4,0,2,0.0,0,0,,0,2,2,1,2,0,0,4,4,3.0,15.0,Aaron Holiday,2,3,0.6666666666666666
129,11/12/2022,26.117808219178084,L,0,18.916666666666668,2,6,0.333,1,3,0.333,0,0,,0,0,0,0,0,0,1,3,5,-0.6,5.0,Aaron Holiday,1,3,0.3333333333333333
130,11/14/2022,26.123287671232877,W,0,20.2,2,5,0.4,0,1,0.0,0,0,,0,3,3,2,1,0,0,3,4,3.4,18.0,Aaron Holiday,2,4,0.5
131,11/16/2022,26.12876712328767,L,0,10.633333333333333,1,6,0.167,0,1,0.0,0,0,,0,2,2,0,0,0,0,2,2,-2.0,-19.0,Aaron Holiday,1,5,0.2
132,11/19/2022,26.136986301369863,W,0,8.0,0,0,,0,0,,0,0,,0,1,1,0,0,0,1,0,0,-0.7,-9.0,Aaron Holiday,0,0,
133,11/21/2022,26.14246575342466,L,0,18.666666666666668,1,6,0.167,1,4,0.25,0,0,,2,1,3,0,0,0,0,2,3,0.1,-4.0,Aaron Holiday,0,2,0.0
134,11/23/2022,26.147945205479452,W,0,16.85,3,5,0.6,3,3,1.0,0,0,,0,0,0,2,2,0,0,3,9,8.9,3.0,Aaron Holiday,0,2,0.0
135,11/25/2022,26.153424657534245,L,0,15.9,1,2,0.5,0,1,0.0,0,2,0.0,0,2,2,1,0,0,2,4,2,-2.1,-5.0,Aaron Holiday,1,1,1.0
136,10/19/2022,28.421917808219177,W,1,26.05,1,3,0.333,0,0,,0,0,,2,6,8,0,0,2,1,2,2,3.1,-1.0,Clint Capela,1,3,0.3333333333333333
137,10/21/2022,28.427397260273974,W,1,31.616666666666667,4,6,0.667,0,0,,0,0,,0,7,7,0,2,1,0,1,8,9.8,6.0,Clint Capela,4,6,0.6666666666666666
138,10/23/2022,28.432876712328767,L,1,22.95,6,8,0.75,0,0,,2,2,1.0,5,5,10,1,1,1,1,4,14,15.6,-19.0,Clint Capela,6,8,0.75
139,10/26/2022,28.44109589041096,W,1,26.433333333333334,3,8,0.375,0,0,,0,0,,5,5,10,2,1,4,1,0,6,10.8,22.0,Clint Capela,3,8,0.375
140,10/28/2022,28.446575342465753,W,1,23.433333333333334,2,6,0.333,0,0,,1,3,0.333,3,8,11,1,0,2,1,2,5,5.6,14.0,Clint Capela,2,6,0.3333333333333333
141,10/29/2022,28.44931506849315,L,1,28.783333333333335,5,8,0.625,0,0,,1,2,0.5,5,5,10,1,2,1,2,1,11,13.0,-14.0,Clint Capela,5,8,0.625
142,10/31/2022,28.454794520547946,L,1,25.416666666666668,6,7,0.857,0,0,,1,4,0.25,2,3,5,0,0,1,1,2,13,10.5,-24.0,Clint Capela,6,7,0.8571428571428571
143,11/2/2022,28.46027397260274,W,1,25.183333333333334,3,8,0.375,0,0,,2,2,1.0,4,6,10,1,1,0,0,1,8,9.5,15.0,Clint Capela,3,8,0.375
144,11/5/2022,28.46849315068493,W,1,35.0,10,15,0.667,0,0,,1,2,0.5,5,14,19,1,1,4,1,3,21,24.1,8.0,Clint Capela,10,15,0.6666666666666666
145,11/7/2022,28.473972602739725,W,1,22.15,2,7,0.286,0,0,,1,1,1.0,3,9,12,0,1,1,1,3,5,5.2,1.0,Clint Capela,2,7,0.2857142857142857
146,11/9/2022,28.47945205479452,L,1,26.183333333333334,7,13,0.538,0,0,,1,2,0.5,10,9,19,1,0,2,1,1,15,18.7,7.0,Clint Capela,7,13,0.5384615384615384
147,11/10/2022,28.482191780821918,W,1,26.366666666666667,7,10,0.7,0,0,,4,6,0.667,5,15,20,0,0,0,1,2,18,19.2,24.0,Clint Capela,7,10,0.7
148,11/12/2022,28.487671232876714,L,1,33.11666666666667,7,9,0.778,0,0,,0,0,,6,9,15,0,0,0,4,3,14,12.2,-20.0,Clint Capela,7,9,0.7777777777777778
149,11/14/2022,28.493150684931507,W,1,30.0,9,11,0.818,0,0,,1,4,0.25,7,3,10,2,0,2,1,2,19,20.5,14.0,Clint Capela,9,11,0.8181818181818182
150,11/16/2022,28.4986301369863,L,1,18.416666666666668,3,3,1.0,0,0,,1,2,0.5,2,6,8,0,0,0,0,0,7,8.9,-9.0,Clint Capela,3,3,1.0
151,11/19/2022,28.506849315068493,W,1,34.35,9,13,0.692,0,0,,0,0,,6,8,14,1,0,3,0,4,18,20.3,10.0,Clint Capela,9,13,0.6923076923076923
152,11/21/2022,28.512328767123286,L,1,27.133333333333333,2,5,0.4,0,0,,0,0,,2,10,12,3,2,2,1,4,4,8.6,-14.0,Clint Capela,2,5,0.4
153,11/23/2022,28.517808219178082,W,1,28.266666666666666,5,10,0.5,0,0,,1,1,1.0,4,10,14,1,0,3,0,3,11,13.4,6.0,Clint Capela,5,10,0.5
154,10/19/2022,33.53972602739726,W,0,18.533333333333335,1,5,0.2,1,4,0.25,0,0,,0,1,1,3,1,1,0,2,3,3.2,3.0,Justin Holiday,0,1,0.0
155,10/21/2022,33.54520547945206,W,0,20.116666666666667,3,8,0.375,3,6,0.5,0,0,,0,1,1,2,1,0,0,2,9,6.5,2.0,Justin Holiday,0,2,0.0
156,10/23/2022,33.55068493150685,L,0,17.216666666666665,1,7,0.143,1,5,0.2,0,0,,0,0,0,0,0,1,0,1,3,-1.2,-18.0,Justin Holiday,0,2,0.0
157,10/26/2022,33.558904109589044,W,0,22.366666666666667,1,3,0.333,0,1,0.0,0,0,,0,3,3,3,0,0,1,1,2,1.9,-3.0,Justin Holiday,1,2,0.5
158,10/28/2022,33.56438356164384,W,0,25.816666666666666,2,8,0.25,0,6,0.0,0,0,,0,0,0,3,0,0,0,5,4,-0.7,14.0,Justin Holiday,2,2,1.0
159,10/29/2022,33.56712328767123,L,0,12.75,4,5,0.8,2,3,0.667,0,0,,0,0,0,0,0,0,0,4,10,6.5,-1.0,Justin Holiday,2,2,1.0
160,10/31/2022,33.57260273972603,L,0,23.733333333333334,5,8,0.625,2,4,0.5,0,0,,0,0,0,1,0,1,0,2,12,9.0,-13.0,Justin Holiday,3,4,0.75
161,11/2/2022,33.57808219178082,W,0,14.5,1,4,0.25,1,3,0.333,0,0,,0,1,1,2,0,0,0,1,3,1.9,-11.0,Justin Holiday,0,1,0.0
162,11/5/2022,33.586301369863016,W,0,16.366666666666667,2,7,0.286,1,6,0.167,0,0,,0,1,1,0,2,0,1,1,5,1.8,-11.0,Justin Holiday,1,1,1.0
163,11/7/2022,33.59178082191781,W,0,23.0,5,10,0.5,4,7,0.571,0,0,,0,0,0,0,0,0,0,1,14,8.6,18.0,Justin Holiday,1,3,0.3333333333333333
164,11/9/2022,33.5972602739726,L,0,19.1,4,9,0.444,2,6,0.333,0,0,,0,2,2,0,0,0,2,2,10,3.1,-14.0,Justin Holiday,2,3,0.6666666666666666
165,11/10/2022,33.6,W,0,22.65,2,4,0.5,2,4,0.5,0,0,,1,3,4,0,0,0,3,1,6,2.2,11.0,Justin Holiday,0,0,
166,11/12/2022,33.605479452054794,L,0,15.466666666666667,0,2,0.0,0,1,0.0,0,0,,0,3,3,1,0,1,1,2,0,-0.9,3.0,Justin Holiday,0,1,0.0
167,11/16/2022,33.61643835616438,L,0,6.7,0,1,0.0,0,1,0.0,0,0,,0,0,0,0,0,1,0,1,0,-0.4,-2.0,Justin Holiday,0,0,
168,11/19/2022,33.62465753424657,W,0,7.266666666666667,2,5,0.4,1,3,0.333,0,0,,0,0,0,0,0,0,1,0,5,1.3,-6.0,Justin Holiday,1,2,0.5
169,11/21/2022,33.63013698630137,L,0,15.516666666666667,0,3,0.0,0,3,0.0,0,0,,0,0,0,1,0,0,0,2,0,-2.2,-2.0,Justin Holiday,0,0,
170,11/25/2022,33.64109589041096,L,0,1.4166666666666667,0,0,,0,0,,0,0,,0,0,0,0,0,0,0,0,0,0.0,-1.0,Justin Holiday,0,0,
171,10/23/2022,19.161643835616438,L,0,6.45,3,4,0.75,2,3,0.667,0,0,,0,0,0,0,2,0,0,0,8,8.4,6.0,AJ Griffin,1,1,1.0
172,10/28/2022,19.175342465753424,W,0,5.716666666666667,4,6,0.667,2,3,0.667,0,0,,0,0,0,0,0,0,0,2,10,6.6,-2.0,AJ Griffin,2,3,0.6666666666666666
173,10/29/2022,19.17808219178082,L,0,5.083333333333333,0,2,0.0,0,0,,0,0,,2,0,2,0,0,0,0,0,0,0.0,-1.0,AJ Griffin,0,2,0.0
174,10/31/2022,19.183561643835617,L,0,14.466666666666667,1,3,0.333,0,2,0.0,0,0,,0,2,2,1,0,0,0,1,2,1.2,-11.0,AJ Griffin,1,1,1.0
175,11/2/2022,19.18904109589041,W,0,9.266666666666667,1,2,0.5,1,2,0.5,0,0,,0,0,0,2,0,0,0,0,3,3.4,9.0,AJ Griffin,0,0,
176,11/7/2022,19.202739726027396,W,0,31.383333333333333,10,15,0.667,2,6,0.333,2,2,1.0,1,3,4,1,3,0,1,2,24,21.0,28.0,AJ Griffin,8,9,0.8888888888888888
177,11/9/2022,19.208219178082192,L,0,10.483333333333333,1,5,0.2,1,4,0.25,0,0,,1,2,3,0,0,0,0,1,3,0.8,-18.0,AJ Griffin,0,1,0.0
178,11/10/2022,19.21095890410959,W,0,14.316666666666666,1,3,0.333,1,2,0.5,0,0,,0,2,2,1,1,0,1,2,3,1.8,6.0,AJ Griffin,0,1,0.0
179,11/12/2022,19.216438356164385,L,0,12.0,3,7,0.429,2,2,1.0,1,1,1.0,0,1,1,0,0,0,1,0,9,4.6,3.0,AJ Griffin,1,5,0.2
180,11/14/2022,19.221917808219178,W,0,17.1,3,6,0.5,1,2,0.5,0,0,,1,1,2,1,0,0,2,1,7,3.3,-1.0,AJ Griffin,2,4,0.5
181,11/16/2022,19.22739726027397,L,0,20.85,3,9,0.333,0,4,0.0,0,0,,3,0,3,1,1,0,2,1,6,2.3,-21.0,AJ Griffin,3,5,0.6
182,11/19/2022,19.235616438356164,W,0,30.0,8,15,0.533,1,6,0.167,0,0,,3,2,5,1,1,1,0,2,17,14.0,-6.0,AJ Griffin,7,9,0.7777777777777778
183,11/21/2022,19.24109589041096,L,1,35.916666666666664,7,11,0.636,3,6,0.5,0,0,,1,1,2,1,3,0,2,3,17,13.6,-8.0,AJ Griffin,4,5,0.8
184,11/23/2022,19.246575342465754,W,0,24.1,4,8,0.5,2,4,0.5,2,2,1.0,1,2,3,2,1,0,1,0,12,10.7,3.0,AJ Griffin,2,4,0.5
185,11/25/2022,19.252054794520546,L,0,23.966666666666665,3,5,0.6,3,4,0.75,2,2,1.0,0,1,1,1,2,0,1,2,11,9.9,-2.0,AJ Griffin,0,1,0.0
186,11/27/2022,19.257534246575343,L,0,21.35,3,13,0.231,2,9,0.222,0,0,,0,2,2,0,1,0,0,1,8,1.3,-3.0,AJ Griffin,1,4,0.25
187,10/28/2022,29.567123287671233,W,0,3.05,0,0,,0,0,,0,0,,0,2,2,1,0,0,0,1,0,0.9,0.0,Frank Kaminsky,0,0,
188,10/31/2022,29.575342465753426,L,0,6.333333333333333,0,1,0.0,0,1,0.0,4,4,1.0,0,1,1,1,0,0,1,1,4,2.9,-6.0,Frank Kaminsky,0,0,
189,11/2/2022,29.58082191780822,W,0,1.1166666666666667,0,0,,0,0,,0,0,,0,0,0,0,0,0,0,0,0,0.0,-2.0,Frank Kaminsky,0,0,
190,11/7/2022,29.594520547945205,W,0,3.85,0,1,0.0,0,0,,0,0,,0,0,0,0,0,0,0,2,0,-1.5,-4.0,Frank Kaminsky,0,1,0.0
191,11/12/2022,29.60821917808219,L,0,13.283333333333333,3,3,1.0,0,0,,0,0,,0,3,3,1,0,0,0,3,6,5.5,6.0,Frank Kaminsky,3,3,1.0
192,11/16/2022,29.61917808219178,L,0,5.366666666666666,1,1,1.0,1,1,1.0,0,0,,0,1,1,1,0,0,0,0,3,3.7,4.0,Frank Kaminsky,0,0,
193,11/21/2022,29.632876712328766,L,0,1.1333333333333333,0,0,,0,0,,0,0,,0,0,0,0,0,0,0,0,0,0.0,3.0,Frank Kaminsky,0,0,
194,11/25/2022,29.643835616438356,L,0,8.316666666666666,1,1,1.0,0,0,,0,0,,0,0,0,0,0,0,0,1,2,1.3,-9.0,Frank Kaminsky,1,1,1.0
195,11/27/2022,29.649315068493152,L,0,11.766666666666667,2,4,0.5,2,3,0.667,0,0,,0,4,4,1,0,0,1,2,6,4.1,3.0,Frank Kaminsky,0,1,0.0
196,10/23/2022,22.345205479452055,L,0,1.6666666666666665,0,0,,0,0,,0,0,,0,0,0,1,0,0,0,0,0,0.7,1.0,Vit Krejci,0,0,
197,10/28/2022,22.35890410958904,W,0,1.6666666666666665,0,0,,0,0,,0,0,,0,0,0,0,0,0,0,1,0,-0.4,0.0,Vit Krejci,0,0,
198,10/31/2022,22.367123287671234,L,0,6.333333333333333,2,3,0.667,1,2,0.5,0,0,,0,1,1,0,0,0,0,1,5,3.6,-6.0,Vit Krejci,1,1,1.0
199,11/2/2022,22.372602739726027,W,0,1.1166666666666667,0,0,,0,0,,0,0,,0,0,0,0,0,0,0,0,0,0.0,-2.0,Vit Krejci,0,0,
200,11/7/2022,22.386301369863013,W,0,2.533333333333333,1,2,0.5,1,2,0.5,0,0,,0,1,1,0,0,0,0,0,3,2.3,-2.0,Vit Krejci,0,0,
201,11/14/2022,22.405479452054795,W,0,0.8666666666666667,0,0,,0,0,,0,0,,0,0,0,0,0,0,0,0,0,0.0,1.0,Vit Krejci,0,0,
202,11/16/2022,22.410958904109588,L,0,5.366666666666666,1,1,1.0,1,1,1.0,0,0,,0,0,0,0,0,0,0,0,3,2.7,4.0,Vit Krejci,0,0,
203,11/21/2022,22.424657534246574,L,0,1.1333333333333333,0,1,0.0,0,1,0.0,0,0,,0,0,0,0,0,0,0,0,0,-0.7,3.0,Vit Krejci,0,0,
204,10/23/2022,23.63013698630137,L,0,1.6666666666666665,1,1,1.0,0,0,,0,0,,0,0,0,0,0,0,0,0,2,1.7,1.0,Tyrese Martin,1,1,1.0
205,10/28/2022,23.643835616438356,W,0,2.9,1,1,1.0,0,0,,0,0,,0,0,0,0,1,0,0,0,2,2.7,2.0,Tyrese Martin,1,1,1.0
206,10/31/2022,23.65205479452055,L,0,6.333333333333333,1,2,0.5,1,1,1.0,0,0,,0,0,0,0,0,0,0,0,3,2.0,-6.0,Tyrese Martin,0,1,0.0
207,11/2/2022,23.65753424657534,W,0,1.1166666666666667,0,1,0.0,0,1,0.0,0,0,,1,0,1,0,0,0,0,1,0,-0.4,-2.0,Tyrese Martin,0,0,
208,11/7/2022,23.671232876712327,W,0,2.533333333333333,0,0,,0,0,,0,0,,0,0,0,0,0,0,0,0,0,0.0,-2.0,Tyrese Martin,0,0,
209,11/14/2022,23.69041095890411,W,0,0.8666666666666667,0,0,,0,0,,0,0,,0,0,0,0,0,0,0,0,0,0.0,1.0,Tyrese Martin,0,0,
210,11/16/2022,23.695890410958903,L,0,5.366666666666666,0,1,0.0,0,1,0.0,0,0,,1,2,3,0,0,0,0,0,0,0.6,4.0,Tyrese Martin,0,0,
211,10/23/2022,24.364383561643837,L,0,1.6666666666666665,0,0,,0,0,,0,0,,0,0,0,1,0,0,0,0,0,0.7,1.0,Trent Forrest,0,0,
212,10/28/2022,24.378082191780823,W,0,1.6666666666666665,0,0,,0,0,,0,0,,0,0,0,0,0,0,0,0,0,0.0,0.0,Trent Forrest,0,0,
213,10/31/2022,24.386301369863013,L,0,6.333333333333333,0,2,0.0,0,0,,0,0,,0,2,2,1,0,0,0,0,0,-0.1,-6.0,Trent Forrest,0,2,0.0
214,11/7/2022,24.405479452054795,W,0,3.85,0,1,0.0,0,0,,0,0,,0,0,0,1,0,0,0,1,0,-0.4,-4.0,Trent Forrest,0,1,0.0
215,11/16/2022,24.43013698630137,L,0,5.366666666666666,0,0,,0,0,,0,0,,0,0,0,2,0,0,0,0,0,1.4,4.0,Trent Forrest,0,0,
216,11/27/2022,24.46027397260274,L,0,12.716666666666667,1,1,1.0,0,0,,0,0,,0,0,0,2,0,0,0,0,2,3.1,1.0,Trent Forrest,1,1,1.0
217,11/7/2022,23.71232876712329,W,0,2.533333333333333,0,1,0.0,0,0,,1,2,0.5,1,0,1,0,0,0,0,0,1,0.6,-2.0,Jarrett Culver,0,1,0.0
218,11/14/2022,23.731506849315068,W,0,0.8666666666666667,0,0,,0,0,,0,0,,0,0,0,0,0,0,0,0,0,0.0,1.0,Jarrett Culver,0,0,
219,10/19/2022,31.783561643835615,W,0,25.116666666666667,4,10,0.4,2,3,0.667,4,4,1.0,1,1,2,3,0,0,2,1,14,9.3,0.0,Will Barton,2,7,0.2857142857142857
220,10/21/2022,31.78904109589041,W,0,17.283333333333335,3,6,0.5,0,1,0.0,0,0,,1,4,5,1,1,0,1,1,6,5.2,-5.0,Will Barton,3,5,0.6
221,10/23/2022,31.794520547945204,L,0,35.416666666666664,4,11,0.364,1,3,0.333,0,0,,0,4,4,2,2,0,5,2,9,1.7,-7.0,Will Barton,3,8,0.375
222,10/25/2022,31.8,W,0,29.166666666666668,6,9,0.667,4,6,0.667,0,0,,0,2,2,4,2,1,1,2,16,16.4,18.0,Will Barton,2,3,0.6666666666666666
223,10/28/2022,31.80821917808219,L,0,29.066666666666666,3,6,0.5,3,5,0.6,0,0,,0,2,2,3,0,0,1,2,9,6.9,-7.0,Will Barton,0,1,0.0
224,10/30/2022,31.813698630136987,L,0,14.483333333333333,2,8,0.25,0,3,0.0,0,1,0.0,0,2,2,1,0,0,0,1,4,-0.3,-16.0,Will Barton,2,5,0.4
225,10/31/2022,31.816438356164383,L,0,21.466666666666665,2,6,0.333,1,3,0.333,2,2,1.0,1,3,4,1,0,0,0,2,7,5.1,-17.0,Will Barton,1,3,0.3333333333333333
226,11/2/2022,31.82191780821918,W,0,24.15,4,9,0.444,1,4,0.25,2,2,1.0,0,1,1,3,1,1,0,2,11,9.6,3.0,Will Barton,3,5,0.6
227,11/4/2022,31.827397260273973,L,0,19.05,1,7,0.143,1,4,0.25,0,0,,0,3,3,3,1,0,1,0,3,1.5,-33.0,Will Barton,0,3,0.0
228,11/6/2022,31.832876712328765,L,0,23.733333333333334,5,12,0.417,1,5,0.2,1,1,1.0,0,4,4,5,0,0,0,2,12,9.5,3.0,Will Barton,4,7,0.5714285714285714
229,11/7/2022,31.835616438356166,W,0,26.65,3,10,0.3,0,3,0.0,0,0,,1,5,6,1,0,0,3,0,6,0.1,8.0,Will Barton,3,7,0.42857142857142855
230,11/10/2022,31.843835616438355,W,0,28.933333333333334,4,12,0.333,3,7,0.429,3,3,1.0,1,6,7,4,0,1,2,1,14,10.8,7.0,Will Barton,1,5,0.2
231,11/12/2022,31.84931506849315,W,0,16.383333333333333,3,7,0.429,1,5,0.2,2,2,1.0,0,2,2,1,0,1,1,1,9,5.9,-6.0,Will Barton,2,2,1.0
232,11/13/2022,31.852054794520548,W,0,22.683333333333334,3,9,0.333,1,4,0.25,0,0,,1,4,5,3,1,0,1,0,7,5.9,2.0,Will Barton,2,5,0.4
233,11/16/2022,31.86027397260274,L,0,16.433333333333334,2,5,0.4,1,2,0.5,0,0,,0,1,1,2,0,0,0,2,5,3.2,-17.0,Will Barton,1,3,0.3333333333333333
234,11/18/2022,31.865753424657534,W,0,8.216666666666667,0,2,0.0,0,1,0.0,0,0,,0,1,1,0,0,0,0,0,0,-1.1,-11.0,Will Barton,0,1,0.0
235,11/20/2022,31.87123287671233,W,0,20.733333333333334,1,6,0.167,1,2,0.5,0,0,,0,1,1,2,0,2,0,0,3,2.3,-1.0,Will Barton,0,4,0.0
236,11/23/2022,31.87945205479452,L,0,29.35,5,10,0.5,2,5,0.4,1,2,0.5,0,7,7,7,1,0,2,2,13,12.8,-10.0,Will Barton,3,5,0.6
237,11/25/2022,31.884931506849316,L,0,16.15,1,8,0.125,1,5,0.2,2,2,1.0,0,3,3,4,1,0,1,1,5,3.1,4.0,Will Barton,0,3,0.0
238,11/27/2022,31.89041095890411,L,0,30.866666666666667,2,8,0.25,0,4,0.0,2,3,0.667,0,4,4,2,1,0,1,1,6,3.0,-2.0,Will Barton,2,4,0.5
239,10/19/2022,21.791780821917808,W,1,7.666666666666667,1,1,1.0,0,0,,2,2,1.0,0,0,0,0,0,0,0,0,4,3.7,14.0,Deni Avdija,1,1,1.0
240,10/21/2022,21.797260273972604,W,1,23.016666666666666,2,4,0.5,2,2,1.0,0,0,,0,10,10,4,1,1,1,5,6,8.5,16.0,Deni Avdija,0,2,0.0
241,10/23/2022,21.802739726027397,L,1,14.45,1,6,0.167,0,3,0.0,0,0,,0,2,2,0,2,0,1,4,2,-1.8,1.0,Deni Avdija,1,3,0.3333333333333333
242,10/25/2022,21.80821917808219,W,1,26.833333333333332,3,6,0.5,1,3,0.333,2,2,1.0,0,7,7,2,1,2,0,3,9,10.7,12.0,Deni Avdija,2,3,0.6666666666666666
243,10/28/2022,21.816438356164383,L,1,19.966666666666665,3,7,0.429,1,3,0.333,0,0,,1,1,2,0,0,0,2,2,7,1.5,-6.0,Deni Avdija,2,4,0.5
244,10/30/2022,21.82191780821918,L,1,11.016666666666667,2,4,0.5,1,1,1.0,1,2,0.5,0,1,1,1,0,0,0,2,6,3.8,-9.0,Deni Avdija,1,3,0.3333333333333333
245,10/31/2022,21.824657534246576,L,0,16.7,0,1,0.0,0,0,,0,0,,0,1,1,2,0,1,0,3,0,0.5,-12.0,Deni Avdija,0,1,0.0
246,11/2/2022,21.83013698630137,W,0,28.8,1,3,0.333,0,1,0.0,3,4,0.75,1,7,8,1,0,3,0,5,5,6.5,17.0,Deni Avdija,1,2,0.5
247,11/4/2022,21.835616438356166,L,0,21.533333333333335,2,5,0.4,0,2,0.0,0,0,,0,2,2,1,0,0,2,2,4,-0.2,-21.0,Deni Avdija,2,3,0.6666666666666666
248,11/6/2022,21.84109589041096,L,1,26.05,2,12,0.167,0,5,0.0,0,0,,4,6,10,2,0,0,2,1,4,0.0,-16.0,Deni Avdija,2,7,0.2857142857142857
249,11/7/2022,21.843835616438355,W,1,18.45,1,4,0.25,0,3,0.0,1,2,0.5,0,3,3,2,0,0,1,3,3,0.3,4.0,Deni Avdija,1,1,1.0
250,11/10/2022,21.852054794520548,W,1,32.36666666666667,4,13,0.308,1,4,0.25,3,3,1.0,2,4,6,4,1,0,3,4,12,6.3,-2.0,Deni Avdija,3,9,0.3333333333333333
251,11/12/2022,21.85753424657534,W,1,34.36666666666667,4,6,0.667,1,2,0.5,4,4,1.0,1,6,7,3,3,1,2,3,13,15.5,22.0,Deni Avdija,3,4,0.75
252,11/13/2022,21.86027397260274,W,1,33.9,8,16,0.5,4,7,0.571,1,3,0.333,0,2,2,5,1,0,3,4,21,12.7,4.0,Deni Avdija,4,9,0.4444444444444444
253,11/16/2022,21.86849315068493,L,1,29.566666666666666,4,10,0.4,2,3,0.667,2,2,1.0,3,4,7,2,0,2,4,5,12,6.7,1.0,Deni Avdija,2,7,0.2857142857142857
254,11/18/2022,21.873972602739727,W,1,14.416666666666666,1,2,0.5,1,2,0.5,0,0,,0,1,1,3,0,0,1,4,3,1.8,-3.0,Deni Avdija,0,0,
255,11/20/2022,21.87945205479452,W,1,31.133333333333333,6,11,0.545,0,3,0.0,0,1,0.0,4,9,13,1,0,1,1,2,12,11.4,7.0,Deni Avdija,6,8,0.75
256,11/23/2022,21.887671232876713,L,1,40.6,5,10,0.5,1,3,0.333,1,1,1.0,3,6,9,10,1,2,4,4,12,14.7,-3.0,Deni Avdija,4,7,0.5714285714285714
257,11/25/2022,21.893150684931506,L,1,30.7,2,8,0.25,0,4,0.0,4,6,0.667,1,8,9,5,1,2,3,3,8,7.2,-2.0,Deni Avdija,2,4,0.5
258,11/27/2022,21.898630136986302,L,1,26.8,4,8,0.5,2,6,0.333,0,0,,0,1,1,3,1,0,0,3,10,8.2,-11.0,Deni Avdija,2,2,1.0
259,10/19/2022,24.04931506849315,W,0,15.983333333333333,6,8,0.75,0,0,,0,0,,4,3,7,0,1,1,2,0,12,12.2,-2.0,Daniel Gafford,6,8,0.75
260,10/21/2022,24.054794520547944,W,0,17.75,1,1,1.0,0,0,,0,0,,0,2,2,0,1,1,3,4,2,-0.6,-15.0,Daniel Gafford,1,1,1.0
261,10/23/2022,24.06027397260274,L,0,14.8,1,2,0.5,0,0,,0,0,,1,1,2,0,0,1,1,2,2,0.9,-11.0,Daniel Gafford,1,2,0.5
262,10/25/2022,24.065753424657533,W,0,19.8,4,6,0.667,0,0,,1,2,0.5,1,4,5,1,0,2,0,2,9,9.2,19.0,Daniel Gafford,4,6,0.6666666666666666
263,10/28/2022,24.073972602739726,L,0,14.933333333333334,3,4,0.75,0,0,,4,5,0.8,2,2,4,0,0,0,1,2,10,8.2,1.0,Daniel Gafford,3,4,0.75
264,10/30/2022,24.07945205479452,L,0,10.05,0,1,0.0,0,0,,0,0,,1,0,1,0,0,1,2,1,0,-1.7,-16.0,Daniel Gafford,0,1,0.0
265,10/31/2022,24.08219178082192,L,0,10.65,0,2,0.0,0,0,,1,2,0.5,0,2,2,1,1,0,3,2,1,-2.3,-12.0,Daniel Gafford,0,2,0.0
266,11/2/2022,24.087671232876712,W,0,11.25,4,5,0.8,0,0,,2,5,0.4,2,0,2,1,1,1,0,0,10,10.7,2.0,Daniel Gafford,4,5,0.8
267,11/4/2022,24.09315068493151,L,0,10.333333333333334,2,2,1.0,0,0,,0,0,,0,1,1,0,0,1,1,1,4,3.0,-13.0,Daniel Gafford,2,2,1.0
268,11/6/2022,24.0986301369863,L,0,13.566666666666666,4,6,0.667,0,0,,1,1,1.0,2,3,5,2,0,0,0,3,9,8.9,3.0,Daniel Gafford,4,6,0.6666666666666666
269,11/7/2022,24.101369863013698,W,0,11.15,2,2,1.0,0,0,,1,1,1.0,2,5,7,1,1,0,1,0,5,8.0,5.0,Daniel Gafford,2,2,1.0
270,11/10/2022,24.10958904109589,W,0,24.766666666666666,3,3,1.0,0,0,,5,6,0.833,2,8,10,0,0,4,1,3,11,14.1,11.0,Daniel Gafford,3,3,1.0
271,11/12/2022,24.115068493150684,W,0,14.316666666666666,1,1,1.0,0,0,,0,0,,1,1,2,1,0,1,0,0,2,4.1,-11.0,Daniel Gafford,1,1,1.0
272,11/13/2022,24.117808219178084,W,0,16.616666666666667,1,1,1.0,0,0,,3,7,0.429,2,3,5,1,0,2,2,3,5,4.3,0.0,Daniel Gafford,1,1,1.0
273,11/16/2022,24.126027397260273,L,0,5.75,1,1,1.0,0,0,,0,0,,0,1,1,0,0,0,0,2,2,1.2,-14.0,Daniel Gafford,1,1,1.0
274,11/18/2022,24.13150684931507,W,0,4.5,0,0,,0,0,,0,0,,0,0,0,0,0,0,0,2,0,-0.8,-9.0,Daniel Gafford,0,0,
275,11/20/2022,24.136986301369863,W,0,7.966666666666667,1,2,0.5,0,0,,2,2,1.0,1,2,3,0,0,1,2,1,4,2.6,-3.0,Daniel Gafford,1,2,0.5
276,11/23/2022,24.145205479452056,L,0,9.933333333333334,2,4,0.5,0,0,,0,0,,2,4,6,0,1,0,1,3,4,3.4,-10.0,Daniel Gafford,2,4,0.5
277,11/25/2022,24.15068493150685,L,0,8.1,3,3,1.0,0,0,,0,0,,1,2,3,0,0,1,0,1,6,6.7,8.0,Daniel Gafford,3,3,1.0
278,11/27/2022,24.156164383561645,L,0,6.366666666666666,2,2,1.0,0,0,,0,0,,1,2,3,0,0,0,0,1,4,4.3,13.0,Daniel Gafford,2,2,1.0
279,10/19/2022,27.213698630136985,W,1,31.783333333333335,5,14,0.357,1,5,0.2,4,6,0.667,2,8,10,3,0,2,2,2,15,10.9,7.0,Kristaps Porziņģis,4,9,0.4444444444444444
280,10/21/2022,27.21917808219178,W,1,28.8,6,13,0.462,2,5,0.4,0,0,,0,3,3,2,1,2,1,6,14,8.6,17.0,Kristaps Porziņģis,4,8,0.5
281,10/23/2022,27.224657534246575,L,1,37.93333333333333,7,16,0.438,4,8,0.5,0,1,0.0,1,10,11,3,1,1,2,4,18,13.1,1.0,Kristaps Porziņģis,3,8,0.375
282,10/25/2022,27.23013698630137,W,1,25.3,8,13,0.615,2,4,0.5,2,2,1.0,4,3,7,2,0,0,3,5,20,14.2,1.0,Kristaps Porziņģis,6,9,0.6666666666666666
283,10/28/2022,27.23835616438356,L,1,30.933333333333334,7,13,0.538,2,4,0.5,6,7,0.857,2,4,6,1,1,0,2,4,22,16.0,-13.0,Kristaps Porziņģis,5,9,0.5555555555555556
284,10/30/2022,27.243835616438357,L,1,27.916666666666668,8,16,0.5,0,4,0.0,1,2,0.5,7,6,13,1,0,2,3,3,17,13.2,-4.0,Kristaps Porziņģis,8,12,0.6666666666666666
285,10/31/2022,27.246575342465754,L,1,34.666666666666664,10,17,0.588,3,7,0.429,9,9,1.0,4,5,9,3,2,0,0,3,32,31.3,8.0,Kristaps Porziņģis,7,10,0.7
286,11/2/2022,27.252054794520546,W,1,34.4,9,13,0.692,1,4,0.25,11,11,1.0,0,9,9,3,1,3,1,1,30,31.0,7.0,Kristaps Porziņģis,8,9,0.8888888888888888
287,11/4/2022,27.257534246575343,L,1,25.683333333333334,4,11,0.364,2,4,0.5,4,6,0.667,3,7,10,1,0,0,1,2,14,10.2,-17.0,Kristaps Porziņģis,2,7,0.2857142857142857
288,11/6/2022,27.263013698630136,L,1,30.883333333333333,3,13,0.231,1,6,0.167,3,4,0.75,1,3,4,3,1,3,4,5,10,2.5,2.0,Kristaps Porziņģis,2,7,0.2857142857142857
289,11/7/2022,27.265753424657536,W,1,30.766666666666666,6,14,0.429,1,6,0.167,6,8,0.75,1,7,8,5,0,1,1,4,19,15.2,3.0,Kristaps Porziņģis,5,8,0.625
290,11/12/2022,27.279452054794522,W,1,32.6,12,20,0.6,4,8,0.5,3,5,0.6,1,9,10,2,1,2,1,0,31,27.2,24.0,Kristaps Porziņģis,8,12,0.6666666666666666
291,11/13/2022,27.28219178082192,W,1,31.383333333333333,7,15,0.467,6,10,0.6,5,6,0.833,3,3,6,2,2,2,2,4,25,21.1,10.0,Kristaps Porziņģis,1,5,0.2
292,11/16/2022,27.29041095890411,L,1,36.46666666666667,8,15,0.533,4,7,0.571,7,9,0.778,2,7,9,4,1,1,2,1,27,24.5,16.0,Kristaps Porziņģis,4,8,0.5
293,11/18/2022,27.295890410958904,W,1,39.4,7,20,0.35,1,6,0.167,5,7,0.714,2,15,17,5,1,2,1,5,20,16.8,-2.0,Kristaps Porziņģis,6,14,0.42857142857142855
294,11/20/2022,27.301369863013697,W,1,34.2,4,19,0.211,2,8,0.25,2,2,1.0,4,4,8,2,1,5,4,5,12,4.2,5.0,Kristaps Porziņģis,2,11,0.18181818181818182
295,11/23/2022,27.30958904109589,L,1,33.15,8,19,0.421,2,9,0.222,3,6,0.5,1,8,9,4,0,0,3,5,21,10.6,-3.0,Kristaps Porziņģis,6,10,0.6
296,11/25/2022,27.315068493150687,L,1,35.86666666666667,7,18,0.389,1,4,0.25,3,3,1.0,2,5,7,1,0,2,1,3,18,11.0,-6.0,Kristaps Porziņģis,6,14,0.42857142857142855
297,11/27/2022,27.32054794520548,L,1,26.3,7,11,0.636,0,1,0.0,7,8,0.875,0,4,4,2,0,0,1,2,21,16.5,-23.0,Kristaps Porziņģis,7,10,0.7
298,10/19/2022,27.23835616438356,W,1,34.5,8,19,0.421,3,10,0.3,3,5,0.6,1,12,13,2,0,2,2,4,22,14.6,7.0,Kyle Kuzma,5,9,0.5555555555555556
299,10/21/2022,27.243835616438357,W,1,33.9,8,16,0.5,4,8,0.5,6,7,0.857,1,5,6,2,0,0,1,1,26,19.8,6.0,Kyle Kuzma,4,8,0.5
300,10/23/2022,27.24931506849315,L,1,37.43333333333333,4,8,0.5,1,2,0.5,2,4,0.5,0,2,2,3,0,2,0,4,11,8.7,-5.0,Kyle Kuzma,3,6,0.5
301,10/25/2022,27.254794520547946,W,1,27.4,9,17,0.529,0,5,0.0,7,8,0.875,0,6,6,1,0,1,3,4,25,14.9,23.0,Kyle Kuzma,9,12,0.75
302,10/28/2022,27.263013698630136,L,1,37.3,7,19,0.368,3,7,0.429,1,1,1.0,0,9,9,3,1,0,3,4,18,8.7,2.0,Kyle Kuzma,4,12,0.3333333333333333
303,10/30/2022,27.268493150684932,L,1,28.45,3,13,0.231,1,5,0.2,2,2,1.0,1,7,8,1,1,0,0,3,9,4.4,-20.0,Kyle Kuzma,2,8,0.25
304,10/31/2022,27.27123287671233,L,1,32.7,3,5,0.6,1,1,1.0,2,2,1.0,1,6,7,2,0,1,1,3,9,9.1,6.0,Kyle Kuzma,2,4,0.5
305,11/2/2022,27.276712328767122,W,1,31.3,8,12,0.667,2,5,0.4,0,0,,2,6,8,4,0,0,4,4,18,13.2,2.0,Kyle Kuzma,6,7,0.8571428571428571
306,11/4/2022,27.28219178082192,L,1,23.716666666666665,5,12,0.417,3,8,0.375,6,8,0.75,0,5,5,2,0,0,1,2,19,12.9,-22.0,Kyle Kuzma,2,4,0.5
307,11/6/2022,27.28767123287671,L,1,34.36666666666667,5,14,0.357,2,9,0.222,0,0,,2,9,11,2,0,1,3,3,12,6.2,-5.0,Kyle Kuzma,3,5,0.6
308,11/7/2022,27.29041095890411,W,1,31.416666666666668,9,16,0.563,1,3,0.333,1,5,0.2,0,6,6,1,0,1,2,0,20,12.0,10.0,Kyle Kuzma,8,13,0.6153846153846154
309,11/10/2022,27.2986301369863,W,1,41.2,14,26,0.538,5,11,0.455,3,3,1.0,2,9,11,6,1,0,4,2,36,27.9,-2.0,Kyle Kuzma,9,15,0.6
310,11/12/2022,27.304109589041097,W,1,33.166666666666664,8,19,0.421,1,7,0.143,6,7,0.857,1,7,8,6,0,0,4,2,23,14.7,12.0,Kyle Kuzma,7,12,0.5833333333333334
311,11/13/2022,27.306849315068494,W,1,34.416666666666664,4,13,0.308,1,7,0.143,0,1,0.0,1,10,11,3,0,0,4,1,9,2.5,10.0,Kyle Kuzma,3,6,0.5
312,11/16/2022,27.315068493150687,L,1,38.93333333333333,7,15,0.467,3,8,0.375,1,1,1.0,2,8,10,9,1,0,7,3,18,13.2,13.0,Kyle Kuzma,4,7,0.5714285714285714
313,11/18/2022,27.32054794520548,W,1,40.46666666666667,9,24,0.375,2,12,0.167,1,3,0.333,0,8,8,5,1,0,4,2,21,9.1,1.0,Kyle Kuzma,7,12,0.5833333333333334
314,11/20/2022,27.326027397260273,W,1,37.766666666666666,10,19,0.526,4,9,0.444,4,5,0.8,1,9,10,5,0,0,4,2,28,20.4,7.0,Kyle Kuzma,6,10,0.6
315,11/23/2022,27.334246575342465,L,1,39.96666666666667,13,27,0.481,2,13,0.154,5,7,0.714,0,7,7,1,1,0,0,1,33,21.9,-9.0,Kyle Kuzma,11,14,0.7857142857142857
316,11/25/2022,27.339726027397262,L,1,38.86666666666667,11,22,0.5,3,10,0.3,3,3,1.0,3,4,7,5,1,0,3,2,28,21.0,-5.0,Kyle Kuzma,8,12,0.6666666666666666
317,10/19/2022,27.312328767123287,W,1,21.383333333333333,2,6,0.333,1,1,1.0,2,2,1.0,2,4,6,6,2,0,1,1,7,11.0,17.0,Monte Morris,1,5,0.2
318,10/21/2022,27.317808219178083,W,1,26.45,4,8,0.5,1,3,0.333,0,0,,0,4,4,3,1,1,0,0,9,10.0,5.0,Monte Morris,3,5,0.6
319,10/23/2022,27.323287671232876,L,1,26.5,5,8,0.625,3,3,1.0,0,0,,0,3,3,6,0,0,1,3,13,12.3,6.0,Monte Morris,2,5,0.4
320,10/25/2022,27.328767123287673,W,1,29.633333333333333,3,8,0.375,1,4,0.25,2,4,0.5,1,5,6,6,0,0,0,3,9,9.0,19.0,Monte Morris,2,4,0.5
321,10/28/2022,27.336986301369862,L,1,31.15,2,8,0.25,0,3,0.0,1,2,0.5,0,2,2,12,0,1,1,1,5,8.1,6.0,Monte Morris,2,5,0.4
322,10/30/2022,27.34246575342466,L,1,27.3,1,7,0.143,0,2,0.0,1,1,1.0,0,7,7,2,0,0,0,1,3,1.6,-26.0,Monte Morris,1,5,0.2
323,10/31/2022,27.345205479452055,L,1,35.13333333333333,7,13,0.538,2,3,0.667,3,3,1.0,0,3,3,4,3,0,3,1,19,16.0,6.0,Monte Morris,5,10,0.5
324,11/2/2022,27.350684931506848,W,1,24.0,2,5,0.4,0,3,0.0,2,3,0.667,0,1,1,6,1,0,0,0,6,8.4,-3.0,Monte Morris,2,2,1.0
325,11/4/2022,27.356164383561644,L,1,22.716666666666665,2,6,0.333,0,3,0.0,0,0,,0,3,3,5,0,0,3,0,4,2.0,-23.0,Monte Morris,2,3,0.6666666666666666
326,11/6/2022,27.361643835616437,L,1,33.15,7,12,0.583,2,5,0.4,2,2,1.0,0,0,0,1,1,0,0,1,18,13.7,-9.0,Monte Morris,5,7,0.7142857142857143
327,11/7/2022,27.364383561643837,W,1,32.45,3,7,0.429,1,1,1.0,1,2,0.5,2,3,5,2,0,1,1,1,8,6.9,4.0,Monte Morris,2,6,0.3333333333333333
328,11/10/2022,27.372602739726027,W,1,19.366666666666667,3,6,0.5,0,1,0.0,0,0,,0,1,1,3,0,0,1,2,6,3.6,-4.0,Monte Morris,3,5,0.6
329,11/12/2022,27.378082191780823,W,1,29.183333333333334,2,9,0.222,1,3,0.333,0,0,,1,6,7,9,0,0,0,1,5,7.9,15.0,Monte Morris,1,6,0.16666666666666666
330,11/13/2022,27.38082191780822,W,1,27.366666666666667,4,10,0.4,1,4,0.25,1,2,0.5,1,5,6,6,2,1,2,0,10,11.3,3.0,Monte Morris,3,6,0.5
331,11/16/2022,27.389041095890413,L,1,27.266666666666666,4,7,0.571,3,5,0.6,0,0,,0,3,3,4,2,0,0,3,11,12.2,24.0,Monte Morris,1,2,0.5
332,11/18/2022,27.394520547945206,W,1,26.366666666666667,3,8,0.375,0,5,0.0,0,0,,0,5,5,5,0,0,0,2,6,5.8,1.0,Monte Morris,3,3,1.0
333,11/27/2022,27.41917808219178,L,1,23.683333333333334,6,8,0.75,4,5,0.8,0,0,,0,3,3,8,0,0,0,2,16,18.5,-3.0,Monte Morris,2,3,0.6666666666666666
334,10/19/2022,24.693150684931506,W,0,24.0,3,7,0.429,1,1,1.0,0,0,,1,4,5,0,0,1,3,2,7,2.1,-6.0,Rui Hachimura,2,6,0.3333333333333333
335,10/21/2022,24.698630136986303,W,0,23.983333333333334,4,9,0.444,0,2,0.0,4,4,1.0,1,3,4,1,0,0,2,0,12,7.6,-17.0,Rui Hachimura,4,7,0.5714285714285714
336,10/23/2022,24.704109589041096,L,0,20.316666666666666,7,12,0.583,2,3,0.667,0,0,,1,2,3,1,0,0,1,1,16,11.0,-5.0,Rui Hachimura,5,9,0.5555555555555556
337,10/25/2022,24.70958904109589,W,0,26.8,4,8,0.5,0,1,0.0,2,2,1.0,0,4,4,1,0,0,1,0,10,6.9,-5.0,Rui Hachimura,4,7,0.5714285714285714
338,10/28/2022,24.71780821917808,L,0,24.983333333333334,3,7,0.429,0,1,0.0,4,6,0.667,1,4,5,0,0,1,1,2,10,6.3,-19.0,Rui Hachimura,3,6,0.5
339,10/30/2022,24.723287671232878,L,0,22.466666666666665,5,12,0.417,1,4,0.25,2,4,0.5,3,6,9,3,0,1,1,1,13,11.1,-17.0,Rui Hachimura,4,8,0.5
340,10/31/2022,24.726027397260275,L,0,17.916666666666668,4,9,0.444,0,2,0.0,2,2,1.0,1,5,6,0,2,1,2,0,10,8.2,-18.0,Rui Hachimura,4,7,0.5714285714285714
341,11/2/2022,24.731506849315068,W,0,32.88333333333333,5,13,0.385,0,2,0.0,0,0,,2,8,10,4,0,1,1,2,10,8.4,14.0,Rui Hachimura,5,11,0.45454545454545453
342,11/4/2022,24.736986301369864,L,0,17.683333333333334,1,5,0.2,0,1,0.0,0,0,,0,2,2,0,0,1,1,1,2,-1.2,-22.0,Rui Hachimura,1,4,0.25
343,11/6/2022,24.742465753424657,L,0,22.283333333333335,7,12,0.583,1,3,0.333,0,1,0.0,1,2,3,0,0,0,1,2,15,8.5,0.0,Rui Hachimura,6,9,0.6666666666666666
344,11/7/2022,24.745205479452054,W,0,26.3,6,12,0.5,0,0,,4,7,0.571,0,3,3,0,0,1,2,1,16,8.0,10.0,Rui Hachimura,6,12,0.5
345,11/10/2022,24.753424657534246,W,0,25.816666666666666,9,14,0.643,2,4,0.5,3,3,1.0,0,8,8,0,0,0,4,2,23,14.4,20.0,Rui Hachimura,7,10,0.7
346,11/12/2022,24.75890410958904,W,0,28.533333333333335,5,12,0.417,1,4,0.25,0,0,,0,4,4,1,0,1,1,1,11,5.8,-9.0,Rui Hachimura,4,8,0.5
347,11/13/2022,24.76164383561644,W,0,15.45,1,7,0.143,1,2,0.5,0,0,,0,2,2,1,0,0,0,1,3,-0.6,5.0,Rui Hachimura,0,5,0.0
348,11/16/2022,24.76986301369863,L,0,17.683333333333334,6,8,0.75,2,3,0.667,0,0,,0,1,1,2,3,0,0,0,14,15.5,-3.0,Rui Hachimura,4,5,0.8
349,11/18/2022,24.775342465753425,W,0,28.416666666666668,6,11,0.545,1,3,0.333,0,0,,1,7,8,3,0,0,1,2,13,10.8,-2.0,Rui Hachimura,5,8,0.625
350,10/19/2022,30.005479452054793,W,0,15.433333333333334,1,3,0.333,0,1,0.0,0,0,,0,2,2,0,0,1,0,3,2,0.4,0.0,Anthony Gill,1,2,0.5
351,10/21/2022,30.01095890410959,W,0,10.616666666666667,1,1,1.0,0,0,,0,0,,0,1,1,1,0,0,0,2,2,1.9,2.0,Anthony Gill,1,1,1.0
352,10/23/2022,30.016438356164382,L,0,10.05,1,3,0.333,0,2,0.0,0,0,,0,2,2,0,0,0,0,1,2,0.5,-9.0,Anthony Gill,1,1,1.0
353,10/25/2022,30.02191780821918,W,0,6.516666666666667,0,1,0.0,0,1,0.0,2,2,1.0,0,0,0,0,0,0,0,0,2,1.3,7.0,Anthony Gill,0,0,
354,10/28/2022,30.03013698630137,L,0,4.116666666666666,1,1,1.0,1,1,1.0,0,0,,1,0,1,1,0,0,0,1,3,3.7,3.0,Anthony Gill,0,0,
355,10/30/2022,30.035616438356165,L,0,18.683333333333334,4,6,0.667,0,1,0.0,2,2,1.0,3,2,5,2,1,0,0,2,10,11.7,8.0,Anthony Gill,4,5,0.8
356,10/31/2022,30.03835616438356,L,1,25.983333333333334,5,10,0.5,1,3,0.333,0,0,,2,2,4,2,0,0,2,0,11,7.4,7.0,Anthony Gill,4,7,0.5714285714285714
357,11/2/2022,30.043835616438358,W,1,16.716666666666665,1,1,1.0,0,0,,0,0,,0,2,2,0,0,0,0,2,2,1.5,2.0,Anthony Gill,1,1,1.0
358,11/4/2022,30.04931506849315,L,1,28.416666666666668,4,6,0.667,0,0,,0,0,,3,1,4,0,1,0,0,2,8,8.0,-16.0,Anthony Gill,4,6,0.6666666666666666
359,11/6/2022,30.054794520547944,L,0,2.6,0,0,,0,0,,0,0,,0,0,0,1,1,0,0,1,0,1.3,6.0,Anthony Gill,0,0,
360,11/7/2022,30.057534246575344,W,0,16.983333333333334,2,3,0.667,0,0,,2,2,1.0,1,0,1,1,0,0,0,3,6,4.9,-10.0,Anthony Gill,2,3,0.6666666666666666
361,11/10/2022,30.065753424657533,W,1,15.383333333333333,1,2,0.5,0,0,,0,0,,0,2,2,1,0,0,0,4,2,0.7,-7.0,Anthony Gill,1,2,0.5
362,11/12/2022,30.07123287671233,W,0,1.0833333333333333,0,0,,0,0,,0,0,,0,0,0,0,0,0,0,0,0,0.0,-4.0,Anthony Gill,0,0,
363,11/23/2022,30.101369863013698,L,0,12.516666666666667,1,1,1.0,0,0,,0,0,,0,1,1,0,1,2,2,2,2,1.6,2.0,Anthony Gill,1,1,1.0
364,11/25/2022,30.106849315068494,L,0,12.916666666666666,1,1,1.0,0,0,,0,0,,1,2,3,1,0,1,0,0,2,4.4,-1.0,Anthony Gill,1,1,1.0
365,11/27/2022,30.112328767123287,L,0,14.833333333333334,1,2,0.5,0,1,0.0,3,5,0.6,1,2,3,0,0,0,0,2,5,3.7,13.0,Anthony Gill,1,1,1.0
366,10/19/2022,29.30958904109589,W,1,37.516666666666666,9,17,0.529,2,7,0.286,3,3,1.0,2,3,5,6,0,1,3,2,23,18.1,8.0,Bradley Beal,7,10,0.7
367,10/21/2022,29.315068493150687,W,1,36.65,9,14,0.643,1,2,0.5,0,0,,0,1,1,8,0,2,5,2,19,14.3,4.0,Bradley Beal,8,12,0.6666666666666666
368,10/23/2022,29.32054794520548,L,1,41.583333333333336,11,16,0.688,0,1,0.0,5,7,0.714,1,3,4,5,2,0,6,3,27,19.3,-5.0,Bradley Beal,11,15,0.7333333333333333
369,10/25/2022,29.326027397260273,W,1,21.816666666666666,4,9,0.444,1,4,0.25,4,4,1.0,1,3,4,6,0,0,2,2,13,11.3,5.0,Bradley Beal,3,5,0.6
370,10/28/2022,29.334246575342465,L,1,37.21666666666667,11,18,0.611,2,5,0.4,7,7,1.0,2,5,7,4,3,1,2,3,31,29.0,-10.0,Bradley Beal,9,13,0.6923076923076923
371,10/30/2022,29.339726027397262,L,1,37.36666666666667,4,16,0.25,2,7,0.286,2,2,1.0,0,1,1,8,1,1,1,0,12,9.0,-13.0,Bradley Beal,2,9,0.2222222222222222
372,10/31/2022,29.34246575342466,L,1,37.85,7,18,0.389,2,6,0.333,4,4,1.0,0,5,5,6,0,1,4,3,20,11.4,0.0,Bradley Beal,5,12,0.4166666666666667
373,11/2/2022,29.34794520547945,W,1,36.5,11,17,0.647,1,2,0.5,6,7,0.857,0,2,2,5,0,0,1,2,29,23.4,6.0,Bradley Beal,10,15,0.6666666666666666
374,11/4/2022,29.353424657534248,L,1,29.6,8,18,0.444,2,6,0.333,2,2,1.0,0,3,3,3,2,1,0,1,20,15.9,-19.0,Bradley Beal,6,12,0.5
375,11/16/2022,29.386301369863013,L,1,37.016666666666666,9,19,0.474,2,4,0.5,5,5,1.0,2,4,6,6,1,1,1,1,25,22.4,10.0,Bradley Beal,7,15,0.4666666666666667
376,11/18/2022,29.39178082191781,W,1,48.5,9,18,0.5,5,9,0.556,4,4,1.0,0,2,2,8,1,0,7,2,27,17.4,10.0,Bradley Beal,4,9,0.4444444444444444
377,11/20/2022,29.397260273972602,W,1,40.55,11,21,0.524,3,7,0.429,1,2,0.5,0,4,4,5,5,0,5,4,26,18.4,4.0,Bradley Beal,8,14,0.5714285714285714
378,11/25/2022,29.410958904109588,L,1,37.8,11,20,0.55,4,7,0.571,2,3,0.667,2,3,5,5,1,3,1,3,28,24.7,-4.0,Bradley Beal,7,13,0.5384615384615384
379,11/27/2022,29.416438356164385,L,1,34.78333333333333,11,19,0.579,0,3,0.0,8,9,0.889,1,4,5,4,2,0,2,1,30,25.0,-28.0,Bradley Beal,11,16,0.6875
380,10/25/2022,24.005479452054793,W,0,2.3,1,1,1.0,0,0,,0,0,,1,2,3,0,0,0,1,0,2,2.0,0.0,Jordan Goodwin,1,1,1.0
381,10/30/2022,24.019178082191782,L,0,18.333333333333332,3,4,0.75,0,1,0.0,0,0,,0,2,2,2,1,1,1,1,6,6.7,8.0,Jordan Goodwin,3,3,1.0
382,11/4/2022,24.03287671232877,L,0,7.716666666666667,0,2,0.0,0,1,0.0,0,0,,0,0,0,1,0,0,0,1,0,-1.1,-5.0,Jordan Goodwin,0,1,0.0
383,11/6/2022,24.03835616438356,L,0,26.033333333333335,4,7,0.571,1,4,0.25,0,0,,4,4,8,5,2,1,0,3,9,14.7,12.0,Jordan Goodwin,3,3,1.0
384,11/7/2022,24.041095890410958,W,0,21.383333333333333,7,7,1.0,1,1,1.0,2,2,1.0,2,2,4,5,0,2,1,1,17,20.4,10.0,Jordan Goodwin,6,6,1.0
385,11/10/2022,24.04931506849315,W,0,28.733333333333334,1,4,0.25,0,1,0.0,0,0,,1,6,7,6,1,0,2,2,2,4.5,12.0,Jordan Goodwin,1,3,0.3333333333333333
386,11/12/2022,24.054794520547944,W,0,20.533333333333335,3,8,0.375,3,3,1.0,0,0,,1,1,2,2,1,2,0,3,9,8.2,-8.0,Jordan Goodwin,0,5,0.0
387,11/13/2022,24.057534246575344,W,0,26.133333333333333,3,7,0.429,3,4,0.75,1,2,0.5,1,7,8,4,1,1,0,2,10,12.4,3.0,Jordan Goodwin,0,3,0.0
388,11/16/2022,24.065753424657533,L,0,19.716666666666665,2,3,0.667,0,0,,0,0,,2,1,3,1,0,1,3,2,4,2.0,-15.0,Jordan Goodwin,2,3,0.6666666666666666
389,11/20/2022,24.076712328767123,W,0,24.483333333333334,2,4,0.5,1,1,1.0,0,2,0.0,1,1,2,1,0,3,1,2,5,4.2,-13.0,Jordan Goodwin,1,3,0.3333333333333333
390,11/23/2022,24.084931506849315,L,1,24.65,3,7,0.429,1,2,0.5,1,3,0.333,0,1,1,3,1,0,0,2,8,6.1,-1.0,Jordan Goodwin,2,5,0.4
391,11/25/2022,24.09041095890411,L,0,25.066666666666666,2,4,0.5,1,2,0.5,2,2,1.0,1,5,6,2,2,0,2,3,7,7.4,0.0,Jordan Goodwin,1,2,0.5
392,11/27/2022,24.095890410958905,L,0,24.316666666666666,4,8,0.5,0,3,0.0,1,2,0.5,0,1,1,2,2,1,0,3,9,7.8,-6.0,Jordan Goodwin,4,5,0.8
393,11/4/2022,23.673972602739727,L,0,18.116666666666667,0,6,0.0,0,5,0.0,2,2,1.0,0,1,1,2,0,0,2,0,2,-2.5,-9.0,Corey Kispert,0,1,0.0
394,11/6/2022,23.67945205479452,L,1,23.783333333333335,3,6,0.5,0,3,0.0,0,1,0.0,0,3,3,3,0,0,0,0,6,5.6,-15.0,Corey Kispert,3,3,1.0
395,11/7/2022,23.682191780821917,W,1,19.25,3,4,0.75,1,2,0.5,1,1,1.0,0,3,3,1,0,0,1,4,8,5.4,-7.0,Corey Kispert,2,2,1.0
396,11/10/2022,23.69041095890411,W,1,23.433333333333334,2,4,0.5,1,2,0.5,2,2,1.0,0,0,0,1,2,0,0,1,7,7.3,5.0,Corey Kispert,1,2,0.5
397,11/12/2022,23.695890410958903,W,1,28.75,6,6,1.0,4,4,1.0,2,2,1.0,0,4,4,2,1,0,0,2,18,19.0,14.0,Corey Kispert,2,2,1.0
398,11/13/2022,23.698630136986303,W,1,32.05,5,8,0.625,2,2,1.0,0,0,,0,2,2,1,2,0,1,0,12,10.7,13.0,Corey Kispert,3,6,0.5
399,11/16/2022,23.706849315068492,L,0,11.166666666666666,1,3,0.333,0,2,0.0,0,0,,0,0,0,2,0,0,2,1,2,-0.7,-20.0,Corey Kispert,1,1,1.0
400,11/18/2022,23.71232876712329,W,0,38.483333333333334,6,9,0.667,5,8,0.625,0,0,,2,2,4,3,2,0,0,2,17,18.4,8.0,Corey Kispert,1,1,1.0
401,11/20/2022,23.71780821917808,W,1,32.333333333333336,4,7,0.571,2,3,0.667,4,4,1.0,2,4,6,3,0,1,0,0,14,16.1,19.0,Corey Kispert,2,4,0.5
402,11/23/2022,23.726027397260275,L,1,39.36666666666667,3,8,0.375,2,6,0.333,0,0,,1,1,2,2,1,0,2,1,8,4.6,-5.0,Corey Kispert,1,2,0.5
403,11/25/2022,23.731506849315068,L,1,34.53333333333333,2,9,0.222,1,7,0.143,0,1,0.0,2,0,2,4,1,0,1,2,5,2.5,-9.0,Corey Kispert,1,2,0.5
404,11/27/2022,23.736986301369864,L,1,21.866666666666667,3,8,0.375,1,3,0.333,1,2,0.5,0,1,1,0,0,0,0,1,8,3.1,-18.0,Corey Kispert,2,5,0.4
405,10/25/2022,37.33698630136986,W,0,2.9,0,1,0.0,0,1,0.0,0,0,,0,0,0,0,0,0,0,0,0,-0.7,1.0,Taj Gibson,0,0,
406,10/30/2022,37.35068493150685,L,0,5.216666666666667,3,4,0.75,1,2,0.5,0,0,,0,1,1,0,0,0,0,0,7,5.7,4.0,Taj Gibson,2,2,1.0
407,10/31/2022,37.35342465753425,L,0,2.6833333333333336,0,0,,0,0,,2,2,1.0,0,0,0,0,0,0,0,1,2,1.6,-3.0,Taj Gibson,0,0,
408,11/4/2022,37.364383561643834,L,0,7.716666666666667,1,3,0.333,0,0,,2,2,1.0,0,3,3,0,0,0,0,1,4,2.8,-5.0,Taj Gibson,1,3,0.3333333333333333
409,11/6/2022,37.36986301369863,L,0,3.55,1,2,0.5,0,1,0.0,0,0,,1,0,1,1,0,0,0,0,2,2.4,-11.0,Taj Gibson,1,1,1.0
410,11/7/2022,37.37260273972603,W,0,5.166666666666667,0,1,0.0,0,0,,0,0,,1,0,1,2,1,0,1,1,0,1.0,3.0,Taj Gibson,0,1,0.0
411,11/18/2022,37.4027397260274,W,0,16.233333333333334,0,2,0.0,0,0,,0,0,,3,5,8,1,1,2,1,4,0,2.7,12.0,Taj Gibson,0,2,0.0
412,11/20/2022,37.40821917808219,W,0,5.833333333333333,1,3,0.333,0,1,0.0,0,0,,1,1,2,0,0,0,0,2,2,0.5,2.0,Taj Gibson,1,2,0.5
413,11/23/2022,37.416438356164385,L,0,4.916666666666667,2,3,0.667,0,0,,0,0,,0,0,0,0,0,0,0,0,4,2.7,5.0,Taj Gibson,2,3,0.6666666666666666
414,11/27/2022,37.42739726027397,L,0,12.3,4,6,0.667,0,1,0.0,4,4,1.0,0,0,0,0,1,0,0,2,12,9.6,7.0,Taj Gibson,4,5,0.8
415,10/25/2022,20.65753424657534,W,0,2.9,0,2,0.0,0,1,0.0,0,0,,0,1,1,0,0,0,0,0,0,-1.1,1.0,Johnny Davis,0,1,0.0
416,10/28/2022,20.665753424657535,L,0,7.283333333333333,1,2,0.5,0,0,,0,0,,0,0,0,1,0,0,0,2,2,0.9,-13.0,Johnny Davis,1,2,0.5
417,10/30/2022,20.671232876712327,L,0,8.283333333333333,1,3,0.333,0,0,,0,0,,0,1,1,0,0,0,0,4,2,-1.0,3.0,Johnny Davis,1,3,0.3333333333333333
418,10/31/2022,20.673972602739727,L,0,4.25,0,0,,0,0,,0,0,,0,0,0,1,0,0,0,0,0,0.7,0.0,Johnny Davis,0,0,
419,11/4/2022,20.684931506849313,L,0,7.716666666666667,0,0,,0,0,,2,2,1.0,1,1,2,0,0,0,1,2,2,1.2,-5.0,Johnny Davis,0,0,
420,11/20/2022,20.72876712328767,W,0,4.983333333333333,0,1,0.0,0,0,,0,0,,0,0,0,0,0,0,0,1,0,-1.1,-7.0,Johnny Davis,0,1,0.0
421,11/23/2022,20.736986301369864,L,0,5.55,0,0,,0,0,,0,0,,0,1,1,0,0,1,0,0,0,1.0,-6.0,Johnny Davis,0,0,
422,10/19/2022,30.482191780821918,W,0,26.616666666666667,3,7,0.429,1,3,0.333,1,2,0.5,1,2,3,1,2,2,1,4,8,6.7,-10.0,Delon Wright,2,4,0.5
423,10/21/2022,30.487671232876714,W,0,21.55,3,8,0.375,0,3,0.0,0,0,,2,1,3,4,3,1,2,1,6,7.4,-3.0,Delon Wright,3,5,0.6
424,10/23/2022,30.493150684931507,L,0,26.5,2,5,0.4,1,3,0.333,2,3,0.667,0,2,2,5,2,0,1,0,7,9.0,-16.0,Delon Wright,1,2,0.5
425,10/25/2022,30.4986301369863,W,0,16.066666666666666,2,4,0.5,1,3,0.333,0,0,,1,1,2,3,4,1,0,0,5,10.8,2.0,Delon Wright,1,1,1.0
426,10/25/2022,21.02191780821918,W,0,2.5666666666666664,0,0,,0,0,,0,0,,0,0,0,0,0,0,0,0,0,0.0,2.0,Isaiah Todd,0,0,
427,10/28/2022,21.03013698630137,L,0,1.0166666666666666,0,1,0.0,0,1,0.0,0,0,,0,0,0,0,0,0,0,0,0,-0.7,2.0,Isaiah Todd,0,0,
428,10/30/2022,21.035616438356165,L,0,5.216666666666667,1,2,0.5,0,1,0.0,0,0,,0,0,0,0,0,0,0,0,2,1.0,4.0,Isaiah Todd,1,1,1.0
429,10/28/2022,21.671232876712327,L,0,1.0166666666666666,0,0,,0,0,,0,0,,0,0,0,0,0,0,0,0,0,0.0,2.0,Vernon Carey Jr.,0,0,
430,11/12/2022,21.71232876712329,W,0,1.0833333333333333,0,0,,0,0,,0,0,,0,0,0,0,0,0,0,1,0,-0.4,-4.0,Vernon Carey Jr.,0,0,
431,10/19/2022,36.56986301369863,L,1,34.65,1,7,0.143,0,5,0.0,0,0,,0,5,5,4,1,0,3,4,2,-1.8,-13.0,Kyle Lowry,1,2,0.5
432,10/21/2022,36.57534246575342,L,1,33.38333333333333,4,13,0.308,3,7,0.429,6,8,0.75,1,3,4,6,3,1,0,3,17,17.0,2.0,Kyle Lowry,1,6,0.16666666666666666
433,10/22/2022,36.57808219178082,W,1,37.25,5,11,0.455,3,7,0.429,4,4,1.0,0,2,2,6,1,0,3,4,17,12.5,-7.0,Kyle Lowry,2,4,0.5
434,10/24/2022,36.583561643835615,L,1,36.1,1,8,0.125,1,6,0.167,4,4,1.0,0,3,3,2,0,0,0,2,7,3.3,0.0,Kyle Lowry,0,2,0.0
435,10/26/2022,36.58904109589041,W,1,26.45,5,8,0.625,5,7,0.714,2,3,0.667,0,2,2,6,1,1,3,2,17,15.7,8.0,Kyle Lowry,0,1,0.0
436,10/27/2022,36.59178082191781,L,1,33.13333333333333,4,10,0.4,2,8,0.25,2,2,1.0,1,4,5,8,3,0,2,4,12,13.5,-9.0,Kyle Lowry,2,2,1.0
437,10/29/2022,36.5972602739726,L,1,36.766666666666666,3,8,0.375,1,4,0.25,8,8,1.0,1,4,5,5,2,1,2,4,15,15.1,-1.0,Kyle Lowry,2,4,0.5
438,11/1/2022,36.605479452054794,W,1,36.56666666666667,5,10,0.5,3,8,0.375,0,0,,1,4,5,9,0,0,2,1,13,13.8,-3.0,Kyle Lowry,2,2,1.0
439,11/2/2022,36.608219178082194,W,1,37.93333333333333,8,14,0.571,2,7,0.286,4,5,0.8,1,4,5,7,2,0,3,2,22,20.0,-7.0,Kyle Lowry,6,7,0.8571428571428571
440,11/4/2022,36.61369863013699,L,1,37.53333333333333,1,9,0.111,1,6,0.167,7,7,1.0,2,4,6,3,2,1,1,3,10,9.3,-2.0,Kyle Lowry,0,3,0.0
441,11/7/2022,36.62191780821918,L,1,34.766666666666666,5,8,0.625,4,6,0.667,1,1,1.0,0,7,7,8,0,0,3,4,15,14.5,-4.0,Kyle Lowry,1,2,0.5
442,11/10/2022,36.63013698630137,W,1,38.833333333333336,3,6,0.5,2,5,0.4,2,2,1.0,0,3,3,3,0,1,1,1,10,9.3,0.0,Kyle Lowry,1,1,1.0
443,11/12/2022,36.635616438356166,W,1,31.816666666666666,5,12,0.417,1,6,0.167,1,1,1.0,1,10,11,8,0,1,3,2,12,11.8,14.0,Kyle Lowry,4,6,0.6666666666666666
444,11/14/2022,36.64109589041096,W,1,38.766666666666666,5,14,0.357,2,5,0.4,3,4,0.75,1,2,3,6,1,0,5,1,15,7.9,7.0,Kyle Lowry,3,9,0.3333333333333333
445,11/16/2022,36.64657534246575,L,1,35.56666666666667,6,9,0.667,4,7,0.571,3,4,0.75,0,1,1,2,1,1,4,5,19,12.1,1.0,Kyle Lowry,2,2,1.0
446,11/18/2022,36.652054794520545,L,1,50.9,8,23,0.348,4,11,0.364,4,6,0.667,1,9,10,15,1,2,3,5,24,21.6,4.0,Kyle Lowry,4,12,0.3333333333333333
447,11/20/2022,36.657534246575345,L,1,31.116666666666667,2,10,0.2,1,7,0.143,4,5,0.8,1,3,4,3,0,1,5,1,9,1.4,-21.0,Kyle Lowry,1,3,0.3333333333333333
448,11/21/2022,36.66027397260274,L,1,44.36666666666667,5,16,0.313,4,11,0.364,7,11,0.636,0,5,5,9,3,2,4,1,21,18.0,-12.0,Kyle Lowry,1,5,0.2
449,11/23/2022,36.66575342465753,W,1,35.21666666666667,7,12,0.583,5,6,0.833,9,9,1.0,2,4,6,3,0,1,4,5,28,21.8,19.0,Kyle Lowry,2,6,0.3333333333333333
450,11/25/2022,36.67123287671233,W,1,39.483333333333334,4,12,0.333,2,6,0.333,3,3,1.0,2,5,7,8,1,0,0,3,13,14.5,0.0,Kyle Lowry,2,6,0.3333333333333333
451,11/27/2022,36.676712328767124,W,1,32.81666666666667,2,9,0.222,1,7,0.143,4,4,1.0,1,2,3,9,2,1,2,3,9,10.6,13.0,Kyle Lowry,1,2,0.5
452,10/19/2022,27.057534246575344,L,1,28.616666666666667,3,9,0.333,1,3,0.333,0,0,,1,3,4,3,2,0,0,2,7,6.8,-7.0,Caleb Martin,2,6,0.3333333333333333
453,10/21/2022,27.063013698630137,L,1,28.766666666666666,2,7,0.286,0,1,0.0,0,0,,3,4,7,0,1,0,0,2,4,3.4,0.0,Caleb Martin,2,6,0.3333333333333333
454,10/22/2022,27.065753424657533,W,1,22.116666666666667,3,8,0.375,0,2,0.0,2,2,1.0,2,3,5,2,1,0,1,4,8,5.7,17.0,Caleb Martin,3,6,0.5
455,10/26/2022,27.076712328767123,W,1,29.366666666666667,7,8,0.875,2,2,1.0,0,0,,4,4,8,3,4,0,2,3,16,20.1,19.0,Caleb Martin,5,6,0.8333333333333334
456,10/27/2022,27.07945205479452,L,1,29.466666666666665,3,10,0.3,2,4,0.5,0,0,,1,0,1,1,1,0,1,1,8,3.2,-1.0,Caleb Martin,1,6,0.16666666666666666
457,10/29/2022,27.084931506849315,L,1,25.933333333333334,3,9,0.333,1,2,0.5,2,2,1.0,1,3,4,1,2,0,0,3,9,7.0,-4.0,Caleb Martin,2,7,0.2857142857142857
458,11/1/2022,27.09315068493151,W,1,19.383333333333333,2,4,0.5,1,2,0.5,0,0,,1,3,4,0,0,0,1,1,5,3.2,-18.0,Caleb Martin,1,2,0.5
459,11/2/2022,27.095890410958905,W,1,29.6,3,7,0.429,0,1,0.0,2,2,1.0,2,1,3,2,1,0,1,2,8,6.6,5.0,Caleb Martin,3,6,0.5
460,11/4/2022,27.101369863013698,L,1,27.833333333333332,3,5,0.6,0,1,0.0,0,0,,1,3,4,2,0,1,2,3,6,4.2,8.0,Caleb Martin,3,4,0.75
461,11/7/2022,27.10958904109589,L,1,34.75,5,11,0.455,0,5,0.0,0,0,,3,2,5,1,1,0,0,0,10,8.7,-4.0,Caleb Martin,5,6,0.8333333333333334
462,11/10/2022,27.117808219178084,W,1,30.75,3,8,0.375,2,4,0.5,1,2,0.5,2,2,4,2,1,0,1,2,9,6.8,4.0,Caleb Martin,1,4,0.25
463,11/12/2022,27.123287671232877,W,1,33.766666666666666,3,8,0.375,0,1,0.0,1,3,0.333,2,2,4,4,1,0,2,3,7,4.4,27.0,Caleb Martin,3,7,0.42857142857142855
464,11/14/2022,27.12876712328767,W,1,36.6,5,8,0.625,5,6,0.833,0,0,,2,3,5,3,2,2,0,0,15,19.2,10.0,Caleb Martin,0,2,0.0
465,11/16/2022,27.134246575342466,L,1,38.333333333333336,6,10,0.6,2,4,0.5,0,0,,2,7,9,3,0,2,3,3,14,12.2,-1.0,Caleb Martin,4,6,0.6666666666666666
466,11/18/2022,27.13972602739726,L,1,47.016666666666666,3,12,0.25,2,5,0.4,4,4,1.0,1,4,5,3,2,1,3,1,12,8.1,1.0,Caleb Martin,1,7,0.14285714285714285
467,11/20/2022,27.145205479452056,L,1,34.25,7,12,0.583,1,5,0.2,2,2,1.0,2,1,3,2,0,0,2,2,17,11.7,-12.0,Caleb Martin,6,7,0.8571428571428571
468,11/21/2022,27.147945205479452,L,1,40.1,3,7,0.429,0,2,0.0,2,4,0.5,3,3,6,3,3,1,1,2,8,10.5,-1.0,Caleb Martin,3,5,0.6
469,11/23/2022,27.153424657534245,W,1,40.483333333333334,10,17,0.588,4,9,0.444,0,0,,4,5,9,4,2,1,0,2,24,25.1,-2.0,Caleb Martin,6,8,0.75
470,11/25/2022,27.15890410958904,W,1,38.4,7,11,0.636,2,4,0.5,4,5,0.8,0,4,4,1,1,0,2,2,20,14.8,13.0,Caleb Martin,5,7,0.7142857142857143
471,11/27/2022,27.164383561643834,W,1,40.86666666666667,8,12,0.667,2,3,0.667,2,2,1.0,1,8,9,4,2,1,1,2,20,21.6,9.0,Caleb Martin,6,9,0.6666666666666666
472,10/19/2022,25.254794520547946,L,1,33.983333333333334,5,15,0.333,0,0,,2,3,0.667,1,8,9,2,0,1,5,4,12,1.7,-15.0,Bam Adebayo,5,15,0.3333333333333333
473,10/21/2022,25.26027397260274,L,1,34.88333333333333,8,11,0.727,0,0,,3,4,0.75,3,5,8,5,2,0,5,4,19,16.6,20.0,Bam Adebayo,8,11,0.7272727272727273
474,10/22/2022,25.263013698630136,W,1,35.7,4,6,0.667,0,1,0.0,2,2,1.0,0,7,7,1,0,0,3,3,10,6.0,5.0,Bam Adebayo,4,5,0.8
475,10/24/2022,25.268493150684932,L,1,37.68333333333333,4,14,0.286,0,0,,6,6,1.0,4,6,10,3,1,2,3,1,14,11.5,5.0,Bam Adebayo,4,14,0.2857142857142857
476,10/26/2022,25.273972602739725,W,1,28.35,6,11,0.545,0,1,0.0,6,7,0.857,3,5,8,3,1,0,3,3,18,14.8,17.0,Bam Adebayo,6,10,0.6
477,10/27/2022,25.276712328767122,L,1,37.733333333333334,10,13,0.769,0,0,,6,8,0.75,4,4,8,1,4,3,5,2,26,25.1,-12.0,Bam Adebayo,10,13,0.7692307692307693
478,10/29/2022,25.28219178082192,L,1,37.71666666666667,9,16,0.563,0,0,,5,6,0.833,2,4,6,4,0,2,1,6,23,18.4,6.0,Bam Adebayo,9,16,0.5625
479,11/1/2022,25.29041095890411,W,1,37.18333333333333,8,15,0.533,0,0,,3,3,1.0,1,6,7,6,3,1,2,4,19,18.5,0.0,Bam Adebayo,8,15,0.5333333333333333
480,11/2/2022,25.293150684931508,W,1,32.1,9,16,0.563,0,0,,2,2,1.0,2,9,11,6,0,0,4,5,20,14.7,2.0,Bam Adebayo,9,16,0.5625
481,11/4/2022,25.2986301369863,L,1,33.86666666666667,7,14,0.5,0,1,0.0,4,4,1.0,3,7,10,4,1,0,5,4,18,12.4,3.0,Bam Adebayo,7,13,0.5384615384615384
482,11/7/2022,25.306849315068494,L,1,33.36666666666667,8,14,0.571,0,0,,0,1,0.0,2,3,5,3,1,1,1,1,16,13.7,2.0,Bam Adebayo,8,14,0.5714285714285714
483,11/10/2022,25.315068493150687,W,1,38.6,6,15,0.4,0,1,0.0,6,6,1.0,2,12,14,4,2,0,5,5,18,12.7,9.0,Bam Adebayo,6,14,0.42857142857142855
484,11/12/2022,25.32054794520548,W,1,33.06666666666667,11,18,0.611,0,0,,2,3,0.667,1,14,15,4,1,1,5,4,24,18.2,19.0,Bam Adebayo,11,18,0.6111111111111112
485,11/14/2022,25.326027397260273,W,1,36.233333333333334,9,18,0.5,0,1,0.0,12,14,0.857,6,4,10,1,1,0,3,2,30,23.5,12.0,Bam Adebayo,9,17,0.5294117647058824
486,11/20/2022,25.34246575342466,L,1,26.966666666666665,7,14,0.5,0,0,,7,7,1.0,2,4,6,3,0,1,3,2,21,15.6,-20.0,Bam Adebayo,7,14,0.5
487,11/21/2022,25.345205479452055,L,1,34.983333333333334,7,18,0.389,0,2,0.0,3,6,0.5,4,10,14,5,0,2,1,5,17,13.7,-11.0,Bam Adebayo,7,16,0.4375
488,11/23/2022,25.350684931506848,W,1,35.35,5,15,0.333,0,0,,5,6,0.833,4,7,11,2,2,1,2,4,15,11.5,6.0,Bam Adebayo,5,15,0.3333333333333333
489,11/25/2022,25.356164383561644,W,1,35.3,15,22,0.682,0,1,0.0,8,8,1.0,3,9,12,3,0,0,0,4,38,33.9,1.0,Bam Adebayo,15,21,0.7142857142857143
490,11/27/2022,25.361643835616437,W,1,33.7,13,20,0.65,0,0,,6,6,1.0,1,7,8,1,0,1,3,2,32,23.6,1.0,Bam Adebayo,13,20,0.65
491,10/19/2022,26.561643835616437,L,0,30.816666666666666,7,9,0.778,5,7,0.714,3,5,0.6,1,6,7,1,0,0,2,3,22,17.7,3.0,Max Strus,2,2,1.0
492,10/21/2022,26.567123287671233,L,0,23.4,1,5,0.2,0,3,0.0,0,0,,0,1,1,1,0,0,1,1,2,-1.5,-25.0,Max Strus,1,2,0.5
493,10/22/2022,26.56986301369863,W,0,37.11666666666667,8,14,0.571,3,7,0.429,1,1,1.0,0,5,5,3,0,2,0,1,20,18.0,-2.0,Max Strus,5,7,0.7142857142857143
494,10/24/2022,26.575342465753426,L,1,30.183333333333334,3,14,0.214,0,8,0.0,0,0,,1,5,6,2,0,0,0,3,6,-0.2,10.0,Max Strus,3,6,0.5
495,10/26/2022,26.58082191780822,W,0,27.65,6,11,0.545,4,7,0.571,0,0,,3,6,9,3,2,0,3,1,16,15.3,24.0,Max Strus,2,4,0.5
496,10/27/2022,26.583561643835615,L,0,32.13333333333333,5,11,0.455,3,8,0.375,1,2,0.5,1,4,5,0,0,2,0,1,14,10.8,-16.0,Max Strus,2,3,0.6666666666666666
497,10/29/2022,26.589041095890412,L,0,34.45,4,15,0.267,3,11,0.273,0,0,,2,3,5,1,1,0,0,4,11,4.5,-11.0,Max Strus,1,4,0.25
498,11/1/2022,26.5972602739726,W,0,32.6,8,17,0.471,4,10,0.4,4,4,1.0,0,1,1,2,1,0,2,2,24,15.2,5.0,Max Strus,4,7,0.5714285714285714
499,11/2/2022,26.6,W,1,32.96666666666667,4,7,0.571,2,5,0.4,0,0,,0,0,0,4,0,1,0,3,10,9.0,-1.0,Max Strus,2,2,1.0
500,11/4/2022,26.605479452054794,L,1,39.63333333333333,6,13,0.462,3,7,0.429,2,2,1.0,1,6,7,3,2,0,3,3,17,12.7,5.0,Max Strus,3,6,0.5
501,11/7/2022,26.613698630136987,L,1,25.2,6,10,0.6,4,8,0.5,0,0,,0,0,0,2,1,0,0,5,16,11.8,2.0,Max Strus,2,2,1.0
502,11/10/2022,26.621917808219177,W,1,39.71666666666667,5,15,0.333,2,11,0.182,0,0,,0,1,1,1,2,0,1,3,12,4.3,3.0,Max Strus,3,4,0.75
503,11/12/2022,26.627397260273973,W,1,38.2,10,16,0.625,8,14,0.571,3,3,1.0,0,4,4,2,1,0,0,4,31,25.8,15.0,Max Strus,2,2,1.0
504,11/14/2022,26.632876712328766,W,1,36.166666666666664,2,8,0.25,1,5,0.2,0,0,,1,2,3,2,1,0,2,2,5,1.1,4.0,Max Strus,1,3,0.3333333333333333
505,11/16/2022,26.638356164383563,L,1,35.416666666666664,6,11,0.545,3,8,0.375,5,5,1.0,0,3,3,0,2,1,3,0,20,15.3,-7.0,Max Strus,3,3,1.0
506,11/18/2022,26.643835616438356,L,1,45.21666666666667,8,24,0.333,3,14,0.214,3,3,1.0,0,5,5,2,0,0,1,0,22,10.3,-7.0,Max Strus,5,10,0.5
507,11/20/2022,26.649315068493152,L,1,32.96666666666667,3,9,0.333,2,5,0.4,0,0,,0,0,0,2,1,0,1,2,8,3.5,-20.0,Max Strus,1,4,0.25
508,11/21/2022,26.65205479452055,L,1,40.38333333333333,7,23,0.304,4,15,0.267,1,1,1.0,1,5,6,2,1,0,4,4,19,4.7,-6.0,Max Strus,3,8,0.375
509,11/27/2022,26.66849315068493,W,1,32.95,6,15,0.4,4,10,0.4,0,0,,0,3,3,1,0,0,2,2,16,6.7,8.0,Max Strus,2,5,0.4
510,10/19/2022,33.18630136986302,L,0,13.45,5,6,0.833,1,1,1.0,0,0,,1,2,3,1,0,0,2,5,11,6.8,5.0,Dewayne Dedmon,4,5,0.8
511,10/21/2022,33.19178082191781,L,0,8.716666666666667,1,3,0.333,0,1,0.0,0,0,,0,0,0,0,0,0,0,2,2,-0.5,-18.0,Dewayne Dedmon,1,2,0.5
512,10/22/2022,33.1945205479452,W,0,12.333333333333334,1,1,1.0,0,0,,0,0,,1,2,3,1,0,0,1,2,2,1.9,-2.0,Dewayne Dedmon,1,1,1.0
513,10/24/2022,33.2,L,0,10.316666666666666,0,1,0.0,0,0,,0,0,,0,1,1,0,0,0,0,1,0,-0.8,-13.0,Dewayne Dedmon,0,1,0.0
514,10/26/2022,33.205479452054796,W,0,5.25,1,1,1.0,0,0,,0,0,,0,1,1,0,0,0,0,2,2,1.2,1.0,Dewayne Dedmon,1,1,1.0
515,11/1/2022,33.221917808219175,W,0,10.816666666666666,2,4,0.5,1,3,0.333,4,4,1.0,0,5,5,0,0,0,1,0,9,7.5,7.0,Dewayne Dedmon,1,1,1.0
516,11/2/2022,33.224657534246575,W,0,15.9,4,6,0.667,2,3,0.667,0,0,,2,6,8,3,0,1,1,3,10,11.2,1.0,Dewayne Dedmon,2,3,0.6666666666666666
517,11/4/2022,33.23013698630137,L,0,14.133333333333333,0,2,0.0,0,1,0.0,4,4,1.0,1,3,4,0,0,0,1,2,4,2.4,-5.0,Dewayne Dedmon,0,1,0.0
518,11/7/2022,33.23835616438356,L,0,14.616666666666667,3,5,0.6,0,1,0.0,4,4,1.0,0,6,6,1,0,0,0,0,10,10.2,-5.0,Dewayne Dedmon,3,4,0.75
519,11/10/2022,33.24657534246575,W,0,14.4,3,6,0.5,0,1,0.0,1,4,0.25,1,1,2,0,1,0,0,5,7,2.8,-4.0,Dewayne Dedmon,3,5,0.6
520,11/12/2022,33.25205479452055,W,0,13.3,3,7,0.429,1,2,0.5,0,0,,3,1,4,2,0,3,0,2,7,8.4,-2.0,Dewayne Dedmon,2,5,0.4
521,11/14/2022,33.25753424657534,W,0,11.766666666666667,5,7,0.714,2,3,0.667,0,0,,3,1,4,0,0,1,0,0,12,12.2,-11.0,Dewayne Dedmon,3,4,0.75
522,11/16/2022,33.26301369863014,L,0,15.916666666666666,4,4,1.0,0,0,,1,3,0.333,0,0,0,0,0,0,2,2,9,4.2,-7.0,Dewayne Dedmon,4,4,1.0
523,11/20/2022,33.273972602739725,L,0,13.133333333333333,3,8,0.375,0,2,0.0,4,4,1.0,1,4,5,0,1,1,1,0,10,8.2,-10.0,Dewayne Dedmon,3,6,0.5
524,11/21/2022,33.276712328767125,L,0,12.4,3,7,0.429,1,2,0.5,3,4,0.75,1,2,3,3,0,0,0,3,10,8.1,5.0,Dewayne Dedmon,2,5,0.4
525,11/23/2022,33.28219178082192,W,0,12.65,3,5,0.6,0,1,0.0,3,3,1.0,0,2,2,1,0,2,0,1,9,9.0,2.0,Dewayne Dedmon,3,4,0.75
526,11/25/2022,33.28767123287671,W,0,12.7,4,8,0.5,0,0,,1,1,1.0,2,3,5,0,1,0,1,1,9,6.9,2.0,Dewayne Dedmon,4,8,0.5
527,11/27/2022,33.293150684931504,W,0,14.3,6,7,0.857,1,2,0.5,0,2,0.0,1,5,6,0,1,0,1,1,13,11.5,7.0,Dewayne Dedmon,5,5,1.0
528,10/19/2022,26.34794520547945,L,0,16.05,1,4,0.25,0,1,0.0,0,0,,0,0,0,3,0,0,4,1,2,-2.7,7.0,Gabe Vincent,1,3,0.3333333333333333
529,10/21/2022,26.353424657534248,L,0,24.1,7,13,0.538,3,5,0.6,0,0,,0,0,0,2,1,0,2,3,17,9.9,-6.0,Gabe Vincent,4,8,0.5
530,10/22/2022,26.356164383561644,W,0,23.733333333333334,3,7,0.429,1,5,0.2,2,2,1.0,0,7,7,4,0,0,3,2,9,6.4,0.0,Gabe Vincent,2,2,1.0
531,10/24/2022,26.361643835616437,L,0,25.85,1,3,0.333,0,1,0.0,1,2,0.5,0,1,1,4,1,1,2,1,3,3.3,-18.0,Gabe Vincent,1,2,0.5
532,10/26/2022,26.367123287671234,W,0,20.266666666666666,2,5,0.4,0,2,0.0,4,4,1.0,1,0,1,7,0,0,1,0,8,9.9,11.0,Gabe Vincent,2,3,0.6666666666666666
533,10/27/2022,26.36986301369863,L,0,17.95,3,8,0.375,1,4,0.25,2,3,0.667,0,1,1,3,1,0,0,3,9,6.4,-3.0,Gabe Vincent,2,4,0.5
534,10/29/2022,26.375342465753423,L,0,19.733333333333334,1,4,0.25,1,2,0.5,0,0,,0,1,1,1,0,0,0,4,3,0.0,-14.0,Gabe Vincent,0,2,0.0
535,11/1/2022,26.383561643835616,W,0,30.983333333333334,2,7,0.286,0,4,0.0,0,0,,3,5,8,3,2,0,2,4,4,4.0,29.0,Gabe Vincent,2,3,0.6666666666666666
536,11/2/2022,26.386301369863013,W,0,28.816666666666666,3,12,0.25,2,7,0.286,2,3,0.667,0,1,1,4,1,0,0,4,10,4.9,8.0,Gabe Vincent,1,5,0.2
537,11/4/2022,26.39178082191781,L,0,25.533333333333335,6,10,0.6,3,6,0.5,0,0,,0,3,3,0,3,0,1,5,15,11.3,1.0,Gabe Vincent,3,4,0.75
538,11/7/2022,26.4,L,0,35.483333333333334,5,13,0.385,3,9,0.333,2,3,0.667,0,1,1,3,2,1,3,3,15,8.4,-5.0,Gabe Vincent,2,4,0.5
539,11/10/2022,26.40821917808219,W,0,37.81666666666667,3,11,0.273,2,7,0.286,4,4,1.0,0,4,4,2,1,0,0,4,12,7.5,2.0,Gabe Vincent,1,4,0.25
540,11/12/2022,26.413698630136988,W,0,30.483333333333334,7,13,0.538,3,8,0.375,3,3,1.0,0,0,0,2,1,0,0,1,20,15.7,-6.0,Gabe Vincent,4,5,0.8
541,11/14/2022,26.41917808219178,W,0,24.966666666666665,4,9,0.444,2,5,0.4,0,0,,0,4,4,4,0,0,2,2,10,6.5,-13.0,Gabe Vincent,2,4,0.5
542,11/16/2022,26.424657534246574,L,0,32.06666666666667,6,11,0.545,3,8,0.375,1,1,1.0,0,2,2,5,0,0,2,4,16,11.2,-8.0,Gabe Vincent,3,3,1.0
543,11/23/2022,26.443835616438356,W,0,18.933333333333334,1,9,0.111,0,6,0.0,0,0,,0,1,1,4,0,0,0,0,2,-0.8,9.0,Gabe Vincent,1,3,0.3333333333333333
544,10/19/2022,28.493150684931507,L,0,10.9,2,4,0.5,1,3,0.333,0,0,,1,3,4,3,0,0,0,1,5,6.3,8.0,Duncan Robinson,1,1,1.0
545,10/21/2022,28.4986301369863,L,0,6.116666666666666,0,0,,0,0,,0,0,,1,0,1,1,0,0,0,0,0,1.4,-5.0,Duncan Robinson,0,0,
546,10/22/2022,28.5013698630137,W,0,14.633333333333333,3,5,0.6,2,3,0.667,0,0,,0,3,3,0,0,0,0,3,8,5.4,-2.0,Duncan Robinson,1,2,0.5
547,10/24/2022,28.506849315068493,L,0,15.566666666666666,4,8,0.5,3,6,0.5,1,1,1.0,0,1,1,0,0,0,0,4,12,6.7,-6.0,Duncan Robinson,1,2,0.5
548,10/26/2022,28.512328767123286,W,0,19.1,2,7,0.286,1,5,0.2,0,0,,0,3,3,3,0,0,1,2,5,2.1,12.0,Duncan Robinson,1,2,0.5
549,10/27/2022,28.515068493150686,L,0,13.15,1,7,0.143,1,5,0.2,0,0,,0,1,1,1,0,0,0,1,3,-0.9,-4.0,Duncan Robinson,0,2,0.0
550,10/29/2022,28.52054794520548,L,0,4.633333333333333,0,2,0.0,0,0,,2,2,1.0,1,1,2,0,0,0,0,2,2,0.8,-8.0,Duncan Robinson,0,2,0.0
551,11/1/2022,28.528767123287672,W,0,25.683333333333334,6,10,0.6,5,8,0.625,0,0,,0,2,2,3,0,0,2,3,17,11.9,19.0,Duncan Robinson,1,2,0.5
552,11/2/2022,28.53150684931507,W,0,24.866666666666667,1,6,0.167,1,5,0.2,1,1,1.0,0,6,6,1,0,0,0,1,4,2.3,-8.0,Duncan Robinson,0,1,0.0
553,11/4/2022,28.536986301369865,L,0,16.666666666666668,0,7,0.0,0,6,0.0,0,0,,0,3,3,0,0,0,0,1,0,-4.4,-13.0,Duncan Robinson,0,1,0.0
554,11/7/2022,28.545205479452054,L,0,28.516666666666666,3,9,0.333,3,9,0.333,0,0,,0,4,4,3,0,0,1,2,9,5.4,2.0,Duncan Robinson,0,0,
555,11/10/2022,28.553424657534247,W,0,22.566666666666666,5,10,0.5,2,6,0.333,2,3,0.667,0,0,0,1,0,0,0,3,14,8.1,0.0,Duncan Robinson,3,4,0.75
556,11/12/2022,28.55890410958904,W,0,23.15,2,9,0.222,0,6,0.0,1,1,1.0,0,1,1,2,1,0,1,1,5,0.8,5.0,Duncan Robinson,2,3,0.6666666666666666
557,11/14/2022,28.564383561643837,W,0,20.7,3,7,0.429,2,6,0.333,2,2,1.0,0,0,0,0,0,0,2,0,10,4.3,-7.0,Duncan Robinson,1,1,1.0
558,11/16/2022,28.56986301369863,L,0,14.533333333333333,0,2,0.0,0,1,0.0,0,0,,1,2,3,3,0,0,2,2,0,-0.8,-3.0,Duncan Robinson,0,1,0.0
559,11/20/2022,28.58082191780822,L,0,20.916666666666668,3,6,0.5,1,3,0.333,0,0,,0,1,1,0,0,0,2,3,7,1.1,-22.0,Duncan Robinson,2,3,0.6666666666666666
560,10/19/2022,33.0958904109589,L,1,36.56666666666667,5,11,0.455,0,0,,14,16,0.875,3,5,8,3,1,1,2,2,24,22.1,-12.0,Jimmy Butler,5,11,0.45454545454545453
561,10/21/2022,33.1013698630137,L,1,40.13333333333333,9,17,0.529,0,1,0.0,0,0,,3,4,7,5,1,0,0,0,18,17.5,7.0,Jimmy Butler,9,16,0.5625
562,10/22/2022,33.104109589041094,W,1,34.833333333333336,7,16,0.438,1,1,1.0,9,11,0.818,1,3,4,5,0,0,2,2,24,17.1,6.0,Jimmy Butler,6,15,0.4
563,10/24/2022,33.10958904109589,L,1,33.78333333333333,8,15,0.533,2,3,0.667,8,9,0.889,2,6,8,4,0,0,1,1,26,22.9,-2.0,Jimmy Butler,6,12,0.5
564,10/26/2022,33.11506849315069,W,1,27.966666666666665,7,15,0.467,0,3,0.0,3,4,0.75,3,2,5,5,2,0,1,1,17,15.7,11.0,Jimmy Butler,7,12,0.5833333333333334
565,10/27/2022,33.11780821917808,L,1,37.06666666666667,8,13,0.615,4,7,0.571,7,7,1.0,1,5,6,8,6,0,2,2,27,32.1,-8.0,Jimmy Butler,4,6,0.6666666666666666
566,10/29/2022,33.12328767123287,L,1,37.11666666666667,4,11,0.364,0,1,0.0,5,7,0.714,1,6,7,6,2,0,2,0,13,12.8,-1.0,Jimmy Butler,4,10,0.4
567,11/1/2022,33.131506849315066,W,1,36.833333333333336,6,17,0.353,2,7,0.286,9,9,1.0,3,3,6,8,0,1,3,1,23,19.4,2.0,Jimmy Butler,4,10,0.4
568,11/7/2022,33.14794520547945,L,1,33.233333333333334,5,14,0.357,0,1,0.0,6,6,1.0,0,4,4,7,6,0,2,3,16,17.1,-3.0,Jimmy Butler,5,13,0.38461538461538464
569,11/10/2022,33.156164383561645,W,1,42.31666666666667,11,19,0.579,0,1,0.0,13,15,0.867,3,7,10,8,2,0,2,2,35,34.3,11.0,Jimmy Butler,11,18,0.6111111111111112
570,11/12/2022,33.16164383561644,W,1,31.3,6,8,0.75,1,2,0.5,7,7,1.0,2,5,7,8,1,0,0,2,20,25.5,13.0,Jimmy Butler,5,6,0.8333333333333334
571,11/14/2022,33.16712328767123,W,1,34.8,5,12,0.417,1,2,0.5,5,5,1.0,4,9,13,7,1,1,0,3,16,20.5,3.0,Jimmy Butler,4,10,0.4
572,11/16/2022,33.172602739726024,L,1,38.28333333333333,4,8,0.5,0,2,0.0,5,5,1.0,0,1,1,5,1,0,5,2,13,8.0,-4.0,Jimmy Butler,4,6,0.6666666666666666
573,10/19/2022,22.745205479452054,L,1,34.46666666666667,8,15,0.533,4,8,0.5,3,4,0.75,0,6,6,1,2,0,1,2,23,18.0,-18.0,Tyler Herro,4,7,0.5714285714285714
574,10/21/2022,22.75068493150685,L,1,36.1,10,21,0.476,2,6,0.333,3,3,1.0,0,6,6,3,0,2,1,3,25,17.4,-1.0,Tyler Herro,8,15,0.5333333333333333
575,10/22/2022,22.753424657534246,W,1,22.283333333333335,4,8,0.5,1,4,0.25,5,5,1.0,2,6,8,6,0,0,2,5,14,13.4,0.0,Tyler Herro,3,4,0.75
576,10/24/2022,22.75890410958904,L,1,39.983333333333334,8,18,0.444,2,9,0.222,4,5,0.8,1,14,15,4,1,0,4,1,22,16.5,-12.0,Tyler Herro,6,9,0.6666666666666666
577,10/26/2022,22.764383561643836,W,1,28.383333333333333,5,13,0.385,3,8,0.375,1,1,1.0,0,4,4,4,0,0,1,2,14,9.1,10.0,Tyler Herro,2,5,0.4
578,10/27/2022,22.767123287671232,L,1,31.766666666666666,3,12,0.25,1,5,0.2,0,0,,0,4,4,2,0,0,2,1,7,0.0,-10.0,Tyler Herro,2,7,0.2857142857142857
579,10/29/2022,22.77260273972603,L,1,34.86666666666667,13,22,0.591,5,8,0.625,3,4,0.75,1,2,3,0,0,0,3,1,34,21.3,11.0,Tyler Herro,8,14,0.5714285714285714
580,11/1/2022,22.78082191780822,W,1,9.95,1,4,0.25,0,0,,0,0,,0,1,1,1,1,1,0,0,2,2.3,-6.0,Tyler Herro,1,4,0.25
581,11/2/2022,22.783561643835615,W,1,37.81666666666667,12,21,0.571,2,6,0.333,0,0,,2,10,12,0,1,3,2,0,26,21.6,15.0,Tyler Herro,10,15,0.6666666666666666
582,11/4/2022,22.78904109589041,L,1,38.35,8,20,0.4,4,10,0.4,9,9,1.0,0,5,5,5,2,0,5,1,29,19.8,-2.0,Tyler Herro,4,10,0.4
583,11/23/2022,22.84109589041096,W,1,29.383333333333333,6,15,0.4,5,10,0.5,0,2,0.0,0,5,5,3,0,0,3,3,17,7.5,-10.0,Tyler Herro,1,5,0.2
584,11/25/2022,22.846575342465755,W,1,38.65,4,18,0.222,2,10,0.2,1,1,1.0,0,5,5,10,0,1,5,1,11,3.8,8.0,Tyler Herro,2,8,0.25
585,11/27/2022,22.852054794520548,W,1,39.916666666666664,3,13,0.231,0,8,0.0,5,5,1.0,1,10,11,10,1,0,2,3,11,11.6,7.0,Tyler Herro,3,5,0.6
586,10/19/2022,25.86027397260274,L,0,0.4666666666666667,0,0,,0,0,,0,0,,0,0,0,0,0,0,0,0,0,0.0,2.0,Haywood Highsmith,0,0,
587,10/21/2022,25.865753424657534,L,0,4.4,0,2,0.0,0,2,0.0,0,0,,0,2,2,0,0,0,0,0,0,-0.8,-9.0,Haywood Highsmith,0,0,
588,10/24/2022,25.873972602739727,L,0,10.483333333333333,0,2,0.0,0,1,0.0,0,0,,0,1,1,0,2,0,2,1,0,-1.5,-4.0,Haywood Highsmith,0,1,0.0
589,10/26/2022,25.87945205479452,W,0,5.616666666666667,1,1,1.0,0,0,,0,0,,0,1,1,0,1,0,0,0,2,3.0,-5.0,Haywood Highsmith,1,1,1.0
590,11/4/2022,25.904109589041095,L,0,6.45,0,1,0.0,0,1,0.0,0,0,,0,0,0,0,0,0,1,0,0,-1.7,-5.0,Haywood Highsmith,0,0,
591,11/12/2022,25.926027397260274,W,0,1.65,0,0,,0,0,,0,0,,0,0,0,0,0,0,0,0,0,0.0,0.0,Haywood Highsmith,0,0,
592,11/18/2022,25.942465753424656,L,1,41.916666666666664,5,17,0.294,1,7,0.143,1,2,0.5,4,10,14,2,2,0,1,1,12,9.5,-2.0,Haywood Highsmith,4,10,0.4
593,11/20/2022,25.947945205479453,L,0,28.633333333333333,0,3,0.0,0,2,0.0,0,2,0.0,1,3,4,0,1,0,0,2,0,-1.1,-23.0,Haywood Highsmith,0,1,0.0
594,11/21/2022,25.95068493150685,L,0,19.883333333333333,4,7,0.571,2,3,0.667,2,2,1.0,2,3,5,0,0,0,4,3,12,5.8,7.0,Haywood Highsmith,2,4,0.5
595,11/23/2022,25.956164383561642,W,0,37.8,2,7,0.286,1,4,0.25,0,0,,0,8,8,1,1,0,0,0,5,5.0,16.0,Haywood Highsmith,1,3,0.3333333333333333
596,11/25/2022,25.96164383561644,W,0,33.53333333333333,2,6,0.333,1,2,0.5,1,4,0.25,2,5,7,1,0,1,1,1,6,4.3,4.0,Haywood Highsmith,1,4,0.25
597,11/27/2022,25.96712328767123,W,0,23.133333333333333,0,3,0.0,0,2,0.0,0,0,,1,2,3,2,1,1,1,2,0,0.5,1.0,Haywood Highsmith,0,1,0.0
598,10/26/2022,19.38082191780822,W,0,13.716666666666667,1,3,0.333,0,1,0.0,0,0,,1,1,2,0,1,0,1,5,2,-0.7,3.0,Nikola Jović,1,2,0.5
599,10/27/2022,19.383561643835616,L,0,7.6,2,4,0.5,0,2,0.0,0,0,,0,0,0,1,1,0,0,0,4,3.7,-2.0,Nikola Jović,2,2,1.0
600,10/29/2022,19.389041095890413,L,0,0.8333333333333334,0,0,,0,0,,0,0,,0,0,0,0,0,0,0,0,0,0.0,-5.0,Nikola Jović,0,0,
601,11/12/2022,19.427397260273974,W,0,1.6333333333333333,1,1,1.0,1,1,1.0,0,0,,0,0,0,0,0,0,1,0,3,1.7,0.0,Nikola Jović,0,0,
602,11/16/2022,19.438356164383563,L,1,23.816666666666666,4,8,0.5,1,3,0.333,4,4,1.0,1,2,3,1,1,0,2,1,13,9.6,-3.0,Nikola Jović,3,5,0.6
603,11/18/2022,19.443835616438356,L,1,30.233333333333334,4,10,0.4,1,3,0.333,9,10,0.9,2,4,6,0,0,0,0,2,18,14.0,6.0,Nikola Jović,3,7,0.42857142857142855
604,11/20/2022,19.44931506849315,L,1,32.21666666666667,2,9,0.222,1,6,0.167,2,2,1.0,2,2,4,5,1,0,1,2,7,6.2,-7.0,Nikola Jović,1,3,0.3333333333333333
605,11/21/2022,19.45205479452055,L,1,22.883333333333333,1,5,0.2,0,3,0.0,2,2,1.0,1,4,5,3,1,0,1,1,4,4.5,-2.0,Nikola Jović,1,2,0.5
606,11/23/2022,19.457534246575342,W,1,12.466666666666667,3,7,0.429,1,3,0.333,0,0,,0,5,5,0,0,0,2,0,7,2.8,-8.0,Nikola Jović,2,4,0.5
607,11/25/2022,19.463013698630135,W,1,14.466666666666667,3,6,0.5,0,3,0.0,1,1,1.0,0,1,1,0,1,1,0,1,7,5.6,-1.0,Nikola Jović,3,3,1.0
608,11/12/2022,23.649315068493152,W,0,1.6333333333333333,1,1,1.0,1,1,1.0,0,0,,0,0,0,0,1,0,0,0,3,3.7,0.0,Jamal Cain,0,0,
609,11/16/2022,23.660273972602738,L,0,6.066666666666666,0,3,0.0,0,2,0.0,0,0,,0,1,1,0,0,0,0,1,0,-2.2,-8.0,Jamal Cain,0,1,0.0
610,11/18/2022,23.665753424657535,L,0,17.516666666666666,1,2,0.5,0,1,0.0,2,4,0.5,1,5,6,1,0,0,0,1,4,4.7,-5.0,Jamal Cain,1,1,1.0
611,11/20/2022,23.671232876712327,L,0,11.9,4,6,0.667,0,0,,0,0,,1,0,1,1,1,0,1,2,8,6.0,1.0,Jamal Cain,4,6,0.6666666666666666
612,11/21/2022,23.673972602739727,L,0,24.966666666666665,5,7,0.714,0,0,,0,0,,0,2,2,1,1,0,0,1,10,9.0,0.0,Jamal Cain,5,7,0.7142857142857143
613,11/23/2022,23.67945205479452,W,0,17.716666666666665,2,6,0.333,0,2,0.0,2,2,1.0,4,2,6,2,2,0,1,3,6,7.2,8.0,Jamal Cain,2,4,0.5
614,11/25/2022,23.684931506849313,W,0,11.55,2,3,0.667,0,0,,0,0,,1,2,3,0,0,0,0,1,4,3.6,-10.0,Jamal Cain,2,3,0.6666666666666666
615,11/27/2022,23.69041095890411,W,0,1.6333333333333333,0,0,,0,0,,0,0,,0,0,0,0,0,0,0,1,0,-0.4,-4.0,Jamal Cain,0,0,
616,11/18/2022,22.35890410958904,L,0,32.2,6,10,0.6,0,2,0.0,2,3,0.667,1,6,7,0,1,1,1,5,14,10.2,-2.0,Orlando Robinson,6,8,0.75
617,11/20/2022,22.364383561643837,L,0,7.883333333333333,0,3,0.0,0,1,0.0,0,0,,1,1,2,1,1,0,0,0,0,0.6,4.0,Orlando Robinson,0,2,0.0
618,10/26/2022,42.38082191780822,W,0,2.2666666666666666,0,1,0.0,0,0,,0,0,,0,1,1,0,0,1,0,0,0,0.3,-1.0,Udonis Haslem,0,1,0.0
619,10/29/2022,42.38904109589041,L,0,7.95,1,2,0.5,0,0,,1,2,0.5,0,1,1,0,0,0,0,1,3,1.5,-3.0,Udonis Haslem,1,2,0.5
620,10/19/2022,21.145205479452056,L,1,34.11666666666667,8,18,0.444,2,6,0.333,2,2,1.0,1,3,4,5,0,0,5,2,20,9.9,-2.0,Franz Wagner,6,12,0.5
621,10/21/2022,21.15068493150685,L,1,35.63333333333333,4,10,0.4,0,3,0.0,0,0,,3,4,7,3,4,0,3,3,8,7.8,-8.0,Franz Wagner,4,7,0.5714285714285714
622,10/22/2022,21.153424657534245,L,1,34.516666666666666,8,17,0.471,2,6,0.333,0,0,,2,4,6,2,1,0,1,1,18,12.9,-17.0,Franz Wagner,6,11,0.5454545454545454
623,10/24/2022,21.15890410958904,L,1,35.96666666666667,5,15,0.333,1,6,0.167,3,4,0.75,3,3,6,5,0,0,2,3,14,8.4,4.0,Franz Wagner,4,9,0.4444444444444444
624,10/26/2022,21.164383561643834,L,1,34.7,10,20,0.5,0,4,0.0,2,3,0.667,2,3,5,5,1,1,5,3,22,12.9,2.0,Franz Wagner,10,16,0.625
625,10/28/2022,21.16986301369863,W,1,23.383333333333333,5,8,0.625,1,3,0.333,2,2,1.0,0,1,1,4,1,0,2,0,13,11.5,23.0,Franz Wagner,4,5,0.8
626,10/30/2022,21.175342465753424,L,1,35.1,3,12,0.25,0,3,0.0,5,6,0.833,0,2,2,4,0,1,3,2,11,3.7,-8.0,Franz Wagner,3,9,0.3333333333333333
627,11/1/2022,21.18082191780822,L,1,36.71666666666667,8,18,0.444,1,5,0.2,3,3,1.0,0,1,1,7,1,2,2,2,20,15.4,12.0,Franz Wagner,7,13,0.5384615384615384
628,11/3/2022,21.186301369863013,W,1,36.63333333333333,7,12,0.583,1,1,1.0,4,5,0.8,0,3,3,2,0,0,4,2,19,10.5,2.0,Franz Wagner,6,11,0.5454545454545454
629,11/5/2022,21.19178082191781,L,1,40.483333333333334,13,22,0.591,1,5,0.2,4,5,0.8,0,3,3,6,3,0,2,4,31,24.9,3.0,Franz Wagner,12,17,0.7058823529411765
630,11/7/2022,21.197260273972603,L,1,32.8,9,12,0.75,3,4,0.75,2,2,1.0,2,3,5,7,0,0,2,2,23,22.6,2.0,Franz Wagner,6,8,0.75
631,11/9/2022,21.202739726027396,W,1,33.11666666666667,9,17,0.529,0,3,0.0,4,4,1.0,0,3,3,6,0,0,3,2,22,15.0,13.0,Franz Wagner,9,14,0.6428571428571429
632,11/11/2022,21.208219178082192,W,1,30.666666666666668,7,15,0.467,0,3,0.0,3,4,0.75,1,5,6,3,0,0,2,3,17,10.0,5.0,Franz Wagner,7,12,0.5833333333333334
633,11/14/2022,21.216438356164385,L,1,33.583333333333336,9,17,0.529,1,1,1.0,4,4,1.0,1,5,6,3,0,0,3,2,23,15.2,-11.0,Franz Wagner,8,16,0.5
634,11/16/2022,21.221917808219178,L,1,34.88333333333333,7,17,0.412,1,1,1.0,3,4,0.75,1,5,6,4,0,1,2,3,18,11.0,-25.0,Franz Wagner,6,16,0.375
635,11/18/2022,21.22739726027397,W,1,33.11666666666667,5,9,0.556,2,3,0.667,8,9,0.889,0,3,3,8,1,0,3,6,20,17.4,11.0,Franz Wagner,3,6,0.5
636,11/19/2022,21.23013698630137,L,1,30.716666666666665,9,17,0.529,5,9,0.556,6,6,1.0,0,5,5,3,1,0,2,3,29,22.1,-4.0,Franz Wagner,4,8,0.5
637,11/21/2022,21.235616438356164,L,1,30.55,6,11,0.545,0,1,0.0,8,10,0.8,0,6,6,3,1,0,3,5,20,13.8,-16.0,Franz Wagner,6,10,0.6
638,11/25/2022,21.246575342465754,L,1,36.233333333333334,7,12,0.583,1,5,0.2,9,10,0.9,1,3,4,1,1,0,2,2,24,18.5,-8.0,Franz Wagner,6,7,0.8571428571428571
639,11/27/2022,21.252054794520546,L,1,26.766666666666666,6,11,0.545,1,4,0.25,4,5,0.8,0,3,3,2,0,1,2,1,17,11.9,-15.0,Franz Wagner,5,7,0.7142857142857143
640,10/19/2022,22.923287671232877,L,0,17.533333333333335,4,6,0.667,0,0,,2,2,1.0,2,4,6,0,0,1,2,0,10,8.7,-4.0,Bol Bol,4,6,0.6666666666666666
641,10/21/2022,22.92876712328767,L,0,11.75,2,3,0.667,0,0,,1,1,1.0,1,2,3,0,0,2,1,0,5,5.4,-4.0,Bol Bol,2,3,0.6666666666666666
642,10/22/2022,22.931506849315067,L,0,14.866666666666667,3,7,0.429,0,1,0.0,0,0,,0,5,5,0,0,4,0,2,6,5.8,9.0,Bol Bol,3,6,0.5
643,10/24/2022,22.936986301369863,L,0,20.266666666666666,8,10,0.8,1,2,0.5,2,2,1.0,3,2,5,0,0,4,2,2,19,17.9,0.0,Bol Bol,7,8,0.875
644,10/26/2022,22.942465753424656,L,0,21.766666666666666,4,7,0.571,1,2,0.5,0,2,0.0,3,7,10,1,0,2,0,2,9,10.4,-2.0,Bol Bol,3,5,0.6
645,10/28/2022,22.947945205479453,W,1,26.55,4,6,0.667,0,2,0.0,3,4,0.75,0,7,7,1,1,1,2,1,11,10.1,18.0,Bol Bol,4,4,1.0
646,10/30/2022,22.953424657534246,L,1,29.733333333333334,7,10,0.7,0,1,0.0,2,2,1.0,3,8,11,0,0,3,2,4,16,14.8,-5.0,Bol Bol,7,9,0.7777777777777778
647,11/1/2022,22.958904109589042,L,1,30.883333333333333,4,6,0.667,1,1,1.0,4,4,1.0,3,9,12,1,0,4,6,2,13,11.9,-3.0,Bol Bol,3,5,0.6
648,11/3/2022,22.964383561643835,W,1,18.65,2,3,0.667,0,1,0.0,0,0,,1,5,6,1,0,2,0,1,4,6.6,-11.0,Bol Bol,2,2,1.0
649,11/5/2022,22.96986301369863,L,1,37.0,10,11,0.909,2,3,0.667,1,1,1.0,1,6,7,2,0,0,0,5,23,21.2,10.0,Bol Bol,8,8,1.0
650,11/7/2022,22.975342465753425,L,1,20.583333333333332,2,5,0.4,0,1,0.0,5,5,1.0,0,3,3,0,1,1,3,0,9,5.9,-1.0,Bol Bol,2,4,0.5
651,11/9/2022,22.980821917808218,W,1,25.216666666666665,4,6,0.667,2,2,1.0,1,2,0.5,0,7,7,0,0,1,2,1,11,8.4,-3.0,Bol Bol,2,4,0.5
652,11/11/2022,22.986301369863014,W,1,30.9,5,8,0.625,3,3,1.0,0,0,,0,15,15,1,0,0,3,1,13,11.2,15.0,Bol Bol,2,5,0.4
653,11/14/2022,22.994520547945207,L,1,30.7,5,13,0.385,2,6,0.333,2,2,1.0,3,6,9,2,0,2,6,1,14,7.2,-14.0,Bol Bol,3,7,0.42857142857142855
654,11/16/2022,23.0,L,1,34.75,12,21,0.571,0,4,0.0,2,2,1.0,3,9,12,1,1,3,4,2,26,19.9,-22.0,Bol Bol,12,17,0.7058823529411765
655,11/18/2022,23.005479452054793,W,1,30.583333333333332,6,10,0.6,0,0,,3,3,1.0,2,8,10,0,0,2,0,2,15,14.8,1.0,Bol Bol,6,10,0.6
656,11/19/2022,23.008219178082193,L,1,33.63333333333333,9,15,0.6,2,3,0.667,2,4,0.5,3,8,11,0,0,2,0,1,22,19.8,3.0,Bol Bol,7,12,0.5833333333333334
657,11/21/2022,23.013698630136986,L,1,27.2,4,11,0.364,0,1,0.0,1,2,0.5,1,8,9,2,0,0,4,2,9,2.2,-14.0,Bol Bol,4,10,0.4
658,11/25/2022,23.024657534246575,L,1,35.016666666666666,8,14,0.571,1,3,0.333,1,2,0.5,2,6,8,2,1,4,0,1,18,19.0,-7.0,Bol Bol,7,11,0.6363636363636364
659,11/27/2022,23.03013698630137,L,1,32.43333333333333,3,6,0.5,0,1,0.0,0,0,,0,4,4,3,2,2,4,0,6,5.7,-19.0,Bol Bol,3,5,0.6
660,10/19/2022,24.438356164383563,L,0,12.0,0,5,0.0,0,4,0.0,0,2,0.0,1,1,2,1,0,0,0,0,0,-2.6,-10.0,Mo Bamba,0,1,0.0
661,10/21/2022,24.443835616438356,L,0,15.05,2,6,0.333,1,3,0.333,2,2,1.0,1,5,6,2,0,0,1,1,7,5.8,2.0,Mo Bamba,1,3,0.3333333333333333
662,10/22/2022,24.446575342465753,L,0,11.7,1,3,0.333,1,3,0.333,0,0,,0,0,0,1,0,0,0,2,3,1.2,2.0,Mo Bamba,0,0,
663,10/24/2022,24.45205479452055,L,0,14.0,1,3,0.333,0,2,0.0,0,0,,0,3,3,0,1,0,2,4,2,-1.4,-18.0,Mo Bamba,1,1,1.0
664,10/26/2022,24.457534246575342,L,0,7.016666666666667,1,1,1.0,0,0,,0,0,,0,1,1,0,0,0,0,1,2,1.6,-2.0,Mo Bamba,1,1,1.0
665,10/28/2022,24.463013698630135,W,0,16.883333333333333,8,12,0.667,2,5,0.4,1,1,1.0,1,5,6,1,0,3,1,5,19,15.8,9.0,Mo Bamba,6,7,0.8571428571428571
666,10/30/2022,24.46849315068493,L,0,17.316666666666666,2,4,0.5,1,1,1.0,0,0,,0,4,4,1,0,1,0,2,5,4.8,0.0,Mo Bamba,1,3,0.3333333333333333
667,11/1/2022,24.473972602739725,L,0,12.916666666666666,1,4,0.25,0,1,0.0,0,0,,2,3,5,0,0,1,2,1,2,0.2,-10.0,Mo Bamba,1,3,0.3333333333333333
668,11/3/2022,24.47945205479452,W,0,5.633333333333333,0,0,,0,0,,0,0,,0,2,2,0,0,0,1,1,0,-0.8,-4.0,Mo Bamba,0,0,
669,11/7/2022,24.49041095890411,L,0,19.616666666666667,6,7,0.857,1,2,0.5,1,2,0.5,1,3,4,3,1,1,0,3,14,15.3,0.0,Mo Bamba,5,5,1.0
670,11/9/2022,24.495890410958904,W,0,24.45,5,8,0.625,1,3,0.333,1,2,0.5,1,5,6,1,0,1,0,2,12,10.8,-7.0,Mo Bamba,4,5,0.8
671,11/11/2022,24.5013698630137,W,0,18.5,3,6,0.5,1,3,0.333,2,3,0.667,1,4,5,2,0,1,1,1,9,8.2,7.0,Mo Bamba,2,3,0.6666666666666666
672,11/14/2022,24.50958904109589,L,0,21.916666666666668,5,10,0.5,1,2,0.5,3,4,0.75,7,3,10,1,0,1,2,2,14,13.0,7.0,Mo Bamba,4,8,0.5
673,11/16/2022,24.515068493150686,L,1,29.333333333333332,4,11,0.364,0,5,0.0,0,0,,3,7,10,2,0,1,1,5,8,5.2,0.0,Mo Bamba,4,6,0.6666666666666666
674,11/18/2022,24.52054794520548,W,0,23.966666666666665,4,9,0.444,4,5,0.8,1,2,0.5,1,3,4,1,0,2,0,4,13,10.0,-3.0,Mo Bamba,0,4,0.0
675,11/19/2022,24.523287671232875,L,1,33.083333333333336,6,14,0.429,3,8,0.375,6,8,0.75,3,6,9,1,2,1,2,3,21,16.9,18.0,Mo Bamba,3,6,0.5
676,11/21/2022,24.528767123287672,L,1,32.916666666666664,5,6,0.833,2,3,0.667,3,3,1.0,0,4,4,1,0,0,2,2,15,11.9,-7.0,Mo Bamba,3,3,1.0
677,11/25/2022,24.53972602739726,L,1,27.366666666666667,2,7,0.286,1,3,0.333,2,2,1.0,0,4,4,4,1,1,1,2,7,6.8,-10.0,Mo Bamba,1,4,0.25
678,11/27/2022,24.545205479452054,L,1,11.616666666666667,1,3,0.333,1,3,0.333,0,0,,0,1,1,0,0,1,1,1,3,0.9,-13.0,Mo Bamba,0,0,
679,10/19/2022,31.7013698630137,L,1,31.816666666666666,5,12,0.417,3,8,0.375,0,1,0.0,1,3,4,1,1,0,0,2,13,8.7,5.0,Terrence Ross,2,4,0.5
680,10/21/2022,31.706849315068492,L,1,35.3,4,8,0.5,1,4,0.25,2,2,1.0,1,3,4,2,0,1,1,4,11,8.1,-8.0,Terrence Ross,3,4,0.75
681,10/22/2022,31.70958904109589,L,1,35.15,11,16,0.688,5,8,0.625,2,2,1.0,1,3,4,1,1,0,0,3,29,24.3,-3.0,Terrence Ross,6,8,0.75
682,10/24/2022,31.715068493150685,L,1,32.583333333333336,3,7,0.429,2,5,0.4,0,0,,0,3,3,0,1,0,1,1,8,4.8,-7.0,Terrence Ross,1,2,0.5
683,10/26/2022,31.720547945205478,L,1,31.9,3,10,0.3,1,3,0.333,0,0,,1,1,2,2,2,0,0,3,7,4.4,-17.0,Terrence Ross,2,7,0.2857142857142857
684,10/28/2022,31.726027397260275,W,1,23.966666666666665,2,7,0.286,1,5,0.2,0,1,0.0,0,2,2,1,1,1,0,3,5,2.3,18.0,Terrence Ross,1,2,0.5
685,10/30/2022,31.731506849315068,L,1,25.466666666666665,3,7,0.429,2,4,0.5,0,0,,0,3,3,2,0,0,1,2,8,4.8,1.0,Terrence Ross,1,3,0.3333333333333333
686,11/1/2022,31.736986301369864,L,1,3.716666666666667,0,0,,0,0,,0,0,,0,0,0,1,0,0,0,0,0,0.7,1.0,Terrence Ross,0,0,
687,11/5/2022,31.747945205479454,L,0,15.6,0,2,0.0,0,0,,0,0,,0,1,1,1,1,0,2,1,0,-1.8,-13.0,Terrence Ross,0,2,0.0
688,11/7/2022,31.753424657534246,L,0,30.883333333333333,8,15,0.533,5,10,0.5,0,0,,0,3,3,2,1,1,4,2,21,12.9,-3.0,Terrence Ross,3,5,0.6
689,11/9/2022,31.75890410958904,W,0,30.233333333333334,3,9,0.333,0,2,0.0,0,1,0.0,0,4,4,1,0,0,2,4,6,-1.2,8.0,Terrence Ross,3,7,0.42857142857142855
690,11/11/2022,31.764383561643836,W,0,24.466666666666665,5,9,0.556,2,3,0.667,2,2,1.0,1,1,2,2,0,0,0,1,14,11.7,9.0,Terrence Ross,3,6,0.5
691,11/14/2022,31.77260273972603,L,0,21.983333333333334,1,6,0.167,1,4,0.25,0,0,,1,2,3,4,0,0,4,2,3,-1.5,4.0,Terrence Ross,0,2,0.0
692,11/16/2022,31.778082191780822,L,0,26.616666666666667,1,4,0.25,1,2,0.5,3,3,1.0,0,2,2,2,0,0,3,3,6,1.4,-2.0,Terrence Ross,0,2,0.0
693,11/18/2022,31.783561643835615,W,0,23.016666666666666,3,6,0.5,2,4,0.5,0,0,,0,2,2,0,0,0,2,1,8,3.2,8.0,Terrence Ross,1,2,0.5
694,11/19/2022,31.786301369863015,L,0,23.7,3,12,0.25,1,7,0.143,0,0,,0,1,1,1,1,0,0,0,7,1.8,1.0,Terrence Ross,2,5,0.4
695,11/21/2022,31.791780821917808,L,0,21.85,2,7,0.286,2,5,0.4,0,0,,0,2,2,2,3,1,1,0,6,6.6,-8.0,Terrence Ross,0,2,0.0
696,11/27/2022,31.80821917808219,L,0,8.583333333333334,3,6,0.5,1,3,0.333,0,1,0.0,0,0,0,0,2,0,3,0,7,2.6,-11.0,Terrence Ross,2,3,0.6666666666666666
697,10/19/2022,24.16986301369863,L,0,17.916666666666668,0,3,0.0,0,1,0.0,2,2,1.0,1,3,4,1,0,0,0,2,2,1.4,-7.0,Chuma Okeke,0,2,0.0
698,10/21/2022,24.175342465753424,L,0,14.366666666666667,1,2,0.5,1,2,0.5,0,0,,0,1,1,0,0,0,0,0,3,2.3,0.0,Chuma Okeke,0,0,
699,10/22/2022,24.17808219178082,L,0,16.133333333333333,3,3,1.0,2,2,1.0,0,0,,2,2,4,2,0,0,0,3,8,9.3,-1.0,Chuma Okeke,1,1,1.0
700,10/24/2022,24.183561643835617,L,0,12.383333333333333,0,5,0.0,0,5,0.0,0,0,,1,1,2,2,0,0,1,2,0,-2.9,-4.0,Chuma Okeke,0,0,
701,10/26/2022,24.18904109589041,L,0,5.466666666666667,0,1,0.0,0,1,0.0,0,0,,0,0,0,1,0,0,0,0,0,0.0,4.0,Chuma Okeke,0,0,
702,10/28/2022,24.194520547945206,W,0,28.95,3,7,0.429,2,5,0.4,2,2,1.0,1,5,6,2,1,0,0,4,10,9.3,0.0,Chuma Okeke,1,2,0.5
703,10/30/2022,24.2,L,0,24.95,2,5,0.4,1,4,0.25,0,0,,2,6,8,3,0,0,0,2,5,6.8,-14.0,Chuma Okeke,1,1,1.0
704,11/1/2022,24.205479452054796,L,0,12.566666666666666,2,3,0.667,2,3,0.667,0,0,,2,3,5,1,1,0,3,1,6,5.3,-12.0,Chuma Okeke,0,0,
705,11/3/2022,24.21095890410959,W,0,27.466666666666665,4,6,0.667,3,5,0.6,5,6,0.833,2,7,9,3,0,1,0,2,16,18.5,13.0,Chuma Okeke,1,1,1.0
706,11/5/2022,24.216438356164385,L,0,22.7,2,6,0.333,0,3,0.0,0,0,,2,4,6,0,2,2,1,1,4,5.2,-12.0,Chuma Okeke,2,3,0.6666666666666666
707,11/7/2022,24.221917808219178,L,0,16.0,1,2,0.5,0,1,0.0,0,0,,1,0,1,2,0,1,0,1,2,3.4,-6.0,Chuma Okeke,1,1,1.0
708,11/9/2022,24.22739726027397,W,1,31.566666666666666,2,5,0.4,1,2,0.5,3,6,0.5,1,6,7,2,0,1,3,4,8,4.1,4.0,Chuma Okeke,1,3,0.3333333333333333
709,11/11/2022,24.232876712328768,W,1,30.366666666666667,4,10,0.4,2,6,0.333,1,1,1.0,3,2,5,3,1,1,0,1,11,11.7,13.0,Chuma Okeke,2,4,0.5
710,11/14/2022,24.24109589041096,L,1,33.11666666666667,4,10,0.4,2,6,0.333,0,0,,2,1,3,0,1,1,0,2,10,7.2,-13.0,Chuma Okeke,2,4,0.5
711,11/16/2022,24.246575342465754,L,1,31.516666666666666,2,8,0.25,1,6,0.167,0,0,,0,5,5,1,2,0,1,3,5,2.2,-11.0,Chuma Okeke,1,2,0.5
712,11/18/2022,24.252054794520546,W,1,29.45,1,5,0.2,0,2,0.0,2,2,1.0,0,7,7,2,1,2,0,4,4,5.2,-12.0,Chuma Okeke,1,3,0.3333333333333333
713,11/19/2022,24.254794520547946,L,1,24.683333333333334,1,3,0.333,1,3,0.333,1,2,0.5,1,2,3,1,2,0,0,1,4,5.5,-7.0,Chuma Okeke,0,0,
714,11/21/2022,24.26027397260274,L,1,12.1,0,3,0.0,0,3,0.0,0,0,,0,0,0,0,0,0,0,1,0,-2.5,-9.0,Chuma Okeke,0,0,
715,10/19/2022,21.695890410958903,L,0,11.483333333333333,1,2,0.5,1,1,1.0,2,2,1.0,1,3,4,2,1,0,0,0,5,8.0,7.0,R.J. Hampton,0,1,0.0
716,10/21/2022,21.7013698630137,L,0,16.383333333333333,1,3,0.333,0,1,0.0,0,0,,0,0,0,2,0,0,2,2,2,-1.1,-5.0,R.J. Hampton,1,2,0.5
717,10/22/2022,21.704109589041096,L,0,9.016666666666667,0,0,,0,0,,1,2,0.5,0,0,0,0,1,0,0,1,1,1.2,-2.0,R.J. Hampton,0,0,
718,10/24/2022,21.70958904109589,L,0,7.066666666666666,0,1,0.0,0,0,,0,0,,0,0,0,0,0,0,0,1,0,-1.1,-3.0,R.J. Hampton,0,1,0.0
719,10/28/2022,21.720547945205478,W,0,24.616666666666667,2,7,0.286,0,1,0.0,5,5,1.0,1,3,4,4,2,0,1,1,9,9.9,-3.0,R.J. Hampton,2,6,0.3333333333333333
720,10/30/2022,21.726027397260275,L,0,21.316666666666666,6,9,0.667,3,4,0.75,0,0,,2,2,4,1,2,0,0,1,15,15.4,-6.0,R.J. Hampton,3,5,0.6
721,11/1/2022,21.731506849315068,L,0,20.8,4,7,0.571,2,4,0.5,0,0,,0,2,2,1,0,1,1,3,10,6.5,-8.0,R.J. Hampton,2,3,0.6666666666666666
722,11/3/2022,21.736986301369864,W,0,20.283333333333335,4,6,0.667,3,5,0.6,4,4,1.0,1,1,2,0,1,1,3,3,15,10.9,6.0,R.J. Hampton,1,1,1.0
723,11/5/2022,21.742465753424657,L,0,17.15,2,6,0.333,0,1,0.0,1,1,1.0,1,1,2,1,0,0,1,1,5,1.9,-11.0,R.J. Hampton,2,5,0.4
724,11/9/2022,21.753424657534246,W,0,8.55,1,2,0.5,0,1,0.0,0,0,,0,0,0,2,0,1,2,0,2,1.1,-7.0,R.J. Hampton,1,1,1.0
725,11/11/2022,21.75890410958904,W,0,10.933333333333334,3,3,1.0,2,2,1.0,0,0,,0,0,0,2,1,1,1,1,8,8.8,11.0,R.J. Hampton,1,1,1.0
726,11/14/2022,21.767123287671232,L,0,10.35,3,7,0.429,1,4,0.25,3,3,1.0,0,0,0,1,1,0,1,0,10,7.0,6.0,R.J. Hampton,2,3,0.6666666666666666
727,11/16/2022,21.77260273972603,L,0,10.25,2,6,0.333,0,2,0.0,0,0,,0,0,0,1,0,0,1,1,4,-0.1,-12.0,R.J. Hampton,2,4,0.5
728,11/19/2022,21.78082191780822,L,0,25.483333333333334,5,8,0.625,2,3,0.667,2,4,0.5,0,1,1,0,2,0,1,2,14,10.1,1.0,R.J. Hampton,3,5,0.6
729,11/21/2022,21.786301369863015,L,0,21.2,2,7,0.286,0,3,0.0,2,3,0.667,1,1,2,5,1,0,1,1,6,5.6,-11.0,R.J. Hampton,2,4,0.5
730,11/25/2022,21.797260273972604,L,0,28.716666666666665,4,11,0.364,2,6,0.333,0,0,,0,4,4,1,1,0,1,1,10,5.4,-1.0,R.J. Hampton,2,5,0.4
731,11/27/2022,21.802739726027397,L,0,25.783333333333335,3,9,0.333,0,4,0.0,5,5,1.0,1,2,3,3,2,0,1,1,11,9.9,-20.0,R.J. Hampton,3,5,0.6
732,10/19/2022,23.50958904109589,L,1,32.65,5,8,0.625,1,2,0.5,0,0,,0,11,11,3,1,1,3,4,11,9.9,0.0,Wendell Carter Jr.,4,6,0.6666666666666666
733,10/21/2022,23.515068493150686,L,1,32.95,4,13,0.308,0,7,0.0,6,7,0.857,1,7,8,2,0,0,2,4,14,6.7,-12.0,Wendell Carter Jr.,4,6,0.6666666666666666
734,10/22/2022,23.517808219178082,L,1,34.93333333333333,6,13,0.462,1,1,1.0,2,4,0.5,5,7,12,5,0,1,3,5,15,12.3,-4.0,Wendell Carter Jr.,5,12,0.4166666666666667
735,10/24/2022,23.523287671232875,L,1,33.6,5,10,0.5,2,5,0.4,5,6,0.833,4,7,11,1,1,0,1,3,17,16.0,-11.0,Wendell Carter Jr.,3,5,0.6
736,10/26/2022,23.528767123287672,L,1,32.8,4,9,0.444,0,3,0.0,4,4,1.0,3,5,8,1,0,0,3,6,12,6.2,-13.0,Wendell Carter Jr.,4,6,0.6666666666666666
737,10/28/2022,23.534246575342465,W,1,25.6,6,13,0.462,0,3,0.0,3,4,0.75,0,5,5,4,2,0,1,1,15,12.8,20.0,Wendell Carter Jr.,6,10,0.6
738,10/30/2022,23.53972602739726,L,1,32.583333333333336,5,10,0.5,1,3,0.333,4,6,0.667,3,6,9,4,0,0,2,1,15,13.5,-6.0,Wendell Carter Jr.,4,7,0.5714285714285714
739,11/1/2022,23.545205479452054,L,1,35.43333333333333,10,15,0.667,2,2,1.0,8,8,1.0,5,7,12,2,2,1,2,3,30,30.0,4.0,Wendell Carter Jr.,8,13,0.6153846153846154
740,11/3/2022,23.55068493150685,W,1,33.31666666666667,4,9,0.444,2,4,0.5,4,6,0.667,2,7,9,2,1,1,2,3,14,11.9,-2.0,Wendell Carter Jr.,2,5,0.4
741,11/5/2022,23.556164383561644,L,1,38.88333333333333,6,9,0.667,1,3,0.333,4,4,1.0,0,9,9,6,1,0,4,6,17,14.6,14.0,Wendell Carter Jr.,5,6,0.8333333333333334
742,11/7/2022,23.561643835616437,L,1,27.383333333333333,6,12,0.5,1,2,0.5,2,2,1.0,3,4,7,2,0,0,2,5,15,9.7,-6.0,Wendell Carter Jr.,5,10,0.5
743,11/9/2022,23.567123287671233,W,1,34.266666666666666,5,9,0.556,1,2,0.5,2,2,1.0,0,12,12,3,0,1,5,2,13,9.3,10.0,Wendell Carter Jr.,4,7,0.5714285714285714
744,11/11/2022,23.572602739726026,W,1,32.4,7,15,0.467,2,5,0.4,4,4,1.0,3,7,10,5,0,1,3,0,20,17.7,10.0,Wendell Carter Jr.,5,10,0.5
745,11/14/2022,23.58082191780822,L,1,31.85,5,8,0.625,3,4,0.75,7,10,0.7,3,2,5,4,0,2,1,1,20,20.7,-12.0,Wendell Carter Jr.,2,4,0.5
746,11/18/2022,23.59178082191781,W,1,33.93333333333333,9,16,0.563,1,6,0.167,2,2,1.0,0,8,8,5,0,0,5,4,21,12.7,13.0,Wendell Carter Jr.,8,10,0.8
747,10/19/2022,19.775342465753425,L,0,21.916666666666668,0,3,0.0,0,2,0.0,0,0,,0,3,3,0,0,1,0,3,0,-1.7,-14.0,Caleb Houstan,0,1,0.0
748,10/24/2022,19.78904109589041,L,0,21.083333333333332,2,4,0.5,1,2,0.5,2,2,1.0,0,3,3,0,0,0,1,0,7,4.9,-17.0,Caleb Houstan,1,2,0.5
749,10/26/2022,19.794520547945204,L,0,15.083333333333334,1,1,1.0,0,0,,0,0,,0,0,0,0,1,0,0,4,2,1.1,2.0,Caleb Houstan,1,1,1.0
750,10/28/2022,19.8,W,0,24.033333333333335,1,6,0.167,1,6,0.167,0,0,,0,3,3,2,0,0,2,4,3,-2.1,2.0,Caleb Houstan,0,0,
751,11/1/2022,19.81095890410959,L,0,14.866666666666667,1,5,0.2,1,3,0.333,0,0,,0,1,1,1,0,0,0,0,3,0.9,5.0,Caleb Houstan,0,2,0.0
752,11/3/2022,19.816438356164383,W,0,4.866666666666667,0,1,0.0,0,1,0.0,2,2,1.0,1,0,1,0,1,0,0,1,2,2.6,11.0,Caleb Houstan,0,0,
753,11/7/2022,19.827397260273973,L,0,9.25,0,0,,0,0,,0,0,,1,0,1,0,0,0,0,0,0,0.7,-5.0,Caleb Houstan,0,0,
754,11/9/2022,19.832876712328765,W,0,26.416666666666668,3,5,0.6,1,2,0.5,1,2,0.5,1,1,2,1,0,0,0,1,8,6.6,10.0,Caleb Houstan,2,3,0.6666666666666666
755,11/11/2022,19.838356164383562,W,0,19.266666666666666,1,1,1.0,1,1,1.0,0,0,,0,2,2,0,0,0,1,0,3,2.3,-1.0,Caleb Houstan,0,0,
756,11/14/2022,19.846575342465755,L,0,15.333333333333334,2,5,0.4,2,5,0.4,0,0,,2,2,4,1,0,0,0,1,6,5.6,8.0,Caleb Houstan,0,0,
757,11/16/2022,19.852054794520548,L,0,22.316666666666666,1,3,0.333,1,3,0.333,0,0,,0,4,4,0,0,0,0,0,3,2.5,3.0,Caleb Houstan,0,0,
758,11/19/2022,19.86027397260274,L,0,18.516666666666666,0,4,0.0,0,1,0.0,2,2,1.0,1,1,2,1,0,0,0,4,2,-0.7,-4.0,Caleb Houstan,0,3,0.0
759,11/21/2022,19.865753424657534,L,0,12.616666666666667,1,1,1.0,1,1,1.0,1,2,0.5,1,0,1,1,0,0,1,3,4,2.5,-9.0,Caleb Houstan,0,0,
760,11/25/2022,19.876712328767123,L,0,14.083333333333334,3,6,0.5,1,4,0.25,0,0,,2,0,2,2,0,0,0,2,7,6.0,0.0,Caleb Houstan,2,2,1.0
761,11/27/2022,19.882191780821916,L,0,26.15,4,8,0.5,4,8,0.5,0,0,,0,1,1,3,1,0,0,2,12,10.6,-24.0,Caleb Houstan,0,0,
762,10/19/2022,21.378082191780823,L,1,25.233333333333334,8,11,0.727,4,6,0.667,1,1,1.0,1,0,1,3,2,0,4,6,21,14.9,3.0,Jalen Suggs,4,5,0.8
763,10/21/2022,21.383561643835616,L,1,15.833333333333334,1,5,0.2,0,3,0.0,1,3,0.333,1,1,2,1,3,0,3,3,3,-0.4,-6.0,Jalen Suggs,1,2,0.5
764,11/1/2022,21.413698630136988,L,0,28.433333333333334,3,14,0.214,1,9,0.111,2,2,1.0,0,2,2,4,2,1,4,1,9,2.1,-17.0,Jalen Suggs,2,5,0.4
765,11/3/2022,21.41917808219178,W,1,36.21666666666667,9,17,0.529,2,6,0.333,6,11,0.545,0,1,1,9,4,0,3,4,26,21.7,-3.0,Jalen Suggs,7,11,0.6363636363636364
766,11/5/2022,21.424657534246574,L,1,34.6,2,6,0.333,0,3,0.0,2,2,1.0,1,0,1,7,1,1,6,5,6,1.9,10.0,Jalen Suggs,2,3,0.6666666666666666
767,11/7/2022,21.43013698630137,L,1,32.85,5,8,0.625,0,1,0.0,1,4,0.25,1,4,5,6,1,0,2,4,11,9.7,-1.0,Jalen Suggs,5,7,0.7142857142857143
768,11/9/2022,21.435616438356163,W,1,25.633333333333333,4,12,0.333,2,4,0.5,2,2,1.0,1,6,7,4,1,1,1,3,12,10.0,5.0,Jalen Suggs,2,8,0.25
769,11/11/2022,21.44109589041096,W,1,31.616666666666667,7,12,0.583,1,4,0.25,1,1,1.0,0,3,3,5,0,0,2,3,16,11.6,16.0,Jalen Suggs,6,8,0.75
770,11/14/2022,21.44931506849315,L,1,30.083333333333332,1,10,0.1,0,3,0.0,0,0,,1,4,5,7,1,1,5,6,2,-3.5,-13.0,Jalen Suggs,1,7,0.14285714285714285
771,11/16/2022,21.454794520547946,L,1,32.65,8,17,0.471,5,11,0.455,2,3,0.667,3,3,6,6,2,0,3,4,23,18.5,-12.0,Jalen Suggs,3,6,0.5
772,11/18/2022,21.46027397260274,W,1,35.3,7,16,0.438,2,6,0.333,4,4,1.0,3,2,5,8,1,1,6,2,20,14.8,-10.0,Jalen Suggs,5,10,0.5
773,11/19/2022,21.463013698630135,L,1,33.28333333333333,5,12,0.417,2,6,0.333,0,0,,2,3,5,8,0,3,4,1,12,11.2,3.0,Jalen Suggs,3,6,0.5
774,11/21/2022,21.46849315068493,L,1,23.9,5,13,0.385,1,4,0.25,1,2,0.5,1,1,2,4,4,0,2,1,12,9.9,-13.0,Jalen Suggs,4,9,0.4444444444444444
775,11/25/2022,21.47945205479452,L,1,18.866666666666667,0,2,0.0,0,2,0.0,0,0,,0,1,1,4,0,1,2,1,0,0.0,-9.0,Jalen Suggs,0,0,
776,10/19/2022,19.934246575342467,L,1,35.333333333333336,11,18,0.611,0,0,,5,7,0.714,2,7,9,5,0,2,4,5,27,20.4,2.0,Paolo Banchero,11,18,0.6111111111111112
777,10/21/2022,19.93972602739726,L,1,33.63333333333333,6,18,0.333,1,6,0.167,7,8,0.875,2,10,12,2,1,3,4,1,20,13.9,-10.0,Paolo Banchero,5,12,0.4166666666666667
778,10/22/2022,19.942465753424656,L,1,33.21666666666667,6,19,0.316,2,7,0.286,9,11,0.818,1,4,5,3,0,1,2,1,23,13.6,-16.0,Paolo Banchero,4,12,0.3333333333333333
779,10/24/2022,19.947945205479453,L,1,33.583333333333336,6,13,0.462,0,3,0.0,9,11,0.818,0,4,4,2,2,0,1,3,21,15.9,-2.0,Paolo Banchero,6,10,0.6
780,10/26/2022,19.953424657534246,L,1,36.983333333333334,10,19,0.526,3,5,0.6,6,8,0.75,1,7,8,4,1,2,3,2,29,23.1,-7.0,Paolo Banchero,7,14,0.5
781,10/28/2022,19.958904109589042,W,1,27.183333333333334,8,14,0.571,2,4,0.5,3,7,0.429,2,10,12,7,0,0,2,0,21,20.1,27.0,Paolo Banchero,6,10,0.6
782,10/30/2022,19.964383561643835,L,1,32.38333333333333,6,20,0.3,1,6,0.167,5,8,0.625,0,3,3,4,0,0,2,5,18,4.9,6.0,Paolo Banchero,5,14,0.35714285714285715
783,11/1/2022,19.96986301369863,L,1,37.43333333333333,6,13,0.462,0,1,0.0,3,3,1.0,0,8,8,2,1,0,4,0,15,9.1,1.0,Paolo Banchero,6,12,0.5
784,11/3/2022,19.975342465753425,W,1,36.1,8,17,0.471,0,4,0.0,6,9,0.667,0,8,8,3,1,1,5,3,22,12.1,-19.0,Paolo Banchero,8,13,0.6153846153846154
785,11/5/2022,19.980821917808218,L,1,39.85,14,26,0.538,0,3,0.0,5,5,1.0,1,15,16,4,0,1,1,2,33,27.3,1.0,Paolo Banchero,14,23,0.6086956521739131
786,11/7/2022,19.986301369863014,L,1,35.483333333333334,8,16,0.5,2,4,0.5,12,14,0.857,0,6,6,4,2,0,5,4,30,21.2,-9.0,Paolo Banchero,6,12,0.5
787,11/25/2022,20.035616438356165,L,1,35.733333333333334,5,12,0.417,1,3,0.333,8,11,0.727,2,2,4,3,1,0,4,1,19,12.1,-9.0,Paolo Banchero,4,9,0.4444444444444444
788,11/27/2022,20.041095890410958,L,1,31.233333333333334,7,17,0.412,1,4,0.25,3,6,0.5,0,1,1,1,0,0,0,3,18,7.5,-14.0,Paolo Banchero,6,13,0.46153846153846156
789,10/21/2022,25.326027397260273,L,0,0.6166666666666667,0,0,,0,0,,0,0,,0,1,1,0,0,0,0,0,0,0.3,2.0,Kevon Harris,0,0,
790,10/22/2022,25.328767123287673,L,0,18.75,1,4,0.25,0,1,0.0,1,2,0.5,0,3,3,1,1,0,1,2,3,1.0,2.0,Kevon Harris,1,3,0.3333333333333333
791,10/26/2022,25.339726027397262,L,0,22.233333333333334,0,3,0.0,0,1,0.0,0,0,,0,3,3,0,1,0,2,3,0,-3.4,-4.0,Kevon Harris,0,2,0.0
792,10/28/2022,25.345205479452055,W,0,5.516666666666667,1,2,0.5,0,1,0.0,0,0,,0,0,0,2,0,0,1,0,2,1.4,-9.0,Kevon Harris,1,1,1.0
793,10/30/2022,25.350684931506848,L,0,17.066666666666666,3,4,0.75,2,3,0.667,4,5,0.8,1,2,3,1,0,0,2,3,12,8.8,-9.0,Kevon Harris,1,1,1.0
794,11/1/2022,25.356164383561644,L,0,6.233333333333333,0,2,0.0,0,0,,0,0,,0,1,1,0,0,0,0,1,0,-1.5,-13.0,Kevon Harris,0,2,0.0
795,11/3/2022,25.361643835616437,W,0,20.833333333333332,4,7,0.571,2,3,0.667,2,3,0.667,4,1,5,0,1,0,1,2,12,10.6,12.0,Kevon Harris,2,4,0.5
796,11/5/2022,25.367123287671234,L,0,16.066666666666666,1,4,0.25,0,2,0.0,2,2,1.0,1,2,3,0,0,0,0,1,4,2.5,-13.0,Kevon Harris,1,2,0.5
797,11/7/2022,25.372602739726027,L,0,15.133333333333333,0,5,0.0,0,0,,2,2,1.0,2,0,2,1,1,0,1,4,2,-1.0,-6.0,Kevon Harris,0,5,0.0
798,11/14/2022,25.39178082191781,L,0,11.083333333333334,1,2,0.5,1,1,1.0,0,0,,2,1,3,0,0,0,0,1,3,3.3,3.0,Kevon Harris,0,1,0.0
799,11/16/2022,25.397260273972602,L,0,6.183333333333334,2,2,1.0,0,0,,5,5,1.0,1,0,1,1,0,0,0,0,9,9.8,0.0,Kevon Harris,2,2,1.0
800,11/19/2022,25.405479452054795,L,0,3.7333333333333334,0,1,0.0,0,0,,0,0,,0,2,2,0,0,0,0,0,0,-0.1,4.0,Kevon Harris,0,1,0.0
801,11/21/2022,25.410958904109588,L,0,13.866666666666667,1,4,0.25,0,1,0.0,0,0,,4,2,6,1,1,1,2,1,2,3.0,-2.0,Kevon Harris,1,3,0.3333333333333333
802,10/28/2022,25.58082191780822,W,0,13.316666666666666,2,3,0.667,1,2,0.5,0,0,,0,2,2,0,0,0,0,3,5,3.1,-5.0,Admiral Schofield,1,1,1.0
803,10/30/2022,25.586301369863016,L,0,4.083333333333333,0,0,,0,0,,0,0,,0,0,0,0,0,0,0,1,0,-0.4,-4.0,Admiral Schofield,0,0,
804,11/5/2022,25.602739726027398,L,0,2.6666666666666665,0,0,,0,0,,0,0,,0,0,0,0,0,0,0,0,0,0.0,-4.0,Admiral Schofield,0,0,
805,11/9/2022,25.613698630136987,W,0,0.55,0,0,,0,0,,0,0,,0,1,1,0,0,0,0,1,0,-0.1,2.0,Admiral Schofield,0,0,
806,11/11/2022,25.61917808219178,W,0,10.883333333333333,1,3,0.333,1,3,0.333,0,0,,0,2,2,0,0,0,0,0,3,1.9,0.0,Admiral Schofield,0,0,
807,11/16/2022,25.632876712328766,L,0,11.5,3,4,0.75,0,1,0.0,0,0,,1,0,1,3,1,0,1,5,6,5.2,-9.0,Admiral Schofield,3,3,1.0
808,11/18/2022,25.638356164383563,W,0,7.1,0,1,0.0,0,1,0.0,0,0,,0,1,1,0,0,0,0,1,0,-0.8,-4.0,Admiral Schofield,0,0,
809,11/19/2022,25.64109589041096,L,0,13.166666666666666,1,5,0.2,0,2,0.0,0,0,,1,1,2,1,0,0,0,2,2,-0.2,-20.0,Admiral Schofield,1,3,0.3333333333333333
810,11/21/2022,25.646575342465752,L,0,21.283333333333335,4,11,0.364,2,7,0.286,0,0,,3,0,3,1,0,0,0,4,10,5.1,-7.0,Admiral Schofield,2,4,0.5
811,11/27/2022,25.663013698630138,L,0,21.883333333333333,2,3,0.667,2,3,0.667,0,0,,3,1,4,0,0,0,0,5,6,5.1,-13.0,Admiral Schofield,0,0,
812,10/21/2022,22.435616438356163,L,0,28.483333333333334,8,12,0.667,4,5,0.8,5,7,0.714,0,0,0,2,1,1,2,1,25,19.7,-1.0,Cole Anthony,4,7,0.5714285714285714
813,10/22/2022,22.438356164383563,L,1,31.716666666666665,6,13,0.462,2,5,0.4,0,2,0.0,1,8,9,6,1,1,2,4,14,11.9,0.0,Cole Anthony,4,8,0.5
814,10/24/2022,22.443835616438356,L,1,29.466666666666665,6,18,0.333,0,5,0.0,2,2,1.0,2,2,4,4,1,0,1,4,14,7.0,-7.0,Cole Anthony,6,13,0.46153846153846156
815,10/26/2022,22.44931506849315,L,1,32.05,2,10,0.2,1,5,0.2,4,4,1.0,0,6,6,5,0,1,3,5,9,3.8,-18.0,Cole Anthony,1,5,0.2
816,11/18/2022,28.17808219178082,W,0,23.533333333333335,3,5,0.6,1,1,1.0,0,0,,0,1,1,1,1,0,0,1,7,6.3,1.0,Gary Harris,2,4,0.5
817,11/21/2022,28.186301369863013,L,0,22.516666666666666,6,11,0.545,3,6,0.5,3,3,1.0,1,2,3,0,0,0,1,5,18,11.0,-9.0,Gary Harris,3,5,0.6
818,11/25/2022,28.197260273972603,L,0,27.216666666666665,3,8,0.375,1,3,0.333,0,0,,1,2,3,3,1,0,3,2,7,3.2,3.0,Gary Harris,2,5,0.4
819,11/27/2022,28.202739726027396,L,1,29.133333333333333,4,9,0.444,1,5,0.2,2,2,1.0,0,3,3,5,1,0,0,2,11,10.9,-7.0,Gary Harris,3,4,0.75
820,11/25/2022,25.583561643835615,L,0,16.766666666666666,2,8,0.25,1,6,0.167,2,2,1.0,1,4,5,0,1,0,1,3,7,2.9,1.0,Moritz Wagner,1,2,0.5
821,11/27/2022,25.589041095890412,L,0,26.416666666666668,3,7,0.429,1,5,0.2,5,6,0.833,3,3,6,4,1,0,4,5,12,8.7,-14.0,Moritz Wagner,2,2,1.0
822,10/19/2022,26.86027397260274,W,1,22.633333333333333,5,10,0.5,1,3,0.333,2,3,0.667,0,4,4,2,3,0,0,4,13,11.6,36.0,Kelly Oubre Jr.,4,7,0.5714285714285714
823,10/21/2022,26.865753424657534,L,1,30.2,6,13,0.462,2,6,0.333,1,2,0.5,1,3,4,0,3,0,2,4,15,8.9,-24.0,Kelly Oubre Jr.,4,7,0.5714285714285714
824,10/23/2022,26.87123287671233,W,1,32.5,9,20,0.45,3,6,0.5,3,3,1.0,2,8,10,0,1,0,1,4,24,15.8,12.0,Kelly Oubre Jr.,6,14,0.42857142857142855
825,10/26/2022,26.87945205479452,L,1,35.2,7,18,0.389,1,6,0.167,2,3,0.667,1,4,5,0,2,1,2,5,17,7.4,-10.0,Kelly Oubre Jr.,6,12,0.5
826,10/28/2022,26.884931506849316,L,1,21.85,4,16,0.25,2,10,0.2,2,4,0.5,2,2,4,1,0,0,1,1,12,2.9,-13.0,Kelly Oubre Jr.,2,6,0.3333333333333333
827,10/29/2022,26.887671232876713,W,1,38.266666666666666,7,18,0.389,3,7,0.429,1,2,0.5,1,4,5,5,0,1,0,0,18,13.9,10.0,Kelly Oubre Jr.,4,11,0.36363636363636365
828,10/31/2022,26.893150684931506,L,1,25.016666666666666,6,13,0.462,4,8,0.5,0,0,,0,4,4,2,1,0,2,2,16,10.1,-10.0,Kelly Oubre Jr.,2,5,0.4
829,11/2/2022,26.898630136986302,L,1,30.033333333333335,9,17,0.529,5,11,0.455,1,2,0.5,1,4,5,1,2,1,0,2,24,19.8,-10.0,Kelly Oubre Jr.,4,6,0.6666666666666666
830,11/4/2022,26.904109589041095,L,1,24.6,5,12,0.417,2,5,0.4,5,6,0.833,0,1,1,1,2,0,2,3,17,10.0,-40.0,Kelly Oubre Jr.,3,7,0.42857142857142855
831,11/5/2022,26.90684931506849,L,1,31.1,5,14,0.357,4,11,0.364,4,7,0.571,0,1,1,0,0,0,1,5,18,6.3,-14.0,Kelly Oubre Jr.,1,3,0.3333333333333333
832,11/7/2022,26.912328767123288,L,1,28.716666666666665,8,20,0.4,1,7,0.143,3,3,1.0,0,1,1,0,0,0,1,5,20,6.5,-3.0,Kelly Oubre Jr.,7,13,0.5384615384615384
833,11/9/2022,26.91780821917808,L,1,35.88333333333333,5,19,0.263,1,11,0.091,5,7,0.714,4,4,8,3,1,0,1,2,16,9.2,-4.0,Kelly Oubre Jr.,4,8,0.5
834,11/10/2022,26.92054794520548,L,1,38.733333333333334,11,20,0.55,7,13,0.538,0,0,,0,7,7,2,2,1,3,5,29,20.6,2.0,Kelly Oubre Jr.,4,7,0.5714285714285714
835,11/12/2022,26.926027397260274,L,1,33.75,8,16,0.5,2,5,0.4,2,3,0.667,1,7,8,1,0,1,1,1,20,14.4,-22.0,Kelly Oubre Jr.,6,11,0.5454545454545454
836,11/14/2022,26.931506849315067,W,1,33.81666666666667,5,18,0.278,0,6,0.0,6,8,0.75,3,2,5,0,6,0,1,4,16,10.7,17.0,Kelly Oubre Jr.,5,12,0.4166666666666667
837,11/16/2022,26.936986301369863,L,1,35.516666666666666,8,21,0.381,1,7,0.143,0,0,,7,6,13,2,2,0,1,4,17,13.0,-11.0,Kelly Oubre Jr.,7,14,0.5
838,11/18/2022,26.942465753424656,L,1,38.75,12,21,0.571,5,9,0.556,5,5,1.0,1,2,3,0,3,0,2,6,34,24.0,6.0,Kelly Oubre Jr.,7,12,0.5833333333333334
839,11/20/2022,26.947945205479453,L,1,29.35,10,20,0.5,1,7,0.143,2,2,1.0,1,6,7,0,1,1,0,3,23,16.0,-3.0,Kelly Oubre Jr.,9,13,0.6923076923076923
840,11/23/2022,26.956164383561642,W,1,32.8,6,15,0.4,0,6,0.0,2,2,1.0,2,2,4,1,2,0,1,3,14,8.4,4.0,Kelly Oubre Jr.,6,9,0.6666666666666666
841,11/25/2022,26.96164383561644,W,1,34.36666666666667,10,21,0.476,3,7,0.429,5,8,0.625,2,4,6,2,3,0,0,1,28,22.7,7.0,Kelly Oubre Jr.,7,14,0.5
842,10/19/2022,24.156164383561645,W,1,29.85,7,12,0.583,3,4,0.75,0,0,,2,5,7,4,0,3,1,2,17,17.4,29.0,P.J. Washington,4,8,0.5
843,10/21/2022,24.161643835616438,L,1,29.35,4,13,0.308,2,8,0.25,0,0,,2,1,3,2,1,1,3,5,10,2.3,-24.0,P.J. Washington,2,5,0.4
844,10/23/2022,24.167123287671235,W,1,21.883333333333333,4,8,0.5,2,4,0.5,2,2,1.0,1,2,3,1,0,0,2,4,12,6.4,0.0,P.J. Washington,2,4,0.5
845,10/26/2022,24.175342465753424,L,1,37.833333333333336,5,14,0.357,4,8,0.5,3,4,0.75,0,5,5,1,1,0,2,1,17,9.6,-1.0,P.J. Washington,1,6,0.16666666666666666
846,10/28/2022,24.18082191780822,L,1,22.483333333333334,2,9,0.222,1,6,0.167,0,0,,0,1,1,0,0,3,1,3,5,-0.3,-19.0,P.J. Washington,1,3,0.3333333333333333
847,10/29/2022,24.183561643835617,W,1,40.11666666666667,13,23,0.565,1,6,0.167,4,4,1.0,1,6,7,1,1,0,1,4,31,21.7,2.0,P.J. Washington,12,17,0.7058823529411765
848,10/31/2022,24.18904109589041,L,1,36.53333333333333,12,21,0.571,3,4,0.75,1,2,0.5,1,4,5,3,0,2,2,3,28,19.9,-8.0,P.J. Washington,9,17,0.5294117647058824
849,11/2/2022,24.194520547945206,L,1,31.366666666666667,3,10,0.3,0,2,0.0,2,2,1.0,2,5,7,3,0,1,4,2,8,3.1,-17.0,P.J. Washington,3,8,0.375
850,11/4/2022,24.2,L,1,27.433333333333334,2,15,0.133,1,7,0.143,5,6,0.833,2,2,4,0,0,1,2,1,10,0.2,-29.0,P.J. Washington,1,8,0.125
851,11/5/2022,24.202739726027396,L,1,34.016666666666666,5,11,0.455,3,6,0.5,5,7,0.714,0,3,3,2,0,4,0,1,18,16.2,1.0,P.J. Washington,2,5,0.4
852,11/7/2022,24.208219178082192,L,1,30.466666666666665,11,18,0.611,2,6,0.333,1,1,1.0,1,3,4,0,3,0,1,2,25,19.6,-27.0,P.J. Washington,9,12,0.75
853,11/9/2022,24.213698630136985,L,1,32.63333333333333,3,12,0.25,1,6,0.167,3,4,0.75,4,3,7,4,2,0,2,3,10,7.7,9.0,P.J. Washington,2,6,0.3333333333333333
854,11/10/2022,24.216438356164385,L,1,34.75,4,9,0.444,1,3,0.333,0,2,0.0,0,5,5,0,0,0,4,5,9,-1.0,-1.0,P.J. Washington,3,6,0.5
855,11/12/2022,24.221917808219178,L,1,27.583333333333332,2,7,0.286,0,2,0.0,0,0,,0,1,1,0,0,1,1,5,4,-2.1,-4.0,P.J. Washington,2,5,0.4
856,11/14/2022,24.22739726027397,W,1,36.21666666666667,6,13,0.462,0,3,0.0,2,2,1.0,3,3,6,5,1,0,0,1,14,14.4,-2.0,P.J. Washington,6,10,0.6
857,11/16/2022,24.232876712328768,L,1,36.083333333333336,7,16,0.438,4,9,0.444,6,7,0.857,0,4,4,4,0,0,1,3,24,17.0,-20.0,P.J. Washington,3,7,0.42857142857142855
858,11/18/2022,24.23835616438356,L,1,46.18333333333333,10,20,0.5,2,10,0.2,6,6,1.0,1,9,10,4,4,0,2,2,28,25.4,-18.0,P.J. Washington,8,10,0.8
859,11/20/2022,24.243835616438357,L,1,34.3,5,14,0.357,2,6,0.333,1,2,0.5,1,4,5,1,0,1,3,1,13,4.7,-16.0,P.J. Washington,3,8,0.375
860,11/23/2022,24.252054794520546,W,1,34.083333333333336,8,14,0.571,3,5,0.6,0,0,,1,5,6,3,0,0,2,3,19,13.5,-1.0,P.J. Washington,5,9,0.5555555555555556
861,11/25/2022,24.257534246575343,W,1,20.033333333333335,6,13,0.462,1,5,0.2,3,4,0.75,1,2,3,0,0,1,2,5,16,6.9,3.0,P.J. Washington,5,8,0.625
862,10/19/2022,24.887671232876713,W,0,21.433333333333334,7,13,0.538,0,0,,5,7,0.714,8,2,10,0,0,0,0,2,19,17.3,28.0,Nick Richards,7,13,0.5384615384615384
863,10/21/2022,24.893150684931506,L,0,26.216666666666665,2,4,0.5,0,0,,2,2,1.0,1,5,6,0,0,0,0,2,6,5.4,-8.0,Nick Richards,2,4,0.5
864,10/23/2022,24.898630136986302,W,0,20.15,9,9,1.0,0,0,,2,3,0.667,5,6,11,1,0,2,0,1,20,23.9,25.0,Nick Richards,9,9,1.0
865,10/26/2022,24.90684931506849,L,0,19.083333333333332,2,2,1.0,0,0,,3,4,0.75,2,2,4,2,0,0,0,0,7,9.4,12.0,Nick Richards,2,2,1.0
866,10/28/2022,24.912328767123288,L,0,20.366666666666667,5,7,0.714,0,0,,4,5,0.8,2,4,6,0,0,0,0,3,14,12.1,-13.0,Nick Richards,5,7,0.7142857142857143
867,10/29/2022,24.915068493150685,W,0,19.85,3,8,0.375,0,0,,3,3,1.0,5,3,8,2,0,0,1,2,9,8.6,-3.0,Nick Richards,3,8,0.375
868,10/31/2022,24.92054794520548,L,0,19.433333333333334,2,3,0.667,0,0,,0,2,0.0,0,4,4,2,0,1,2,3,4,2.0,-1.0,Nick Richards,2,3,0.6666666666666666
869,11/2/2022,24.926027397260274,L,0,13.9,2,3,0.667,0,0,,0,2,0.0,1,1,2,1,0,2,2,2,4,2.2,-16.0,Nick Richards,2,3,0.6666666666666666
870,11/4/2022,24.931506849315067,L,0,18.883333333333333,2,9,0.222,0,0,,5,6,0.833,4,5,9,2,0,1,1,1,9,8.1,-9.0,Nick Richards,2,9,0.2222222222222222
871,11/5/2022,24.934246575342467,L,0,17.716666666666665,3,5,0.6,0,0,,4,5,0.8,4,5,9,1,0,0,2,4,10,8.7,9.0,Nick Richards,3,5,0.6
872,11/7/2022,24.93972602739726,L,0,23.733333333333334,4,6,0.667,0,0,,0,0,,3,3,6,0,0,2,0,2,8,9.0,-3.0,Nick Richards,4,6,0.6666666666666666
873,11/9/2022,24.945205479452056,L,0,14.75,2,3,0.667,0,0,,2,3,0.667,1,1,2,0,0,1,1,1,6,4.6,-9.0,Nick Richards,2,3,0.6666666666666666
874,11/10/2022,24.947945205479453,L,0,14.166666666666666,4,4,1.0,0,0,,2,3,0.667,2,2,4,0,1,1,1,4,10,9.5,-9.0,Nick Richards,4,4,1.0
875,11/12/2022,24.953424657534246,L,0,21.3,6,7,0.857,0,0,,3,3,1.0,2,3,5,0,0,0,1,3,15,12.6,-1.0,Nick Richards,6,7,0.8571428571428571
876,11/14/2022,24.958904109589042,W,0,14.566666666666666,2,2,1.0,0,0,,2,2,1.0,2,0,2,1,0,2,1,3,6,6.7,-4.0,Nick Richards,2,2,1.0
877,11/16/2022,24.964383561643835,L,0,18.783333333333335,2,4,0.5,0,0,,1,1,1.0,4,1,5,0,0,0,0,1,5,5.7,10.0,Nick Richards,2,4,0.5
878,11/18/2022,24.96986301369863,L,0,29.6,5,10,0.5,0,0,,3,4,0.75,6,8,14,0,0,3,1,4,13,13.7,-2.0,Nick Richards,5,10,0.5
879,11/20/2022,24.975342465753425,L,0,17.433333333333334,4,8,0.5,0,0,,3,4,0.75,4,6,10,0,0,0,1,2,11,9.4,-5.0,Nick Richards,4,8,0.5
880,11/23/2022,24.983561643835618,W,0,21.383333333333333,5,10,0.5,0,0,,3,4,0.75,5,8,13,0,1,1,1,1,13,13.8,11.0,Nick Richards,5,10,0.5
881,11/25/2022,24.98904109589041,W,0,19.6,1,2,0.5,0,0,,0,0,,0,3,3,1,0,2,2,2,2,1.2,2.0,Nick Richards,1,2,0.5
882,10/19/2022,32.62465753424657,W,1,22.233333333333334,5,9,0.556,0,0,,2,2,1.0,4,3,7,4,0,1,1,2,12,13.1,6.0,Mason Plumlee,5,9,0.5555555555555556
883,10/21/2022,32.63013698630137,L,1,18.866666666666667,4,5,0.8,0,0,,0,0,,2,3,5,4,0,0,1,5,8,8.2,-1.0,Mason Plumlee,4,5,0.8
884,10/23/2022,32.635616438356166,W,1,26.416666666666668,2,4,0.5,0,0,,4,9,0.444,1,7,8,6,0,1,2,2,8,8.9,-7.0,Mason Plumlee,2,4,0.5
885,10/26/2022,32.64383561643836,L,1,31.166666666666668,2,3,0.667,0,0,,4,6,0.667,2,5,7,4,1,1,2,5,8,9.3,-15.0,Mason Plumlee,2,3,0.6666666666666666
886,10/28/2022,32.64931506849315,L,1,20.533333333333335,1,2,0.5,0,0,,0,0,,1,3,4,4,0,0,2,3,2,2.2,-19.0,Mason Plumlee,1,2,0.5
887,10/29/2022,32.652054794520545,W,1,23.216666666666665,2,4,0.5,0,0,,2,6,0.333,4,5,9,7,1,0,2,4,6,9.0,6.0,Mason Plumlee,2,4,0.5
888,10/31/2022,32.657534246575345,L,1,28.166666666666668,5,6,0.833,0,0,,2,5,0.4,2,8,10,2,0,1,2,4,12,10.9,-4.0,Mason Plumlee,5,6,0.8333333333333334
889,11/2/2022,32.66301369863014,L,1,25.316666666666666,4,8,0.5,0,0,,3,4,0.75,4,9,13,3,0,2,2,3,11,12.4,1.0,Mason Plumlee,4,8,0.5
890,11/4/2022,32.66849315068493,L,1,21.733333333333334,3,5,0.6,0,0,,1,2,0.5,2,5,7,3,1,0,1,1,7,8.9,-31.0,Mason Plumlee,3,5,0.6
891,11/5/2022,32.67123287671233,L,1,30.05,4,8,0.5,0,0,,1,1,1.0,3,8,11,3,1,0,2,5,9,8.6,-13.0,Mason Plumlee,4,8,0.5
892,11/7/2022,32.676712328767124,L,1,22.316666666666666,1,5,0.2,0,0,,4,6,0.667,7,3,10,5,2,0,2,4,6,9.8,-6.0,Mason Plumlee,1,5,0.2
893,11/9/2022,32.68219178082192,L,1,32.2,7,10,0.7,0,0,,2,5,0.4,5,7,12,4,0,1,1,2,16,17.9,-1.0,Mason Plumlee,7,10,0.7
894,11/10/2022,32.68493150684932,L,1,38.833333333333336,4,4,1.0,0,0,,5,7,0.714,2,13,15,5,0,0,3,4,13,15.2,4.0,Mason Plumlee,4,4,1.0
895,11/12/2022,32.69041095890411,L,1,26.7,4,6,0.667,0,0,,1,1,1.0,1,4,5,5,0,0,3,2,9,8.0,-16.0,Mason Plumlee,4,6,0.6666666666666666
896,11/14/2022,32.6958904109589,W,1,31.466666666666665,8,9,0.889,0,0,,2,2,1.0,4,6,10,2,3,1,2,5,18,20.6,10.0,Mason Plumlee,8,9,0.8888888888888888
897,11/16/2022,32.701369863013696,L,1,29.216666666666665,5,7,0.714,0,0,,2,2,1.0,2,8,10,3,0,2,3,3,12,12.2,-22.0,Mason Plumlee,5,7,0.7142857142857143
898,11/18/2022,32.706849315068496,L,1,28.183333333333334,0,4,0.0,0,0,,2,4,0.5,2,4,6,4,1,1,2,6,2,1.1,-8.0,Mason Plumlee,0,4,0.0
899,11/20/2022,32.71232876712329,L,1,30.566666666666666,2,8,0.25,0,0,,5,8,0.625,4,4,8,4,0,1,2,4,9,6.9,1.0,Mason Plumlee,2,8,0.25
900,11/23/2022,32.72054794520548,W,1,26.483333333333334,4,6,0.667,0,0,,3,6,0.5,1,12,13,6,1,0,2,1,11,14.3,-5.0,Mason Plumlee,4,6,0.6666666666666666
901,11/25/2022,32.726027397260275,W,1,28.333333333333332,1,4,0.25,0,0,,1,4,0.25,6,6,12,5,1,0,3,2,3,6.1,2.0,Mason Plumlee,1,4,0.25
902,10/19/2022,24.715068493150685,W,0,23.333333333333332,2,5,0.4,1,2,0.5,0,0,,0,5,5,2,1,1,0,0,5,6.9,13.0,Jalen McDaniels,1,3,0.3333333333333333
903,10/21/2022,24.720547945205478,L,0,26.5,5,7,0.714,4,4,1.0,0,0,,0,5,5,2,0,1,1,4,14,12.1,7.0,Jalen McDaniels,1,3,0.3333333333333333
904,10/23/2022,24.726027397260275,W,0,20.35,3,6,0.5,1,3,0.333,2,2,1.0,1,4,5,3,0,1,1,3,9,8.5,13.0,Jalen McDaniels,2,3,0.6666666666666666
905,10/26/2022,24.734246575342464,L,0,22.8,6,10,0.6,3,3,1.0,2,2,1.0,1,5,6,2,1,1,1,4,17,15.1,14.0,Jalen McDaniels,3,7,0.42857142857142855
906,10/28/2022,24.73972602739726,L,0,22.083333333333332,1,7,0.143,0,2,0.0,4,4,1.0,1,6,7,2,1,0,1,3,6,4.2,-8.0,Jalen McDaniels,1,5,0.2
907,10/29/2022,24.742465753424657,W,0,32.483333333333334,4,10,0.4,2,5,0.4,2,2,1.0,2,9,11,2,0,0,2,1,12,9.7,-1.0,Jalen McDaniels,2,5,0.4
908,10/31/2022,24.747945205479454,L,0,27.033333333333335,5,11,0.455,3,4,0.75,0,0,,1,0,1,4,2,0,2,5,13,8.8,-6.0,Jalen McDaniels,2,7,0.2857142857142857
909,11/2/2022,24.753424657534246,L,0,35.63333333333333,5,18,0.278,0,5,0.0,1,2,0.5,3,3,6,2,5,2,2,2,11,8.0,-13.0,Jalen McDaniels,5,13,0.38461538461538464
910,11/4/2022,24.75890410958904,L,1,21.466666666666665,1,5,0.2,0,4,0.0,2,2,1.0,0,1,1,2,1,0,2,2,4,0.8,-33.0,Jalen McDaniels,1,1,1.0
911,11/5/2022,24.76164383561644,L,0,27.766666666666666,3,7,0.429,0,3,0.0,0,0,,2,4,6,3,1,0,2,2,6,5.2,-12.0,Jalen McDaniels,3,4,0.75
912,11/7/2022,24.767123287671232,L,0,27.383333333333333,4,9,0.444,1,4,0.25,0,1,0.0,2,5,7,1,3,2,1,3,9,9.7,5.0,Jalen McDaniels,3,5,0.6
913,11/9/2022,24.77260273972603,L,0,20.45,3,7,0.429,1,3,0.333,0,0,,2,1,3,1,1,0,0,2,7,5.9,-16.0,Jalen McDaniels,2,4,0.5
914,11/10/2022,24.775342465753425,L,0,34.166666666666664,6,10,0.6,3,5,0.6,1,2,0.5,1,3,4,4,0,0,3,4,16,10.8,-5.0,Jalen McDaniels,3,5,0.6
915,11/12/2022,24.78082191780822,L,0,27.633333333333333,3,6,0.5,1,2,0.5,2,2,1.0,0,4,4,4,0,0,1,2,9,8.2,-6.0,Jalen McDaniels,2,4,0.5
916,11/14/2022,24.786301369863015,W,0,25.966666666666665,4,7,0.571,0,1,0.0,2,2,1.0,1,3,4,0,1,2,1,2,10,8.9,-1.0,Jalen McDaniels,4,6,0.6666666666666666
917,11/16/2022,24.791780821917808,L,0,20.066666666666666,1,5,0.2,0,2,0.0,1,2,0.5,1,3,4,4,2,1,3,5,3,1.6,4.0,Jalen McDaniels,1,3,0.3333333333333333
918,11/18/2022,24.797260273972604,L,0,23.466666666666665,0,2,0.0,0,2,0.0,2,2,1.0,1,1,2,1,0,1,1,5,2,0.0,-14.0,Jalen McDaniels,0,0,
919,11/20/2022,24.802739726027397,L,0,21.1,3,10,0.3,2,5,0.4,0,0,,1,5,6,1,0,0,1,2,8,3.3,7.0,Jalen McDaniels,1,5,0.2
920,11/23/2022,24.81095890410959,W,0,21.116666666666667,4,8,0.5,1,4,0.25,2,3,0.667,1,2,3,1,1,0,0,1,11,9.2,2.0,Jalen McDaniels,3,4,0.75
921,11/25/2022,24.816438356164383,W,1,31.216666666666665,3,9,0.333,0,3,0.0,2,2,1.0,0,6,6,3,0,0,1,2,8,5.0,-6.0,Jalen McDaniels,3,6,0.5
922,10/19/2022,22.084931506849315,W,0,14.433333333333334,0,5,0.0,0,4,0.0,0,0,,0,2,2,1,0,0,0,1,0,-2.6,-2.0,James Bouknight,0,1,0.0
923,10/21/2022,22.09041095890411,L,0,13.15,0,5,0.0,0,3,0.0,0,0,,0,2,2,0,0,0,1,0,0,-3.9,-1.0,James Bouknight,0,2,0.0
924,10/23/2022,22.095890410958905,W,0,17.666666666666668,3,9,0.333,2,4,0.5,2,2,1.0,0,1,1,2,1,0,0,4,10,6.0,20.0,James Bouknight,1,5,0.2
925,10/26/2022,22.104109589041094,L,0,17.166666666666668,5,9,0.556,2,5,0.4,1,2,0.5,0,2,2,3,1,0,1,2,13,10.2,9.0,James Bouknight,3,4,0.75
926,10/28/2022,22.10958904109589,L,0,26.15,4,11,0.364,3,7,0.429,0,2,0.0,0,3,3,0,0,0,3,2,11,1.2,-7.0,James Bouknight,1,4,0.25
927,10/29/2022,22.112328767123287,W,0,14.733333333333333,0,5,0.0,0,4,0.0,0,0,,0,1,1,1,0,0,0,1,0,-2.9,-3.0,James Bouknight,0,1,0.0
928,10/31/2022,22.117808219178084,L,0,16.433333333333334,2,4,0.5,2,3,0.667,0,0,,0,2,2,1,0,0,2,2,6,2.5,12.0,James Bouknight,0,1,0.0
929,11/2/2022,22.123287671232877,L,0,20.783333333333335,2,7,0.286,1,5,0.2,2,2,1.0,0,3,3,0,0,1,0,1,7,4.1,-8.0,James Bouknight,1,2,0.5
930,11/4/2022,22.12876712328767,L,0,27.633333333333333,7,10,0.7,0,0,,0,0,,2,2,4,5,1,0,1,2,14,14.5,0.0,James Bouknight,7,10,0.7
931,11/5/2022,22.13150684931507,L,0,28.883333333333333,1,9,0.111,0,4,0.0,1,2,0.5,1,4,5,5,1,2,4,1,3,0.1,0.0,James Bouknight,1,5,0.2
932,11/7/2022,22.136986301369863,L,0,20.4,3,7,0.429,0,3,0.0,1,2,0.5,1,5,6,3,0,0,1,3,7,5.0,-5.0,James Bouknight,3,4,0.75
933,11/9/2022,22.14246575342466,L,0,17.083333333333332,2,5,0.4,1,3,0.333,2,2,1.0,0,0,0,0,2,0,1,2,7,4.5,-11.0,James Bouknight,1,2,0.5
934,11/10/2022,22.145205479452056,L,0,17.166666666666668,0,5,0.0,0,4,0.0,1,2,0.5,0,3,3,0,0,0,1,2,1,-3.8,-12.0,James Bouknight,0,1,0.0
935,11/12/2022,22.15068493150685,L,0,14.1,4,6,0.667,1,3,0.333,0,0,,0,0,0,0,0,1,0,1,9,6.7,-3.0,James Bouknight,3,3,1.0
936,11/14/2022,22.156164383561645,W,0,3.7333333333333334,0,1,0.0,0,0,,0,0,,0,0,0,0,0,0,0,0,0,-0.7,-1.0,James Bouknight,0,1,0.0
937,11/16/2022,22.161643835616438,L,0,6.333333333333333,1,3,0.333,0,1,0.0,0,0,,0,1,1,1,0,0,0,0,2,1.3,3.0,James Bouknight,1,2,0.5
938,11/18/2022,22.167123287671235,L,0,12.133333333333333,0,0,,0,0,,0,0,,0,2,2,1,0,0,1,3,0,-0.9,-5.0,James Bouknight,0,0,
939,11/25/2022,22.186301369863013,W,0,14.983333333333333,3,5,0.6,2,3,0.667,0,0,,0,2,2,2,1,0,2,1,8,6.3,6.0,James Bouknight,1,2,0.5
940,10/19/2022,21.353424657534248,W,0,4.333333333333333,0,0,,0,0,,2,2,1.0,0,1,1,1,0,0,1,0,2,2.0,-7.0,Théo Maledon,0,0,
941,10/23/2022,21.364383561643837,W,0,14.5,1,1,1.0,0,0,,2,3,0.667,0,0,0,4,1,0,0,1,4,6.7,8.0,Théo Maledon,1,1,1.0
942,10/26/2022,21.372602739726027,L,0,16.383333333333333,6,7,0.857,2,2,1.0,1,1,1.0,0,0,0,4,1,0,1,1,15,14.9,2.0,Théo Maledon,4,5,0.8
943,10/28/2022,21.378082191780823,L,0,20.583333333333332,3,5,0.6,2,3,0.667,0,0,,1,4,5,3,0,0,1,0,8,8.7,-6.0,Théo Maledon,1,2,0.5
944,10/29/2022,21.38082191780822,W,0,15.916666666666666,2,8,0.25,1,4,0.25,0,0,,0,0,0,2,0,0,1,0,5,0.6,-5.0,Théo Maledon,1,4,0.25
945,10/31/2022,21.386301369863013,L,0,11.366666666666667,1,3,0.333,0,2,0.0,0,0,,0,1,1,3,1,1,2,1,2,2.0,-6.0,Théo Maledon,1,1,1.0
946,11/2/2022,21.39178082191781,L,0,15.833333333333334,0,2,0.0,0,2,0.0,0,0,,0,1,1,3,1,1,3,1,0,-0.7,-18.0,Théo Maledon,0,0,
947,11/4/2022,21.397260273972602,L,0,19.333333333333332,3,5,0.6,1,2,0.5,0,0,,0,5,5,2,1,0,3,3,7,4.4,-3.0,Théo Maledon,2,3,0.6666666666666666
948,11/5/2022,21.4,L,0,11.033333333333333,1,3,0.333,0,1,0.0,0,0,,0,3,3,2,0,0,0,1,2,2.2,-8.0,Théo Maledon,1,2,0.5
949,11/7/2022,21.405479452054795,L,0,5.25,0,0,,0,0,,0,0,,0,1,1,1,0,0,0,0,0,1.0,4.0,Théo Maledon,0,0,
950,11/9/2022,21.410958904109588,L,0,11.433333333333334,0,2,0.0,0,1,0.0,0,0,,0,2,2,0,0,1,1,2,0,-1.9,-19.0,Théo Maledon,0,1,0.0
951,11/10/2022,21.413698630136988,L,0,7.616666666666667,0,1,0.0,0,1,0.0,0,0,,0,2,2,1,0,0,1,0,0,-0.4,-4.0,Théo Maledon,0,0,
952,11/12/2022,21.41917808219178,L,0,19.6,3,3,1.0,0,0,,2,2,1.0,0,6,6,2,0,0,0,2,8,9.5,6.0,Théo Maledon,3,3,1.0
953,11/14/2022,21.424657534246574,W,0,24.783333333333335,4,4,1.0,2,2,1.0,4,5,0.8,0,3,3,3,2,0,1,4,14,14.8,0.0,Théo Maledon,2,2,1.0
954,11/16/2022,21.43013698630137,L,0,21.616666666666667,2,4,0.5,1,2,0.5,2,2,1.0,0,3,3,1,2,1,0,2,7,8.5,-2.0,Théo Maledon,1,2,0.5
955,11/18/2022,21.435616438356163,L,0,13.483333333333333,0,5,0.0,0,2,0.0,0,0,,0,2,2,2,1,0,2,0,0,-2.5,-4.0,Théo Maledon,0,3,0.0
956,11/23/2022,21.44931506849315,W,0,16.05,2,6,0.333,0,1,0.0,0,0,,0,0,0,3,2,0,1,1,4,3.3,11.0,Théo Maledon,2,5,0.4
957,11/25/2022,21.454794520547946,W,0,25.55,4,7,0.571,1,1,1.0,5,6,0.833,2,5,7,3,1,0,1,1,14,14.9,2.0,Théo Maledon,3,6,0.5
958,10/19/2022,24.898630136986302,W,0,21.183333333333334,5,7,0.714,2,2,1.0,0,0,,0,2,2,4,2,2,1,2,12,14.1,28.0,Dennis Smith Jr.,3,5,0.6
959,10/21/2022,24.904109589041095,L,0,22.4,4,7,0.571,2,3,0.667,0,0,,0,2,2,4,2,0,1,1,10,10.7,2.0,Dennis Smith Jr.,2,4,0.5
960,10/23/2022,24.90958904109589,W,1,33.5,8,16,0.5,1,2,0.5,1,1,1.0,1,1,2,6,3,1,2,3,18,15.7,9.0,Dennis Smith Jr.,7,14,0.5
961,10/26/2022,24.91780821917808,L,1,36.61666666666667,7,16,0.438,0,3,0.0,0,2,0.0,0,3,3,11,2,0,1,5,14,12.4,-5.0,Dennis Smith Jr.,7,13,0.5384615384615384
962,10/28/2022,24.923287671232877,L,1,27.416666666666668,2,7,0.286,0,1,0.0,0,0,,1,3,4,4,1,0,2,2,4,2.5,-14.0,Dennis Smith Jr.,2,6,0.3333333333333333
963,10/29/2022,24.926027397260274,W,1,37.083333333333336,4,10,0.4,2,2,1.0,3,4,0.75,2,7,9,8,0,0,2,2,13,13.5,12.0,Dennis Smith Jr.,2,8,0.25
964,10/31/2022,24.931506849315067,L,1,36.63333333333333,7,13,0.538,1,5,0.2,0,0,,2,5,7,8,6,1,4,4,15,18.3,-1.0,Dennis Smith Jr.,6,8,0.75
965,11/2/2022,24.936986301369863,L,1,32.166666666666664,5,9,0.556,0,1,0.0,0,0,,0,5,5,6,2,0,1,0,10,12.4,0.0,Dennis Smith Jr.,5,8,0.625
966,11/4/2022,24.942465753424656,L,1,28.666666666666668,3,7,0.429,1,2,0.5,1,2,0.5,0,3,3,5,2,1,3,1,8,7.6,-28.0,Dennis Smith Jr.,2,5,0.4
967,11/5/2022,24.945205479452056,L,1,6.6,0,1,0.0,0,0,,0,0,,0,1,1,2,0,0,0,1,0,0.6,-3.0,Dennis Smith Jr.,0,1,0.0
968,11/7/2022,24.95068493150685,L,1,34.2,1,11,0.091,0,2,0.0,1,2,0.5,2,3,5,10,0,3,1,2,3,4.9,-5.0,Dennis Smith Jr.,1,9,0.1111111111111111
969,11/9/2022,24.956164383561642,L,1,32.78333333333333,6,12,0.5,1,2,0.5,0,0,,1,1,2,4,4,0,1,5,13,11.8,1.0,Dennis Smith Jr.,5,10,0.5
970,11/10/2022,24.958904109589042,L,1,33.55,6,9,0.667,0,3,0.0,0,0,,0,2,2,8,1,0,2,4,12,11.7,10.0,Dennis Smith Jr.,6,6,1.0
971,11/20/2022,24.986301369863014,L,0,24.883333333333333,3,6,0.5,0,2,0.0,0,0,,0,2,2,3,2,2,1,1,6,7.7,15.0,Dennis Smith Jr.,3,4,0.75
972,11/23/2022,24.994520547945207,W,0,11.266666666666667,1,3,0.333,0,0,,0,1,0.0,0,0,0,2,0,0,1,1,2,-0.1,-8.0,Dennis Smith Jr.,1,3,0.3333333333333333
973,10/19/2022,20.147945205479452,W,0,8.016666666666667,0,1,0.0,0,1,0.0,0,0,,0,1,1,0,0,1,0,0,0,0.3,6.0,JT Thor,0,0,
974,10/23/2022,20.15890410958904,W,0,16.233333333333334,2,4,0.5,1,3,0.333,0,0,,1,5,6,0,0,1,1,2,5,4.1,12.0,JT Thor,1,1,1.0
975,10/26/2022,20.167123287671235,L,0,8.95,1,2,0.5,0,1,0.0,0,0,,1,0,1,0,0,1,0,1,2,2.0,-6.0,JT Thor,1,1,1.0
976,10/28/2022,20.172602739726027,L,0,14.15,0,3,0.0,0,3,0.0,0,0,,0,2,2,1,0,0,1,1,0,-2.2,-13.0,JT Thor,0,0,
977,10/29/2022,20.175342465753424,W,0,8.75,0,0,,0,0,,3,3,1.0,0,3,3,0,0,0,0,0,3,3.9,8.0,JT Thor,0,0,
978,10/31/2022,20.18082191780822,L,0,5.35,0,0,,0,0,,0,0,,0,0,0,0,0,0,1,1,0,-1.4,-2.0,JT Thor,0,0,
979,11/2/2022,20.186301369863013,L,0,13.183333333333334,2,4,0.5,0,1,0.0,0,1,0.0,1,1,2,1,1,1,0,1,4,4.6,-10.0,JT Thor,2,3,0.6666666666666666
980,11/4/2022,20.19178082191781,L,0,26.0,4,12,0.333,2,5,0.4,1,2,0.5,2,3,5,2,1,1,2,0,11,7.2,0.0,JT Thor,2,7,0.2857142857142857
981,11/5/2022,20.194520547945206,L,0,16.483333333333334,1,4,0.25,1,3,0.333,0,0,,2,2,4,1,0,0,0,0,3,3.3,14.0,JT Thor,0,1,0.0
982,11/7/2022,20.2,L,0,10.0,1,2,0.5,0,1,0.0,1,1,1.0,0,2,2,2,0,0,1,1,3,2.6,12.0,JT Thor,1,1,1.0
983,11/9/2022,20.205479452054796,L,0,8.083333333333334,0,1,0.0,0,1,0.0,2,2,1.0,1,0,1,0,0,0,1,0,2,1.0,-9.0,JT Thor,0,0,
984,11/10/2022,20.208219178082192,L,0,2.6333333333333333,0,1,0.0,0,0,,0,0,,0,0,0,0,0,0,1,0,0,-1.7,-11.0,JT Thor,0,1,0.0
985,11/12/2022,20.213698630136985,L,0,5.383333333333334,1,4,0.25,0,1,0.0,0,0,,0,1,1,1,1,0,1,0,2,0.6,-2.0,JT Thor,1,3,0.3333333333333333
986,11/16/2022,20.224657534246575,L,0,2.9333333333333336,0,0,,0,0,,0,0,,0,1,1,0,0,0,0,1,0,-0.1,8.0,JT Thor,0,0,
987,10/19/2022,28.59178082191781,W,1,29.716666666666665,10,19,0.526,4,7,0.571,0,0,,0,6,6,6,0,1,4,1,24,17.0,18.0,Terry Rozier,6,12,0.5
988,10/21/2022,28.5972602739726,L,1,36.13333333333333,7,24,0.292,2,8,0.25,7,8,0.875,4,4,8,11,1,2,2,1,23,20.3,-5.0,Terry Rozier,5,16,0.3125
989,11/5/2022,28.638356164383563,L,1,36.35,9,24,0.375,6,14,0.429,1,1,1.0,1,6,7,3,0,0,4,1,25,12.0,6.0,Terry Rozier,3,10,0.3
990,11/7/2022,28.643835616438356,L,1,37.516666666666666,9,23,0.391,1,9,0.111,0,0,,1,2,3,5,0,0,2,1,19,8.9,-12.0,Terry Rozier,8,14,0.5714285714285714
991,11/9/2022,28.649315068493152,L,1,34.7,6,20,0.3,5,13,0.385,1,1,1.0,2,3,5,5,0,0,2,3,18,9.0,9.0,Terry Rozier,1,7,0.14285714285714285
992,11/10/2022,28.65205479452055,L,1,43.38333333333333,8,25,0.32,3,10,0.3,3,4,0.75,3,5,8,3,0,0,1,2,22,11.2,1.0,Terry Rozier,5,15,0.3333333333333333
993,11/12/2022,28.65753424657534,L,1,34.1,8,17,0.471,4,9,0.444,2,3,0.667,0,1,1,6,2,0,2,0,22,17.4,-19.0,Terry Rozier,4,8,0.5
994,11/14/2022,28.663013698630138,W,1,33.81666666666667,7,15,0.467,1,8,0.125,2,2,1.0,1,2,3,2,2,0,1,2,17,12.2,17.0,Terry Rozier,6,7,0.8571428571428571
995,11/16/2022,28.66849315068493,L,1,32.93333333333333,7,17,0.412,1,4,0.25,2,2,1.0,0,2,2,8,0,0,5,3,17,7.9,-22.0,Terry Rozier,6,13,0.46153846153846156
996,11/18/2022,28.673972602739727,L,1,48.766666666666666,11,32,0.344,5,16,0.313,1,1,1.0,3,2,5,5,1,0,3,4,28,12.6,-12.0,Terry Rozier,6,16,0.375
997,11/20/2022,28.67945205479452,L,1,37.6,3,14,0.214,0,6,0.0,2,3,0.667,3,4,7,5,1,0,2,3,8,3.6,-17.0,Terry Rozier,3,8,0.375
998,11/23/2022,28.687671232876713,W,1,40.35,9,18,0.5,1,3,0.333,3,5,0.6,0,2,2,6,1,0,2,2,22,15.2,13.0,Terry Rozier,8,15,0.5333333333333333
999,11/25/2022,28.693150684931506,W,1,37.95,9,23,0.391,1,6,0.167,3,4,0.75,1,3,4,8,0,0,6,2,22,9.5,-5.0,Terry Rozier,8,17,0.47058823529411764
1000,10/19/2022,32.57534246575342,W,1,28.9,6,11,0.545,1,4,0.25,7,7,1.0,0,5,5,2,1,0,5,3,20,12.4,7.0,Gordon Hayward,5,7,0.7142857142857143
1001,10/21/2022,32.58082191780822,L,1,37.18333333333333,12,19,0.632,1,2,0.5,1,2,0.5,1,1,2,7,2,0,2,2,26,22.2,-6.0,Gordon Hayward,11,17,0.6470588235294118
1002,10/23/2022,32.586301369863016,W,1,31.3,4,10,0.4,1,4,0.25,3,5,0.6,0,3,3,5,1,0,4,0,12,7.2,0.0,Gordon Hayward,3,6,0.5
1003,10/26/2022,32.59452054794521,L,1,39.166666666666664,8,18,0.444,1,3,0.333,4,6,0.667,2,7,9,4,0,1,5,0,21,12.8,-13.0,Gordon Hayward,7,15,0.4666666666666667
1004,10/28/2022,32.6,L,1,26.45,6,11,0.545,3,6,0.5,3,4,0.75,0,6,6,3,0,0,2,0,18,14.2,-18.0,Gordon Hayward,3,5,0.6
1005,10/29/2022,32.602739726027394,W,1,34.583333333333336,8,16,0.5,1,3,0.333,6,7,0.857,0,2,2,4,0,1,1,0,23,17.7,9.0,Gordon Hayward,7,13,0.5384615384615384
1006,10/31/2022,32.608219178082194,L,1,34.03333333333333,3,10,0.3,1,3,0.333,5,5,1.0,0,4,4,6,1,0,1,1,12,11.2,-9.0,Gordon Hayward,2,7,0.2857142857142857
1007,11/2/2022,32.61369863013699,L,1,16.2,3,11,0.273,1,3,0.333,0,1,0.0,1,2,3,2,1,0,2,0,7,1.8,-1.0,Gordon Hayward,2,8,0.25
1008,11/18/2022,32.657534246575345,L,1,42.35,5,14,0.357,2,4,0.5,1,2,0.5,2,4,6,7,1,1,0,2,13,13.2,-3.0,Gordon Hayward,3,10,0.3
1009,11/20/2022,32.66301369863014,L,1,36.733333333333334,7,16,0.438,3,6,0.5,3,4,0.75,1,4,5,5,0,0,2,2,20,13.8,-9.0,Gordon Hayward,4,10,0.4
1010,11/23/2022,32.67123287671233,W,1,28.566666666666666,3,10,0.3,1,4,0.25,0,0,,0,2,2,3,0,0,4,0,7,-0.1,-7.0,Gordon Hayward,2,6,0.3333333333333333
1011,10/19/2022,21.747945205479454,W,0,4.333333333333333,1,1,1.0,1,1,1.0,0,0,,0,0,0,0,0,0,0,0,3,2.7,-7.0,Kai Jones,0,0,
1012,10/23/2022,21.75890410958904,W,0,1.4333333333333333,0,0,,0,0,,0,0,,0,0,0,0,0,0,0,0,0,0.0,-1.0,Kai Jones,0,0,
1013,10/28/2022,21.77260273972603,L,0,5.516666666666667,1,1,1.0,0,0,,2,4,0.5,0,0,0,2,0,1,0,0,4,5.0,9.0,Kai Jones,1,1,1.0
1014,11/2/2022,21.786301369863015,L,0,5.583333333333333,1,3,0.333,0,2,0.0,0,0,,0,0,0,0,0,1,0,0,2,1.0,2.0,Kai Jones,1,1,1.0
1015,11/4/2022,21.791780821917808,L,0,7.383333333333334,0,1,0.0,0,0,,0,0,,0,1,1,0,1,3,0,2,0,1.9,9.0,Kai Jones,0,1,0.0
1016,11/12/2022,21.813698630136987,L,0,1.65,1,1,1.0,0,0,,0,0,,0,0,0,0,0,0,0,0,2,1.7,0.0,Kai Jones,1,1,1.0
1017,11/14/2022,21.81917808219178,W,0,1.9666666666666668,0,0,,0,0,,0,0,,0,0,0,0,0,1,0,0,0,0.7,1.0,Kai Jones,0,0,
1018,11/18/2022,21.83013698630137,L,0,7.05,1,2,0.5,0,1,0.0,0,0,,1,2,3,0,0,0,0,1,2,1.9,10.0,Kai Jones,1,1,1.0
1019,11/20/2022,21.835616438356166,L,0,8.033333333333333,2,4,0.5,0,0,,0,0,,0,1,1,0,1,0,1,0,4,2.3,7.0,Kai Jones,2,4,0.5
1020,11/23/2022,21.843835616438355,W,0,7.9,2,2,1.0,0,0,,0,0,,1,0,1,0,0,0,1,2,4,2.3,10.0,Kai Jones,2,2,1.0
1021,11/25/2022,21.84931506849315,W,0,27.966666666666665,3,5,0.6,0,0,,3,4,0.75,3,9,12,0,0,1,0,2,9,11.0,-1.0,Kai Jones,3,5,0.6
1022,10/19/2022,19.945205479452056,W,0,4.333333333333333,0,1,0.0,0,1,0.0,0,0,,0,0,0,0,0,1,0,0,0,0.0,-7.0,Bryce McGowens,0,0,
1023,10/23/2022,19.956164383561642,W,0,2.6333333333333333,1,1,1.0,0,0,,0,0,,0,0,0,0,0,0,0,0,2,1.7,-5.0,Bryce McGowens,1,1,1.0
1024,10/26/2022,19.964383561643835,L,0,0.6333333333333333,0,0,,0,0,,0,0,,0,0,0,0,0,0,0,0,0,0.0,-2.0,Bryce McGowens,0,0,
1025,10/28/2022,19.96986301369863,L,0,5.316666666666666,1,2,0.5,0,0,,0,0,,0,1,1,1,1,0,0,0,2,3.0,9.0,Bryce McGowens,1,2,0.5
1026,11/4/2022,19.98904109589041,L,0,16.866666666666667,3,5,0.6,1,2,0.5,5,5,1.0,0,1,1,0,1,0,1,1,12,9.6,9.0,Bryce McGowens,2,3,0.6666666666666666
1027,11/12/2022,21.224657534246575,L,1,28.2,6,17,0.353,1,9,0.111,2,2,1.0,0,6,6,6,1,0,2,5,15,8.5,-18.0,LaMelo Ball,5,8,0.625
1028,11/14/2022,21.23013698630137,W,1,33.666666666666664,6,19,0.316,4,15,0.267,1,1,1.0,0,4,4,9,0,1,5,2,17,8.5,-2.0,LaMelo Ball,2,4,0.5
1029,11/16/2022,21.235616438356164,L,1,36.516666666666666,10,17,0.588,5,8,0.625,1,2,0.5,0,1,1,6,2,0,4,1,26,19.8,-8.0,LaMelo Ball,5,9,0.5555555555555556
1030,10/19/2022,20.84109589041096,W,0,4.333333333333333,0,0,,0,0,,2,2,1.0,0,1,1,0,0,0,2,3,2,-0.9,-7.0,Mark Williams,0,0,
1031,10/23/2022,20.852054794520548,W,0,1.4333333333333333,1,2,0.5,0,0,,0,0,,2,1,3,0,0,0,0,0,2,2.7,-1.0,Mark Williams,1,2,0.5
1032,10/28/2022,20.865753424657534,L,0,7.1,3,5,0.6,0,0,,1,1,1.0,2,2,4,0,0,0,0,0,7,6.7,12.0,Mark Williams,3,5,0.6
1033,10/19/2022,27.057534246575344,W,0,0.9333333333333333,0,0,,0,0,,0,0,,0,0,0,0,0,0,0,0,0,0.0,-6.0,Cody Martin,0,0,
1034,10/18/2022,28.295890410958904,W,1,24.033333333333335,1,3,0.333,0,1,0.0,0,1,0.0,1,2,3,4,1,0,1,2,2,3.2,9.0,Derrick White,1,2,0.5
1035,10/21/2022,28.304109589041097,W,1,24.65,2,5,0.4,2,4,0.5,4,4,1.0,0,7,7,1,0,3,1,4,10,9.6,1.0,Derrick White,0,1,0.0
1036,10/22/2022,28.306849315068494,W,1,36.95,10,17,0.588,5,9,0.556,2,3,0.667,2,2,4,4,1,0,0,2,27,23.7,7.0,Derrick White,5,8,0.625
1037,10/24/2022,28.312328767123287,L,1,25.633333333333333,2,8,0.25,1,5,0.2,0,0,,0,1,1,4,0,0,1,4,5,0.7,5.0,Derrick White,1,3,0.3333333333333333
1038,10/28/2022,28.323287671232876,L,1,22.2,3,5,0.6,1,2,0.5,2,2,1.0,0,1,1,1,2,0,2,4,9,6.1,-1.0,Derrick White,2,3,0.6666666666666666
1039,10/30/2022,28.328767123287673,W,1,23.6,2,6,0.333,1,2,0.5,0,0,,1,4,5,2,0,0,0,3,5,3.7,15.0,Derrick White,1,4,0.25
1040,11/2/2022,28.336986301369862,L,1,32.166666666666664,1,4,0.25,1,3,0.333,0,0,,0,3,3,6,0,2,0,4,3,5.5,7.0,Derrick White,0,1,0.0
1041,11/4/2022,28.34246575342466,W,1,26.183333333333334,3,6,0.5,1,3,0.333,0,0,,0,3,3,2,1,2,0,4,7,7.1,-10.0,Derrick White,2,3,0.6666666666666666
1042,11/5/2022,28.345205479452055,W,1,22.283333333333335,3,5,0.6,1,2,0.5,0,0,,1,2,3,1,0,0,1,1,7,5.3,-5.0,Derrick White,2,3,0.6666666666666666
1043,11/7/2022,28.350684931506848,W,0,18.15,2,5,0.4,0,2,0.0,0,0,,1,1,2,1,1,1,0,2,4,3.9,-3.0,Derrick White,2,3,0.6666666666666666
1044,11/9/2022,28.356164383561644,W,0,19.65,2,4,0.5,2,2,1.0,2,2,1.0,1,7,8,4,0,1,1,2,8,10.5,4.0,Derrick White,0,2,0.0
1045,11/11/2022,28.361643835616437,W,0,24.2,3,9,0.333,2,6,0.333,2,2,1.0,1,0,1,4,0,1,0,1,10,8.7,6.0,Derrick White,1,3,0.3333333333333333
1046,11/12/2022,28.364383561643837,W,1,25.183333333333334,3,12,0.25,1,5,0.2,5,6,0.833,0,3,3,4,0,2,0,4,12,7.9,4.0,Derrick White,2,7,0.2857142857142857
1047,11/14/2022,28.36986301369863,W,0,33.38333333333333,5,9,0.556,2,4,0.5,4,4,1.0,0,1,1,5,4,0,1,3,16,17.3,21.0,Derrick White,3,5,0.6
1048,11/16/2022,28.375342465753423,W,1,31.2,6,11,0.545,2,4,0.5,2,2,1.0,1,4,5,10,0,1,2,0,16,18.3,17.0,Derrick White,4,7,0.5714285714285714
1049,11/18/2022,28.38082191780822,W,1,35.4,9,12,0.75,6,8,0.75,2,2,1.0,0,3,3,1,2,2,1,2,26,24.4,21.0,Derrick White,3,4,0.75
1050,11/21/2022,28.389041095890413,L,0,17.716666666666665,2,5,0.4,0,3,0.0,0,0,,0,2,2,2,0,0,1,3,4,1.1,1.0,Derrick White,2,2,1.0
1051,11/23/2022,28.394520547945206,W,1,28.666666666666668,4,9,0.444,3,6,0.5,1,1,1.0,0,2,2,1,0,0,2,3,12,5.4,-4.0,Derrick White,1,3,0.3333333333333333
1052,11/25/2022,28.4,W,1,25.516666666666666,6,11,0.545,3,7,0.429,1,2,0.5,0,3,3,2,3,0,0,2,16,14.8,-2.0,Derrick White,3,4,0.75
1053,11/27/2022,28.405479452054795,W,1,30.566666666666666,4,7,0.571,2,4,0.5,5,5,1.0,1,1,2,3,2,0,1,3,15,14.6,20.0,Derrick White,2,3,0.6666666666666666
1054,10/18/2022,24.86027397260274,W,0,3.3166666666666664,0,0,,0,0,,0,0,,0,0,0,0,0,0,0,1,0,-0.4,3.0,Sam Hauser,0,0,
1055,10/21/2022,24.86849315068493,W,0,12.916666666666666,2,3,0.667,2,3,0.667,0,0,,0,0,0,0,1,0,0,2,6,4.9,12.0,Sam Hauser,0,0,
1056,10/22/2022,24.87123287671233,W,0,6.766666666666667,3,4,0.75,3,4,0.75,0,0,,0,2,2,0,0,0,0,0,9,8.0,2.0,Sam Hauser,0,0,
1057,10/24/2022,24.876712328767123,L,0,11.116666666666667,1,4,0.25,1,4,0.25,1,2,0.5,1,1,2,1,0,0,0,0,4,2.9,-11.0,Sam Hauser,0,0,
1058,10/28/2022,24.887671232876713,L,0,11.716666666666667,2,3,0.667,1,2,0.5,0,0,,0,1,1,0,0,0,1,1,5,2.6,23.0,Sam Hauser,1,1,1.0
1059,10/30/2022,24.893150684931506,W,0,22.85,3,5,0.6,3,5,0.6,0,0,,0,5,5,2,1,1,0,1,9,10.9,11.0,Sam Hauser,0,0,
1060,11/2/2022,24.9013698630137,L,0,10.033333333333333,0,1,0.0,0,1,0.0,0,0,,0,0,0,0,0,0,0,3,0,-1.9,-9.0,Sam Hauser,0,0,
1061,11/4/2022,24.90684931506849,W,0,18.15,3,6,0.5,2,4,0.5,0,0,,2,2,4,0,0,0,0,0,8,7.0,19.0,Sam Hauser,1,2,0.5
1062,11/5/2022,24.90958904109589,W,0,21.1,6,9,0.667,5,8,0.625,0,0,,1,2,3,2,0,0,0,2,17,15.0,14.0,Sam Hauser,1,1,1.0
1063,11/7/2022,24.915068493150685,W,0,11.033333333333333,1,2,0.5,1,2,0.5,2,2,1.0,0,1,1,1,1,0,0,1,5,5.6,9.0,Sam Hauser,0,0,
1064,11/9/2022,24.92054794520548,W,0,31.85,9,15,0.6,6,12,0.5,0,0,,0,2,2,0,0,0,0,3,24,16.5,-1.0,Sam Hauser,3,3,1.0
1065,11/11/2022,24.926027397260274,W,0,20.15,2,7,0.286,1,6,0.167,0,0,,0,5,5,1,0,2,0,2,5,3.7,12.0,Sam Hauser,1,1,1.0
1066,11/12/2022,24.92876712328767,W,0,20.733333333333334,2,7,0.286,1,6,0.167,0,0,,0,1,1,1,0,0,0,2,5,1.1,-1.0,Sam Hauser,1,1,1.0
1067,11/14/2022,24.934246575342467,W,0,16.383333333333333,2,5,0.4,2,5,0.4,0,0,,0,1,1,0,1,1,1,0,6,4.3,3.0,Sam Hauser,0,0,
1068,11/16/2022,24.93972602739726,W,0,27.483333333333334,5,6,0.833,5,6,0.833,0,0,,0,6,6,0,0,0,0,2,15,13.8,35.0,Sam Hauser,0,0,
1069,11/18/2022,24.945205479452056,W,0,21.15,2,7,0.286,2,5,0.4,0,0,,2,2,4,2,0,0,1,2,6,3.5,-2.0,Sam Hauser,0,2,0.0
1070,11/21/2022,24.953424657534246,L,0,12.416666666666666,1,2,0.5,1,2,0.5,1,2,0.5,0,2,2,0,0,0,0,4,4,1.6,-2.0,Sam Hauser,0,0,
1071,11/23/2022,24.958904109589042,W,0,17.416666666666668,1,3,0.333,1,3,0.333,0,0,,0,3,3,1,0,0,0,3,3,1.7,4.0,Sam Hauser,0,0,
1072,11/25/2022,24.964383561643835,W,0,21.566666666666666,3,6,0.5,3,6,0.5,0,0,,1,2,3,1,0,0,0,1,9,7.6,21.0,Sam Hauser,0,0,
1073,11/27/2022,24.96986301369863,W,0,21.316666666666666,4,5,0.8,3,4,0.75,3,3,1.0,0,5,5,1,0,0,2,3,14,11.1,-4.0,Sam Hauser,1,1,1.0
1074,10/18/2022,24.627397260273973,W,1,38.63333333333333,13,20,0.65,2,7,0.286,7,9,0.778,0,12,12,4,1,1,3,1,35,30.1,10.0,Jayson Tatum,11,13,0.8461538461538461
1075,10/21/2022,24.635616438356166,W,1,36.78333333333333,10,22,0.455,2,7,0.286,7,7,1.0,2,3,5,4,1,2,2,1,29,22.7,-1.0,Jayson Tatum,8,15,0.5333333333333333
1076,10/22/2022,24.638356164383563,W,1,37.65,14,21,0.667,4,10,0.4,8,9,0.889,0,8,8,1,1,2,1,2,40,34.2,6.0,Jayson Tatum,10,11,0.9090909090909091
1077,10/24/2022,24.643835616438356,L,1,35.43333333333333,8,18,0.444,4,8,0.5,6,6,1.0,0,8,8,5,0,0,1,2,26,20.7,-8.0,Jayson Tatum,4,10,0.4
1078,10/28/2022,24.654794520547945,L,1,42.18333333333333,11,19,0.579,3,7,0.429,7,8,0.875,1,6,7,4,1,1,4,4,32,24.1,-10.0,Jayson Tatum,8,12,0.6666666666666666
1079,10/30/2022,24.660273972602738,W,1,27.416666666666668,8,15,0.533,5,10,0.5,2,2,1.0,0,4,4,3,1,0,4,0,23,16.0,10.0,Jayson Tatum,3,5,0.6
1080,11/2/2022,24.66849315068493,L,1,42.86666666666667,8,21,0.381,2,9,0.222,8,8,1.0,3,9,12,6,1,4,6,0,26,21.3,-16.0,Jayson Tatum,6,12,0.5
1081,11/4/2022,24.673972602739727,W,1,40.05,8,23,0.348,3,10,0.3,17,20,0.85,2,10,12,6,1,1,1,4,36,29.6,11.0,Jayson Tatum,5,13,0.38461538461538464
1082,11/5/2022,24.676712328767124,W,1,36.516666666666666,8,17,0.471,6,13,0.462,4,4,1.0,0,4,4,5,1,2,3,3,26,20.2,12.0,Jayson Tatum,2,4,0.5
1083,11/7/2022,24.682191780821917,W,1,39.583333333333336,12,25,0.48,3,11,0.273,12,16,0.75,0,3,3,2,0,2,2,2,39,25.6,15.0,Jayson Tatum,9,14,0.6428571428571429
1084,11/9/2022,24.687671232876713,W,1,31.583333333333332,10,20,0.5,5,11,0.455,6,7,0.857,0,1,1,5,1,1,1,4,31,23.5,16.0,Jayson Tatum,5,9,0.5555555555555556
1085,11/11/2022,24.693150684931506,W,1,37.31666666666667,11,21,0.524,2,7,0.286,10,11,0.909,0,8,8,5,0,0,1,4,34,26.6,18.0,Jayson Tatum,9,14,0.6428571428571429
1086,11/12/2022,24.695890410958903,W,1,40.983333333333334,14,28,0.5,7,14,0.5,8,10,0.8,2,8,10,3,1,1,3,2,43,32.0,7.0,Jayson Tatum,7,14,0.5
1087,11/14/2022,24.7013698630137,W,1,38.0,9,23,0.391,1,9,0.111,8,10,0.8,1,9,10,1,3,3,1,2,27,21.1,2.0,Jayson Tatum,8,14,0.5714285714285714
1088,11/16/2022,24.706849315068492,W,1,32.9,6,19,0.316,3,10,0.3,4,4,1.0,1,6,7,8,1,1,2,1,19,15.5,28.0,Jayson Tatum,3,9,0.3333333333333333
1089,11/18/2022,24.71232876712329,W,1,39.46666666666667,6,18,0.333,2,10,0.2,5,6,0.833,0,7,7,10,0,0,3,1,19,14.1,11.0,Jayson Tatum,4,8,0.5
1090,11/21/2022,24.720547945205478,L,1,35.766666666666666,9,19,0.474,4,10,0.4,6,7,0.857,2,9,11,7,0,0,4,1,28,22.5,-13.0,Jayson Tatum,5,9,0.5555555555555556
1091,11/23/2022,24.726027397260275,W,1,36.81666666666667,11,24,0.458,2,7,0.286,13,15,0.867,3,10,13,5,0,2,2,1,37,31.4,14.0,Jayson Tatum,9,17,0.5294117647058824
1092,11/25/2022,24.731506849315068,W,1,31.15,10,17,0.588,2,6,0.333,8,9,0.889,1,7,8,4,1,0,3,4,30,23.7,12.0,Jayson Tatum,8,11,0.7272727272727273
1093,10/18/2022,25.983561643835618,W,1,38.56666666666667,14,24,0.583,4,12,0.333,3,3,1.0,0,3,3,2,2,1,4,1,35,24.4,7.0,Jaylen Brown,10,12,0.8333333333333334
1094,10/21/2022,25.991780821917807,W,1,34.016666666666666,12,18,0.667,2,3,0.667,2,2,1.0,1,3,4,3,2,2,3,5,28,22.3,-4.0,Jaylen Brown,10,15,0.6666666666666666
1095,10/22/2022,25.994520547945207,W,1,37.5,4,16,0.25,1,6,0.167,3,4,0.75,1,8,9,4,1,1,2,1,12,7.2,14.0,Jaylen Brown,3,10,0.3
1096,10/24/2022,26.0,L,1,35.38333333333333,8,23,0.348,2,7,0.286,3,4,0.75,3,3,6,2,0,2,1,4,21,10.9,-10.0,Jaylen Brown,6,16,0.375
1097,10/28/2022,26.01095890410959,L,1,42.8,11,22,0.5,2,7,0.286,8,12,0.667,0,8,8,4,2,0,6,3,32,19.4,-21.0,Jaylen Brown,9,15,0.6
1098,10/30/2022,26.016438356164382,W,1,29.966666666666665,7,18,0.389,4,9,0.444,6,6,1.0,0,10,10,2,0,0,2,1,24,16.2,13.0,Jaylen Brown,3,9,0.3333333333333333
1099,11/2/2022,26.024657534246575,L,1,44.6,10,26,0.385,3,10,0.3,7,7,1.0,2,6,8,4,1,0,3,5,30,17.8,7.0,Jaylen Brown,7,16,0.4375
1100,11/4/2022,26.03013698630137,W,1,33.833333333333336,6,14,0.429,0,3,0.0,4,5,0.8,1,4,5,2,0,0,3,2,16,7.7,-13.0,Jaylen Brown,6,11,0.5454545454545454
1101,11/5/2022,26.03287671232877,W,1,37.31666666666667,10,19,0.526,6,11,0.545,4,4,1.0,2,3,5,3,0,0,1,5,30,22.1,-5.0,Jaylen Brown,4,8,0.5
1102,11/7/2022,26.03835616438356,W,1,38.266666666666666,8,20,0.4,1,6,0.167,4,5,0.8,0,9,9,2,1,0,7,4,21,6.3,-6.0,Jaylen Brown,7,14,0.5
1103,11/9/2022,26.043835616438358,W,1,30.016666666666666,11,19,0.579,2,6,0.333,6,7,0.857,2,5,7,3,1,0,0,0,30,26.7,25.0,Jaylen Brown,9,13,0.6923076923076923
1104,11/11/2022,26.04931506849315,W,1,34.78333333333333,11,15,0.733,3,4,0.75,0,0,,0,8,8,8,0,0,3,3,25,22.7,8.0,Jaylen Brown,8,11,0.7272727272727273
1105,11/14/2022,26.057534246575344,W,1,41.06666666666667,11,21,0.524,0,5,0.0,4,6,0.667,0,6,6,6,2,0,5,4,26,16.3,6.0,Jaylen Brown,11,16,0.6875
1106,11/16/2022,26.063013698630137,W,1,23.183333333333334,10,17,0.588,1,6,0.167,1,2,0.5,0,5,5,0,2,0,3,4,22,12.6,10.0,Jaylen Brown,9,11,0.8181818181818182
1107,11/18/2022,26.068493150684933,W,1,36.81666666666667,10,20,0.5,3,6,0.5,4,5,0.8,3,7,10,7,2,0,7,2,27,19.9,5.0,Jaylen Brown,7,14,0.5
1108,11/21/2022,26.076712328767123,L,1,38.05,9,20,0.45,4,10,0.4,3,5,0.6,0,7,7,2,0,0,5,1,25,11.9,-8.0,Jaylen Brown,5,10,0.5
1109,11/23/2022,26.08219178082192,W,1,35.68333333333333,13,18,0.722,2,3,0.667,3,4,0.75,0,4,4,4,2,0,2,2,31,26.4,14.0,Jaylen Brown,11,15,0.7333333333333333
1110,11/25/2022,26.087671232876712,W,1,26.683333333333334,9,16,0.563,1,4,0.25,6,6,1.0,0,5,5,4,2,0,1,4,25,21.1,5.0,Jaylen Brown,8,12,0.6666666666666666
1111,11/27/2022,26.09315068493151,W,1,34.21666666666667,13,23,0.565,2,7,0.286,8,8,1.0,2,3,5,2,0,0,2,3,36,25.6,26.0,Jaylen Brown,11,16,0.6875
1112,10/18/2022,23.882191780821916,W,0,23.95,5,5,1.0,3,3,1.0,2,3,0.667,0,1,1,1,0,0,0,3,15,12.9,-3.0,Grant Williams,2,2,1.0
1113,10/21/2022,23.89041095890411,W,0,25.4,4,6,0.667,2,4,0.5,0,0,,1,6,7,2,0,2,1,1,10,11.3,15.0,Grant Williams,2,2,1.0
1114,10/22/2022,23.893150684931506,W,0,31.05,3,3,1.0,3,3,1.0,4,4,1.0,0,6,6,2,0,2,0,5,13,14.7,7.0,Grant Williams,0,0,
1115,10/24/2022,23.898630136986302,L,0,18.283333333333335,0,3,0.0,0,2,0.0,0,0,,1,2,3,1,1,0,1,3,0,-1.3,-26.0,Grant Williams,0,1,0.0
1116,10/30/2022,23.915068493150685,W,0,24.75,4,6,0.667,2,3,0.667,0,0,,0,3,3,3,0,1,0,1,10,10.7,8.0,Grant Williams,2,3,0.6666666666666666
1117,11/2/2022,23.923287671232877,L,0,31.616666666666667,3,7,0.429,2,6,0.333,3,4,0.75,2,5,7,0,2,1,0,5,11,10.5,4.0,Grant Williams,1,1,1.0
1118,11/4/2022,23.92876712328767,W,0,20.533333333333335,2,3,0.667,0,1,0.0,0,0,,0,4,4,3,0,0,2,2,4,3.2,15.0,Grant Williams,2,2,1.0
1119,11/5/2022,23.931506849315067,W,0,27.533333333333335,4,7,0.571,2,4,0.5,2,2,1.0,1,3,4,1,2,0,2,0,12,11.0,10.0,Grant Williams,2,3,0.6666666666666666
1120,11/7/2022,23.936986301369863,W,1,37.583333333333336,0,0,,0,0,,2,2,1.0,2,3,5,1,1,1,2,3,2,3.5,6.0,Grant Williams,0,0,
1121,11/9/2022,23.942465753424656,W,1,20.45,2,4,0.5,1,3,0.333,0,0,,0,4,4,1,0,0,0,5,5,2.9,15.0,Grant Williams,1,1,1.0
1122,11/11/2022,23.947945205479453,W,1,32.266666666666666,5,8,0.625,2,5,0.4,1,3,0.333,1,3,4,4,1,1,0,3,13,13.5,0.0,Grant Williams,3,3,1.0
1123,11/12/2022,23.95068493150685,W,1,44.9,7,12,0.583,3,6,0.5,2,2,1.0,1,9,10,4,0,0,1,2,19,17.8,8.0,Grant Williams,4,6,0.6666666666666666
1124,11/14/2022,23.956164383561642,W,1,28.516666666666666,2,6,0.333,1,3,0.333,2,2,1.0,1,6,7,0,2,0,0,1,7,7.7,-4.0,Grant Williams,1,3,0.3333333333333333
1125,11/16/2022,23.96164383561644,W,1,27.833333333333332,6,10,0.6,4,7,0.571,2,2,1.0,0,1,1,1,0,0,2,4,18,10.8,7.0,Grant Williams,2,3,0.6666666666666666
1126,11/18/2022,23.96712328767123,W,1,34.95,5,10,0.5,2,6,0.333,0,0,,1,4,5,1,0,0,2,3,12,6.4,6.0,Grant Williams,3,4,0.75
1127,11/21/2022,23.975342465753425,L,1,34.81666666666667,5,9,0.556,3,7,0.429,0,0,,1,6,7,1,0,0,1,2,13,10.1,-10.0,Grant Williams,2,2,1.0
1128,11/23/2022,23.980821917808218,W,0,26.033333333333335,1,5,0.2,0,3,0.0,0,0,,0,3,3,3,1,0,0,4,2,1.3,-3.0,Grant Williams,1,2,0.5
1129,11/25/2022,23.986301369863014,W,0,18.45,0,3,0.0,0,1,0.0,2,2,1.0,1,0,1,2,0,1,0,2,2,1.9,-2.0,Grant Williams,0,2,0.0
1130,11/27/2022,23.991780821917807,W,1,31.583333333333332,2,7,0.286,1,4,0.25,0,0,,2,5,7,3,0,0,1,5,5,2.9,6.0,Grant Williams,1,3,0.3333333333333333
1131,10/18/2022,28.61917808219178,W,1,36.083333333333336,3,8,0.375,1,4,0.25,7,8,0.875,1,2,3,7,1,0,1,3,14,14.2,0.0,Marcus Smart,2,4,0.5
1132,10/21/2022,28.627397260273973,W,1,33.38333333333333,4,9,0.444,0,4,0.0,0,0,,1,4,5,3,0,0,5,2,8,1.5,-2.0,Marcus Smart,4,5,0.8
1133,10/22/2022,28.63013698630137,W,1,36.516666666666666,2,11,0.182,1,9,0.111,1,1,1.0,0,2,2,8,1,0,2,3,6,3.1,0.0,Marcus Smart,1,2,0.5
1134,10/24/2022,28.635616438356166,L,1,32.61666666666667,4,6,0.667,3,5,0.6,0,0,,0,1,1,6,2,2,1,3,11,14.1,-11.0,Marcus Smart,1,1,1.0
1135,10/28/2022,28.646575342465752,L,1,37.833333333333336,3,15,0.2,2,9,0.222,3,4,0.75,0,5,5,7,2,0,2,4,11,6.1,-26.0,Marcus Smart,1,6,0.16666666666666666
1136,10/30/2022,28.65205479452055,W,1,29.016666666666666,2,6,0.333,1,5,0.2,2,2,1.0,0,3,3,6,2,0,0,2,7,9.9,11.0,Marcus Smart,1,1,1.0
1137,11/2/2022,28.660273972602738,L,1,36.78333333333333,5,12,0.417,1,5,0.2,5,5,1.0,0,6,6,5,0,0,1,3,16,12.7,-3.0,Marcus Smart,4,7,0.5714285714285714
1138,11/4/2022,28.665753424657535,W,1,24.516666666666666,5,10,0.5,2,4,0.5,0,0,,0,1,1,1,1,0,2,5,12,5.0,-10.0,Marcus Smart,3,6,0.5
1139,11/5/2022,28.66849315068493,W,1,35.63333333333333,5,9,0.556,3,5,0.6,0,0,,0,2,2,11,0,0,1,2,13,15.2,3.0,Marcus Smart,2,4,0.5
1140,11/7/2022,28.673972602739727,W,1,35.733333333333334,6,11,0.545,2,6,0.333,1,3,0.333,0,7,7,12,0,0,2,4,15,15.8,4.0,Marcus Smart,4,5,0.8
1141,11/9/2022,28.67945205479452,W,1,23.383333333333333,1,6,0.167,0,4,0.0,0,0,,0,3,3,11,2,0,1,2,2,7.0,22.0,Marcus Smart,1,2,0.5
1142,11/11/2022,28.684931506849313,W,1,23.8,2,4,0.5,0,0,,0,0,,0,0,0,4,0,0,1,5,4,1.8,28.0,Marcus Smart,2,4,0.5
1143,11/12/2022,28.687671232876713,W,1,43.016666666666666,7,17,0.412,4,10,0.4,0,0,,1,1,2,10,5,1,1,1,18,21.2,4.0,Marcus Smart,3,7,0.42857142857142855
1144,11/14/2022,28.693150684931506,W,1,29.316666666666666,8,12,0.667,1,2,0.5,5,6,0.833,1,4,5,8,0,1,3,5,22,19.6,-11.0,Marcus Smart,7,10,0.7
1145,11/21/2022,28.71232876712329,L,1,34.96666666666667,3,9,0.333,2,5,0.4,0,0,,0,1,1,8,1,1,3,3,8,6.3,-15.0,Marcus Smart,1,4,0.25
1146,11/23/2022,28.71780821917808,W,1,33.55,5,9,0.556,3,4,0.75,0,0,,1,1,2,9,1,1,3,4,13,13.1,21.0,Marcus Smart,2,5,0.4
1147,11/25/2022,28.723287671232878,W,1,29.316666666666666,0,4,0.0,0,3,0.0,4,4,1.0,0,4,4,5,0,0,4,5,4,-0.1,12.0,Marcus Smart,0,1,0.0
1148,11/27/2022,28.72876712328767,W,1,27.333333333333332,5,8,0.625,2,4,0.5,2,2,1.0,0,4,4,7,0,0,4,3,14,11.3,15.0,Marcus Smart,3,4,0.75
1149,10/18/2022,36.37534246575343,W,1,23.1,2,7,0.286,2,5,0.4,0,0,,1,4,5,1,0,0,0,4,6,2.9,8.0,Al Horford,0,2,0.0
1150,10/21/2022,36.38356164383562,W,1,33.5,3,5,0.6,3,5,0.6,0,0,,1,4,5,1,0,0,3,2,9,5.5,-3.0,Al Horford,0,0,
1151,10/24/2022,36.391780821917806,L,1,25.433333333333334,3,7,0.429,2,6,0.333,0,0,,1,4,5,2,0,1,0,1,8,7.9,-1.0,Al Horford,1,1,1.0
1152,10/28/2022,36.4027397260274,L,1,41.416666666666664,5,7,0.714,2,4,0.5,0,0,,1,1,2,4,0,1,1,3,12,11.4,-20.0,Al Horford,3,3,1.0
1153,10/30/2022,36.40821917808219,W,1,23.533333333333335,2,7,0.286,1,5,0.2,0,0,,2,6,8,1,0,1,1,2,5,3.7,9.0,Al Horford,1,2,0.5
1154,11/2/2022,36.416438356164385,L,1,39.983333333333334,5,11,0.455,1,4,0.25,1,1,1.0,1,11,12,1,1,1,1,2,12,10.9,11.0,Al Horford,4,7,0.5714285714285714
1155,11/4/2022,36.42191780821918,W,1,33.4,4,8,0.5,1,5,0.2,2,3,0.667,1,4,5,5,0,1,1,3,11,10.5,-13.0,Al Horford,3,3,1.0
1156,11/7/2022,36.43013698630137,W,1,32.46666666666667,6,7,0.857,3,3,1.0,0,0,,0,6,6,2,1,2,0,1,15,17.7,-7.0,Al Horford,3,4,0.75
1157,11/9/2022,36.43561643835616,W,1,26.383333333333333,6,6,1.0,1,1,1.0,0,1,0.0,1,5,6,2,1,0,0,3,13,14.2,17.0,Al Horford,5,5,1.0
1158,11/11/2022,36.441095890410956,W,1,34.43333333333333,7,12,0.583,6,8,0.75,1,2,0.5,0,7,7,2,1,0,0,0,21,19.5,11.0,Al Horford,1,4,0.25
1159,11/14/2022,36.44931506849315,W,1,32.38333333333333,5,12,0.417,1,5,0.2,1,1,1.0,4,7,11,4,1,1,1,2,12,13.2,-1.0,Al Horford,4,7,0.5714285714285714
1160,11/16/2022,36.45479452054794,W,1,27.316666666666666,3,6,0.5,1,3,0.333,0,0,,3,8,11,4,0,1,2,4,7,8.4,23.0,Al Horford,2,3,0.6666666666666666
1161,11/18/2022,36.46027397260274,W,1,34.233333333333334,7,8,0.875,4,5,0.8,0,0,,3,4,7,2,0,0,2,1,18,17.5,17.0,Al Horford,3,3,1.0
1162,11/21/2022,36.46849315068493,L,1,34.766666666666666,0,9,0.0,0,7,0.0,0,0,,1,4,5,2,2,2,1,1,0,-1.0,-11.0,Al Horford,0,2,0.0
1163,11/23/2022,36.47397260273973,W,1,35.0,5,5,1.0,4,4,1.0,0,0,,0,5,5,4,0,1,0,2,14,16.7,17.0,Al Horford,1,1,1.0
1164,11/25/2022,36.47945205479452,W,1,27.783333333333335,5,8,0.625,3,3,1.0,0,0,,0,4,4,5,0,2,0,1,13,15.1,0.0,Al Horford,2,5,0.4
1165,11/27/2022,36.484931506849314,W,1,25.716666666666665,6,8,0.75,2,3,0.667,0,0,,0,3,3,3,0,3,0,1,14,15.5,17.0,Al Horford,4,5,0.8
1166,10/18/2022,29.852054794520548,W,0,23.866666666666667,7,11,0.636,0,2,0.0,2,2,1.0,1,1,2,4,2,0,1,2,16,15.1,9.0,Malcolm Brogdon,7,9,0.7777777777777778
1167,10/21/2022,29.86027397260274,W,0,24.85,2,9,0.222,1,3,0.333,2,2,1.0,3,2,5,3,0,0,2,2,7,3.5,7.0,Malcolm Brogdon,1,6,0.16666666666666666
1168,10/22/2022,29.863013698630137,W,0,20.666666666666668,4,10,0.4,1,4,0.25,4,5,0.8,1,1,2,4,0,0,2,1,13,8.6,-2.0,Malcolm Brogdon,3,6,0.5
1169,10/24/2022,29.86849315068493,L,0,22.166666666666668,5,13,0.385,2,6,0.333,0,0,,1,5,6,2,1,0,3,2,12,5.7,-24.0,Malcolm Brogdon,3,7,0.42857142857142855
1170,10/28/2022,29.87945205479452,L,0,22.266666666666666,3,5,0.6,1,1,1.0,2,2,1.0,0,2,2,5,1,0,1,3,9,9.6,-1.0,Malcolm Brogdon,2,4,0.5
1171,10/30/2022,29.884931506849316,W,0,23.316666666666666,6,12,0.5,3,5,0.6,8,8,1.0,0,2,2,4,0,0,0,0,23,20.4,9.0,Malcolm Brogdon,3,7,0.42857142857142855
1172,11/2/2022,29.893150684931506,L,0,24.416666666666668,6,11,0.545,1,3,0.333,2,2,1.0,0,4,4,3,0,0,3,1,15,9.6,2.0,Malcolm Brogdon,5,8,0.625
1173,11/4/2022,29.898630136986302,W,0,28.833333333333332,9,10,0.9,0,0,,7,9,0.778,0,2,2,4,0,1,4,2,25,20.1,4.0,Malcolm Brogdon,9,10,0.9
1174,11/5/2022,29.9013698630137,W,0,28.316666666666666,5,14,0.357,2,5,0.4,2,2,1.0,0,5,5,5,2,0,1,1,14,11.8,20.0,Malcolm Brogdon,3,9,0.3333333333333333
1175,11/7/2022,29.90684931506849,W,0,19.466666666666665,3,12,0.25,2,7,0.286,0,0,,3,7,10,4,0,0,1,0,8,6.8,6.0,Malcolm Brogdon,1,5,0.2
1176,11/9/2022,29.912328767123288,W,0,14.383333333333333,3,4,0.75,1,2,0.5,2,4,0.5,1,1,2,1,0,1,4,0,9,5.0,1.0,Malcolm Brogdon,2,2,1.0
1177,11/18/2022,29.936986301369863,W,0,18.25,1,8,0.125,1,5,0.2,2,2,1.0,1,3,4,4,1,0,1,1,5,3.8,2.0,Malcolm Brogdon,0,3,0.0
1178,11/21/2022,29.945205479452056,L,0,25.15,8,13,0.615,5,6,0.833,2,3,0.667,0,1,1,6,0,1,0,1,23,21.5,-5.0,Malcolm Brogdon,3,7,0.42857142857142855
1179,11/23/2022,29.95068493150685,W,0,23.6,5,10,0.5,2,4,0.5,1,1,1.0,2,4,6,2,0,0,2,3,13,8.8,7.0,Malcolm Brogdon,3,6,0.5
1180,11/25/2022,29.956164383561642,W,0,20.816666666666666,3,9,0.333,2,3,0.667,0,0,,1,2,3,4,2,1,1,2,8,7.9,21.0,Malcolm Brogdon,1,6,0.16666666666666666
1181,11/27/2022,29.96164383561644,W,0,22.633333333333333,5,10,0.5,3,5,0.6,4,4,1.0,1,5,6,4,0,0,3,1,17,13.6,8.0,Malcolm Brogdon,2,5,0.4
1182,10/22/2022,27.27123287671233,W,0,5.85,0,0,,0,0,,1,2,0.5,1,0,1,0,0,0,1,1,1,-0.1,-3.0,Luke Kornet,0,0,
1183,10/24/2022,27.276712328767122,L,0,5.45,1,3,0.333,0,1,0.0,0,0,,1,2,3,0,0,0,0,0,2,1.6,3.0,Luke Kornet,1,2,0.5
1184,10/28/2022,27.28767123287671,L,0,25.566666666666666,2,3,0.667,0,0,,0,0,,2,3,5,3,0,0,0,1,4,6.7,7.0,Luke Kornet,2,3,0.6666666666666666
1185,10/30/2022,27.293150684931508,W,0,19.25,1,1,1.0,1,1,1.0,0,0,,1,3,4,3,0,2,3,3,3,3.6,13.0,Luke Kornet,0,0,
1186,11/2/2022,27.301369863013697,L,0,2.5,0,0,,0,0,,0,0,,0,0,0,1,0,1,0,1,0,1.0,-8.0,Luke Kornet,0,0,
1187,11/4/2022,27.306849315068494,W,0,14.5,1,3,0.333,0,1,0.0,2,2,1.0,1,2,3,1,2,2,0,1,4,7.3,17.0,Luke Kornet,1,2,0.5
1188,11/9/2022,27.32054794520548,W,0,17.816666666666666,1,2,0.5,0,0,,0,0,,3,2,5,2,0,1,2,3,2,2.6,-6.0,Luke Kornet,1,2,0.5
1189,11/11/2022,27.326027397260273,W,0,12.883333333333333,4,8,0.5,0,0,,0,0,,4,3,7,1,0,1,0,1,8,8.7,10.0,Luke Kornet,4,8,0.5
1190,11/12/2022,27.328767123287673,W,0,9.233333333333333,1,1,1.0,0,0,,4,4,1.0,0,1,1,1,0,0,0,2,6,5.9,-5.0,Luke Kornet,1,1,1.0
1191,11/14/2022,27.334246575342465,W,0,5.383333333333334,0,0,,0,0,,0,0,,0,1,1,0,0,1,0,1,0,0.6,7.0,Luke Kornet,0,0,
1192,11/16/2022,27.339726027397262,W,0,25.383333333333333,7,7,1.0,1,1,1.0,0,0,,1,7,8,1,0,4,1,2,15,17.4,7.0,Luke Kornet,6,6,1.0
1193,11/18/2022,27.345205479452055,W,0,14.95,1,1,1.0,0,0,,2,2,1.0,1,5,6,1,0,1,0,1,4,6.9,-10.0,Luke Kornet,1,1,1.0
1194,11/21/2022,27.353424657534248,L,0,6.35,1,1,1.0,0,0,,0,0,,1,1,2,0,0,0,0,2,2,1.9,-7.0,Luke Kornet,1,1,1.0
1195,11/25/2022,27.364383561643837,W,0,12.783333333333333,2,2,1.0,0,0,,0,0,,0,5,5,0,0,2,0,3,4,5.1,19.0,Luke Kornet,2,2,1.0
1196,11/27/2022,27.36986301369863,W,0,22.283333333333335,4,8,0.5,0,1,0.0,4,4,1.0,4,0,4,1,0,2,1,4,12,10.3,-8.0,Luke Kornet,4,7,0.5714285714285714
1197,10/18/2022,27.15068493150685,W,0,20.166666666666668,1,2,0.5,0,0,,0,0,,0,2,2,0,1,1,0,4,2,1.7,7.0,Noah Vonleh,1,2,0.5
1198,10/21/2022,27.15890410958904,W,0,14.5,2,2,1.0,0,0,,0,0,,3,2,5,0,0,2,2,4,4,3.9,10.0,Noah Vonleh,2,2,1.0
1199,10/22/2022,27.161643835616438,W,1,13.816666666666666,1,2,0.5,0,0,,0,0,,2,1,3,0,0,1,0,4,2,1.8,5.0,Noah Vonleh,1,2,0.5
1200,10/24/2022,27.167123287671235,L,0,12.133333333333333,1,4,0.25,0,0,,0,0,,3,2,5,0,1,2,2,5,2,0.7,-16.0,Noah Vonleh,1,4,0.25
1201,10/28/2022,27.17808219178082,L,0,7.316666666666666,1,2,0.5,0,0,,0,0,,1,0,1,0,0,0,0,0,2,1.7,5.0,Noah Vonleh,1,2,0.5
1202,10/30/2022,27.183561643835617,W,0,5.216666666666667,1,1,1.0,0,0,,0,0,,0,3,3,1,0,0,1,0,2,2.3,-4.0,Noah Vonleh,1,1,1.0
1203,11/5/2022,27.2,W,0,16.2,3,4,0.75,1,1,1.0,0,0,,3,4,7,0,0,0,1,2,7,6.9,20.0,Noah Vonleh,2,3,0.6666666666666666
1204,11/7/2022,27.205479452054796,W,0,7.683333333333334,0,0,,0,0,,0,0,,1,1,2,1,0,0,1,2,0,-0.1,-9.0,Noah Vonleh,0,0,
1205,11/9/2022,27.21095890410959,W,0,6.116666666666666,0,0,,0,0,,0,0,,0,1,1,0,0,0,1,1,0,-1.1,-4.0,Noah Vonleh,0,0,
1206,11/11/2022,27.216438356164385,W,0,2.4,0,0,,0,0,,0,0,,0,0,0,0,0,0,0,0,0,0.0,1.0,Noah Vonleh,0,0,
1207,11/12/2022,27.21917808219178,W,0,19.916666666666668,0,2,0.0,0,1,0.0,2,2,1.0,3,4,7,2,0,0,0,3,2,4.1,11.0,Noah Vonleh,0,1,0.0
1208,11/14/2022,27.224657534246575,W,0,1.5166666666666666,0,0,,0,0,,0,0,,0,0,0,0,0,0,1,2,0,-1.8,-7.0,Noah Vonleh,0,0,
1209,11/25/2022,27.254794520547946,W,0,3.75,0,0,,0,0,,0,0,,0,0,0,0,0,0,1,0,0,-1.0,-7.0,Noah Vonleh,0,0,
1210,11/27/2022,27.26027397260274,W,0,2.066666666666667,0,0,,0,0,,0,0,,0,1,1,0,0,0,0,0,0,0.3,-8.0,Noah Vonleh,0,0,
1211,10/22/2022,24.731506849315068,W,0,3.6833333333333336,1,2,0.5,1,1,1.0,0,0,,0,0,0,0,0,0,0,1,3,1.6,-2.0,Payton Pritchard,0,1,0.0
1212,10/24/2022,24.736986301369864,L,0,5.45,1,4,0.25,1,2,0.5,0,0,,0,1,1,2,0,0,0,0,3,2.3,3.0,Payton Pritchard,0,2,0.0
1213,10/30/2022,24.753424657534246,W,0,7.4,0,1,0.0,0,1,0.0,1,2,0.5,0,0,0,2,0,0,2,1,1,-1.1,1.0,Payton Pritchard,0,0,
1214,11/9/2022,24.78082191780822,W,0,12.766666666666667,2,6,0.333,0,3,0.0,0,0,,0,3,3,1,0,0,2,1,4,-0.2,-1.0,Payton Pritchard,2,3,0.6666666666666666
1215,11/11/2022,24.786301369863015,W,0,15.733333333333333,5,6,0.833,0,1,0.0,1,2,0.5,4,1,5,0,1,0,2,0,11,10.5,0.0,Payton Pritchard,5,5,1.0
1216,11/12/2022,24.78904109589041,W,0,14.983333333333333,2,6,0.333,1,3,0.333,0,0,,1,1,2,2,0,0,2,0,5,2.0,16.0,Payton Pritchard,1,3,0.3333333333333333
1217,11/14/2022,24.794520547945204,W,0,14.05,4,8,0.5,2,4,0.5,0,0,,3,1,4,1,2,0,1,0,10,10.1,4.0,Payton Pritchard,2,4,0.5
1218,11/16/2022,24.8,W,0,24.2,5,8,0.625,4,6,0.667,0,0,,0,3,3,4,1,0,1,2,14,13.3,5.0,Payton Pritchard,1,2,0.5
1219,11/18/2022,24.805479452054794,W,0,4.783333333333333,0,1,0.0,0,1,0.0,0,0,,0,0,0,0,1,0,0,0,0,0.3,-10.0,Payton Pritchard,0,0,
1220,11/23/2022,24.81917808219178,W,0,1.6333333333333333,0,1,0.0,0,0,,0,0,,0,0,0,0,0,0,0,0,0,-0.7,-3.0,Payton Pritchard,0,1,0.0
1221,11/25/2022,24.824657534246576,W,0,15.2,2,4,0.5,2,3,0.667,3,4,0.75,0,1,1,0,0,0,0,0,9,6.9,22.0,Payton Pritchard,0,1,0.0
1222,11/27/2022,24.83013698630137,W,0,17.066666666666666,1,4,0.25,1,2,0.5,0,0,,0,1,1,1,0,0,0,0,3,1.6,-13.0,Payton Pritchard,0,2,0.0
1223,10/18/2022,33.59178082191781,W,0,8.283333333333333,0,2,0.0,0,1,0.0,1,2,0.5,2,3,5,1,0,0,0,3,1,1.0,-5.0,Blake Griffin,0,1,0.0
1224,10/22/2022,33.602739726027394,W,0,9.55,0,1,0.0,0,1,0.0,0,0,,0,0,0,1,1,0,0,1,0,0.6,-4.0,Blake Griffin,0,0,
1225,10/24/2022,33.608219178082194,L,0,5.45,1,4,0.25,0,0,,0,0,,3,1,4,1,0,0,0,0,2,2.7,3.0,Blake Griffin,1,4,0.25
1226,10/28/2022,33.61917808219178,L,0,11.7,1,1,1.0,1,1,1.0,4,4,1.0,0,2,2,0,1,0,2,4,7,4.7,-1.0,Blake Griffin,0,0,
1227,11/5/2022,33.64109589041096,W,1,15.083333333333334,3,4,0.75,1,2,0.5,0,0,,0,1,1,2,0,0,2,1,7,4.7,6.0,Blake Griffin,2,2,1.0
1228,11/12/2022,33.66027397260274,W,1,21.0,3,6,0.5,1,3,0.333,0,0,,1,5,6,0,0,0,0,1,7,5.8,1.0,Blake Griffin,2,3,0.6666666666666666
1229,11/16/2022,33.67123287671233,W,0,6.933333333333334,0,1,0.0,0,0,,0,0,,0,2,2,1,0,0,0,1,0,0.2,-4.0,Blake Griffin,0,1,0.0
1230,10/24/2022,27.575342465753426,L,0,5.45,2,3,0.667,2,2,1.0,0,0,,0,0,0,0,0,0,0,0,6,4.7,3.0,Justin Jackson,0,1,0.0
1231,10/30/2022,27.59178082191781,W,0,3.6833333333333336,0,1,0.0,0,1,0.0,0,0,,0,0,0,0,0,0,0,1,0,-1.1,-6.0,Justin Jackson,0,0,
1232,11/9/2022,27.61917808219178,W,0,5.6,0,2,0.0,0,2,0.0,0,0,,0,1,1,1,0,0,0,1,0,-0.8,-8.0,Justin Jackson,0,0,
1233,11/16/2022,27.638356164383563,W,0,10.033333333333333,0,1,0.0,0,1,0.0,0,0,,0,1,1,0,0,1,0,0,0,0.3,0.0,Justin Jackson,0,0,
1234,11/23/2022,27.65753424657534,W,0,1.6,0,0,,0,0,,0,0,,0,0,0,0,0,0,0,0,0,0.0,-2.0,Justin Jackson,0,0,
1235,11/25/2022,27.663013698630138,W,0,4.066666666666666,0,1,0.0,0,1,0.0,0,0,,0,1,1,0,0,0,0,0,0,-0.4,-9.0,Justin Jackson,0,0,
1236,11/27/2022,27.66849315068493,W,0,5.216666666666667,0,0,,0,0,,0,0,,0,0,0,0,0,0,0,0,0,0.0,-14.0,Justin Jackson,0,0,
1237,11/11/2022,20.106849315068494,W,0,2.033333333333333,0,0,,0,0,,0,0,,0,1,1,1,0,0,0,0,0,1.0,1.0,JD Davison,0,0,
1238,11/16/2022,20.12054794520548,W,0,3.533333333333333,0,2,0.0,0,2,0.0,0,0,,0,0,0,0,0,0,1,0,0,-2.4,-3.0,JD Davison,0,0,
1239,11/25/2022,20.145205479452056,W,0,2.9166666666666665,1,2,0.5,0,0,,0,0,,0,0,0,0,1,0,0,0,2,2.0,-2.0,JD Davison,1,2,0.5
1240,10/19/2022,25.257534246575343,W,1,37.55,5,12,0.417,2,5,0.4,6,7,0.857,1,6,7,5,3,1,3,4,18,16.3,9.0,OG Anunoby,3,7,0.42857142857142855
1241,10/21/2022,25.263013698630136,L,1,37.25,3,9,0.333,2,4,0.5,2,2,1.0,1,4,5,1,1,1,3,4,10,4.6,4.0,OG Anunoby,1,5,0.2
1242,10/22/2022,25.265753424657536,L,1,38.35,5,14,0.357,3,6,0.5,0,0,,1,8,9,0,1,1,0,3,13,8.8,4.0,OG Anunoby,2,8,0.25
1243,10/24/2022,25.27123287671233,W,1,33.516666666666666,2,4,0.5,1,3,0.333,1,2,0.5,0,7,7,0,2,1,3,5,6,3.4,16.0,OG Anunoby,1,1,1.0
1244,10/26/2022,25.276712328767122,W,1,34.416666666666664,6,10,0.6,1,3,0.333,2,2,1.0,0,2,2,1,3,0,1,4,15,12.1,3.0,OG Anunoby,5,7,0.7142857142857143
1245,10/28/2022,25.28219178082192,L,1,35.81666666666667,7,16,0.438,2,7,0.286,3,5,0.6,3,6,9,2,2,1,2,2,19,15.0,-12.0,OG Anunoby,5,9,0.5555555555555556
1246,10/31/2022,25.29041095890411,W,1,31.6,5,10,0.5,2,7,0.286,2,2,1.0,1,5,6,3,6,2,1,5,14,17.7,12.0,OG Anunoby,3,3,1.0
1247,11/2/2022,25.295890410958904,W,1,24.35,7,12,0.583,1,3,0.333,3,3,1.0,1,4,5,3,5,1,2,2,18,19.3,28.0,OG Anunoby,6,9,0.6666666666666666
1248,11/4/2022,25.301369863013697,L,1,38.18333333333333,11,21,0.524,4,6,0.667,1,1,1.0,2,5,7,1,5,0,4,4,27,19.7,-2.0,OG Anunoby,7,15,0.4666666666666667
1249,11/6/2022,25.306849315068494,W,1,38.3,10,19,0.526,2,5,0.4,0,0,,4,2,6,3,3,1,1,3,22,19.7,24.0,OG Anunoby,8,14,0.5714285714285714
1250,11/7/2022,25.30958904109589,L,1,39.31666666666667,4,12,0.333,0,2,0.0,5,7,0.714,1,3,4,1,3,0,4,4,13,5.1,-12.0,OG Anunoby,4,10,0.4
1251,11/9/2022,25.315068493150687,W,1,38.68333333333333,10,20,0.5,4,9,0.444,3,4,0.75,1,9,10,1,3,1,1,3,27,22.2,18.0,OG Anunoby,6,11,0.5454545454545454
1252,11/11/2022,25.32054794520548,L,1,31.35,6,15,0.4,0,2,0.0,1,1,1.0,3,3,6,1,2,1,3,1,13,7.9,-24.0,OG Anunoby,6,13,0.46153846153846156
1253,11/12/2022,25.323287671232876,L,1,36.083333333333336,9,16,0.563,2,7,0.286,6,7,0.857,0,2,2,3,1,2,4,4,26,17.5,-17.0,OG Anunoby,7,9,0.7777777777777778
1254,11/14/2022,25.328767123287673,W,1,36.8,6,19,0.316,1,6,0.167,6,7,0.857,2,5,7,3,0,2,3,2,19,10.3,1.0,OG Anunoby,5,13,0.38461538461538464
1255,11/16/2022,25.334246575342465,W,1,43.016666666666666,13,18,0.722,1,3,0.333,5,6,0.833,3,7,10,3,0,1,3,2,32,27.4,8.0,OG Anunoby,12,15,0.8
1256,11/19/2022,25.34246575342466,L,1,42.18333333333333,10,24,0.417,0,6,0.0,7,7,1.0,0,3,3,5,2,0,5,4,27,14.0,-11.0,OG Anunoby,10,18,0.5555555555555556
1257,11/23/2022,25.353424657534248,L,1,35.55,7,20,0.35,0,3,0.0,1,1,1.0,1,4,5,4,2,0,5,1,15,5.1,-29.0,OG Anunoby,7,17,0.4117647058823529
1258,11/26/2022,25.361643835616437,W,1,43.15,9,19,0.474,2,4,0.5,6,7,0.857,4,5,9,2,2,2,5,3,26,18.8,-2.0,OG Anunoby,7,15,0.4666666666666667
1259,10/19/2022,22.33150684931507,W,0,15.366666666666667,1,4,0.25,0,0,,1,2,0.5,2,4,6,0,0,1,1,2,3,1.7,3.0,Christian Koloko,1,4,0.25
1260,10/21/2022,22.336986301369862,L,0,19.75,0,2,0.0,0,0,,1,2,0.5,2,0,2,0,0,1,0,5,1,-0.7,-3.0,Christian Koloko,0,2,0.0
1261,10/22/2022,22.339726027397262,L,0,12.3,0,0,,0,0,,1,2,0.5,0,2,2,0,0,0,0,0,1,1.2,-5.0,Christian Koloko,0,0,
1262,10/24/2022,22.345205479452055,W,1,17.6,1,2,0.5,0,0,,0,0,,0,2,2,2,0,1,0,5,2,1.7,-10.0,Christian Koloko,1,2,0.5
1263,10/26/2022,22.350684931506848,W,0,11.283333333333333,2,2,1.0,0,0,,0,0,,1,3,4,0,1,1,0,4,4,5.1,4.0,Christian Koloko,2,2,1.0
1264,10/28/2022,22.356164383561644,L,0,10.033333333333333,1,1,1.0,0,0,,1,2,0.5,2,0,2,1,2,0,0,1,3,6.0,3.0,Christian Koloko,1,1,1.0
1265,10/31/2022,22.364383561643837,W,1,21.45,4,7,0.571,0,0,,1,3,0.333,2,3,5,0,0,3,2,4,9,5.7,23.0,Christian Koloko,4,7,0.5714285714285714
1266,11/2/2022,22.36986301369863,W,1,23.183333333333334,1,4,0.25,0,0,,0,0,,1,5,6,0,0,1,1,2,2,0.7,30.0,Christian Koloko,1,4,0.25
1267,11/4/2022,22.375342465753423,L,1,11.816666666666666,1,2,0.5,0,1,0.0,0,0,,2,0,2,0,0,1,2,4,2,-0.5,-12.0,Christian Koloko,1,1,1.0
1268,11/6/2022,22.38082191780822,W,1,31.016666666666666,4,8,0.5,0,1,0.0,3,4,0.75,2,5,7,2,0,6,1,3,11,12.9,19.0,Christian Koloko,4,7,0.5714285714285714
1269,11/7/2022,22.383561643835616,L,1,21.05,2,8,0.25,0,1,0.0,1,2,0.5,1,2,3,1,0,1,2,4,5,-1.1,4.0,Christian Koloko,2,7,0.2857142857142857
1270,11/9/2022,22.389041095890413,W,1,14.4,1,4,0.25,0,0,,3,3,1.0,1,0,1,0,0,1,0,5,5,2.0,2.0,Christian Koloko,1,4,0.25
1271,11/11/2022,22.394520547945206,L,1,23.966666666666665,1,4,0.25,0,0,,0,0,,3,1,4,1,1,0,1,3,2,1.5,0.0,Christian Koloko,1,4,0.25
1272,11/12/2022,22.397260273972602,L,0,5.55,1,1,1.0,0,0,,0,0,,1,1,2,0,0,0,0,0,2,2.7,1.0,Christian Koloko,1,1,1.0
1273,11/14/2022,22.4027397260274,W,0,16.966666666666665,2,2,1.0,0,0,,4,4,1.0,2,0,2,1,0,1,1,2,8,8.4,2.0,Christian Koloko,2,2,1.0
1274,11/16/2022,22.40821917808219,W,0,13.0,2,2,1.0,0,0,,0,0,,1,0,1,0,0,1,0,3,4,3.6,4.0,Christian Koloko,2,2,1.0
1275,11/19/2022,22.416438356164385,L,0,30.3,2,4,0.5,0,1,0.0,3,6,0.5,7,4,11,1,0,4,0,5,7,11.4,5.0,Christian Koloko,2,3,0.6666666666666666
1276,11/23/2022,22.427397260273974,L,1,17.8,1,3,0.333,0,0,,2,4,0.5,4,1,5,0,0,1,1,2,4,3.5,-17.0,Christian Koloko,1,3,0.3333333333333333
1277,11/26/2022,22.435616438356163,W,0,4.966666666666667,0,1,0.0,0,0,,0,0,,1,0,1,0,0,0,0,3,0,-1.2,2.0,Christian Koloko,0,1,0.0
1278,10/19/2022,23.75068493150685,W,1,36.983333333333334,5,12,0.417,4,8,0.5,5,7,0.714,3,2,5,0,1,0,1,1,19,14.1,3.0,Gary Trent Jr.,1,4,0.25
1279,10/21/2022,23.756164383561643,L,1,35.96666666666667,6,16,0.375,2,7,0.286,0,0,,0,1,1,0,1,0,0,0,14,6.5,-9.0,Gary Trent Jr.,4,9,0.4444444444444444
1280,10/22/2022,23.75890410958904,L,1,38.916666666666664,7,18,0.389,5,12,0.417,4,6,0.667,0,1,1,2,2,1,1,3,23,14.6,-6.0,Gary Trent Jr.,2,6,0.3333333333333333
1281,10/24/2022,23.764383561643836,W,1,42.2,7,19,0.368,4,12,0.333,0,0,,1,0,1,2,1,0,1,1,18,9.2,5.0,Gary Trent Jr.,3,7,0.42857142857142855
1282,10/26/2022,23.76986301369863,W,1,35.45,11,16,0.688,5,10,0.5,0,0,,0,0,0,0,2,0,2,1,27,19.8,2.0,Gary Trent Jr.,6,6,1.0
1283,10/28/2022,23.775342465753425,L,1,32.95,6,15,0.4,2,7,0.286,0,0,,1,3,4,3,1,0,2,0,14,8.6,-25.0,Gary Trent Jr.,4,8,0.5
1284,10/31/2022,23.783561643835615,W,1,36.81666666666667,7,16,0.438,2,6,0.333,5,6,0.833,1,1,2,2,1,0,0,0,21,15.6,28.0,Gary Trent Jr.,5,10,0.5
1285,11/2/2022,23.78904109589041,W,1,26.2,9,17,0.529,2,6,0.333,4,4,1.0,2,1,3,2,2,0,0,2,24,20.0,35.0,Gary Trent Jr.,7,11,0.6363636363636364
1286,11/4/2022,23.794520547945204,L,1,36.46666666666667,3,12,0.25,1,7,0.143,5,6,0.833,0,0,0,0,1,0,2,2,12,2.6,-7.0,Gary Trent Jr.,2,5,0.4
1287,11/6/2022,23.8,W,1,20.566666666666666,4,11,0.364,1,5,0.2,3,5,0.6,1,2,3,0,1,0,0,0,12,7.4,-25.0,Gary Trent Jr.,3,6,0.5
1288,11/7/2022,23.802739726027397,L,1,32.68333333333333,7,12,0.583,2,4,0.5,3,3,1.0,0,3,3,4,3,1,2,2,19,18.0,-2.0,Gary Trent Jr.,5,8,0.625
1289,11/9/2022,23.80821917808219,W,1,29.65,4,8,0.5,1,4,0.25,2,2,1.0,0,1,1,4,1,0,2,4,11,7.5,2.0,Gary Trent Jr.,3,4,0.75
1290,11/11/2022,23.813698630136987,L,1,23.533333333333335,4,10,0.4,0,2,0.0,4,5,0.8,1,1,2,1,1,0,0,1,12,8.5,-8.0,Gary Trent Jr.,4,8,0.5
1291,11/12/2022,23.816438356164383,L,1,19.5,1,13,0.077,0,5,0.0,4,6,0.667,0,1,1,0,1,1,1,1,6,-2.9,-17.0,Gary Trent Jr.,1,8,0.125
1292,11/23/2022,23.846575342465755,L,1,30.716666666666665,6,19,0.316,1,8,0.125,6,9,0.667,1,0,1,3,3,0,3,1,19,9.3,-12.0,Gary Trent Jr.,5,11,0.45454545454545453
1293,11/26/2022,23.854794520547944,W,1,27.433333333333334,3,12,0.25,1,5,0.2,2,2,1.0,0,4,4,3,4,0,1,1,9,7.7,2.0,Gary Trent Jr.,2,7,0.2857142857142857
1294,10/19/2022,21.216438356164385,W,1,32.333333333333336,7,14,0.5,1,1,1.0,0,0,,1,2,3,7,2,1,3,4,15,12.3,20.0,Scottie Barnes,6,13,0.46153846153846156
1295,10/21/2022,21.221917808219178,L,1,35.88333333333333,7,14,0.5,1,2,0.5,2,2,1.0,2,5,7,3,2,1,3,2,17,13.9,2.0,Scottie Barnes,6,12,0.5
1296,10/22/2022,21.224657534246575,L,1,13.233333333333333,5,9,0.556,0,1,0.0,1,3,0.333,1,1,2,2,0,1,1,1,11,7.6,-8.0,Scottie Barnes,5,8,0.625
1297,10/26/2022,21.235616438356164,W,1,32.666666666666664,6,11,0.545,1,4,0.25,3,3,1.0,1,9,10,5,1,0,0,0,16,18.6,3.0,Scottie Barnes,5,7,0.7142857142857143
1298,10/28/2022,21.24109589041096,L,1,28.9,4,7,0.571,3,4,0.75,2,2,1.0,2,4,6,1,1,0,2,1,13,11.6,-21.0,Scottie Barnes,1,3,0.3333333333333333
1299,10/31/2022,21.24931506849315,W,1,33.38333333333333,7,14,0.5,5,9,0.556,2,3,0.667,0,7,7,8,1,0,2,3,21,19.1,31.0,Scottie Barnes,2,5,0.4
1300,11/2/2022,21.254794520547946,W,1,28.0,7,13,0.538,1,4,0.25,0,0,,1,3,4,5,0,1,2,0,15,12.5,30.0,Scottie Barnes,6,9,0.6666666666666666
1301,11/4/2022,21.26027397260274,L,1,38.083333333333336,4,12,0.333,1,6,0.167,2,2,1.0,3,8,11,10,1,0,5,0,11,11.7,1.0,Scottie Barnes,3,6,0.5
1302,11/6/2022,21.265753424657536,W,1,40.083333333333336,8,19,0.421,2,7,0.286,1,2,0.5,2,8,10,4,1,0,2,1,19,13.7,5.0,Scottie Barnes,6,12,0.5
1303,11/7/2022,21.268493150684932,L,1,30.416666666666668,2,9,0.222,0,2,0.0,1,2,0.5,1,5,6,5,0,0,1,3,5,2.6,6.0,Scottie Barnes,2,7,0.2857142857142857
1304,11/9/2022,21.273972602739725,W,1,34.1,6,16,0.375,1,4,0.25,0,0,,7,1,8,5,0,2,1,1,13,12.9,6.0,Scottie Barnes,5,12,0.4166666666666667
1305,11/11/2022,21.279452054794522,L,1,28.633333333333333,5,13,0.385,1,3,0.333,4,6,0.667,0,3,3,4,1,2,2,1,15,10.8,-4.0,Scottie Barnes,4,10,0.4
1306,11/12/2022,21.28219178082192,L,1,39.016666666666666,4,16,0.25,0,4,0.0,0,0,,4,5,9,5,2,1,2,2,8,6.1,-18.0,Scottie Barnes,4,12,0.3333333333333333
1307,11/14/2022,21.28767123287671,W,1,34.18333333333333,4,9,0.444,0,1,0.0,0,0,,0,5,5,4,1,1,3,3,8,5.1,1.0,Scottie Barnes,4,8,0.5
1308,11/16/2022,21.293150684931508,W,1,41.53333333333333,9,14,0.643,1,2,0.5,0,0,,3,3,6,6,1,1,4,0,19,17.7,4.0,Scottie Barnes,8,12,0.6666666666666666
1309,11/19/2022,21.301369863013697,L,1,45.56666666666667,11,29,0.379,4,8,0.5,2,2,1.0,3,8,11,9,1,2,3,3,28,21.1,-1.0,Scottie Barnes,7,21,0.3333333333333333
1310,10/19/2022,34.32876712328767,W,0,10.783333333333333,1,3,0.333,1,2,0.5,0,0,,0,0,0,0,1,0,0,0,3,2.3,-14.0,Thaddeus Young,0,1,0.0
1311,10/21/2022,34.33424657534247,L,0,5.983333333333333,0,1,0.0,0,1,0.0,0,0,,0,1,1,1,0,0,0,0,0,0.3,4.0,Thaddeus Young,0,0,
1312,10/22/2022,34.33698630136986,L,0,10.583333333333334,2,3,0.667,0,1,0.0,0,0,,1,1,2,0,2,0,1,4,4,3.1,-15.0,Thaddeus Young,2,2,1.0
1313,10/28/2022,34.35342465753425,L,0,4.916666666666667,0,1,0.0,0,1,0.0,0,0,,0,2,2,0,0,0,0,0,0,-0.1,-3.0,Thaddeus Young,0,0,
1314,11/2/2022,34.367123287671234,W,0,8.133333333333333,2,4,0.5,0,0,,1,2,0.5,1,1,2,2,2,0,0,0,5,7.0,5.0,Thaddeus Young,2,4,0.5
1315,11/4/2022,34.37260273972603,L,0,3.8333333333333335,1,1,1.0,0,0,,0,0,,0,0,0,0,0,0,1,2,2,-0.1,0.0,Thaddeus Young,1,1,1.0
1316,11/6/2022,34.37808219178082,W,0,15.55,2,5,0.4,0,1,0.0,0,0,,4,4,8,2,1,0,0,0,4,7.7,25.0,Thaddeus Young,2,4,0.5
1317,11/7/2022,34.38082191780822,L,0,10.4,0,0,,0,0,,0,0,,0,0,0,3,0,0,1,1,0,0.7,-5.0,Thaddeus Young,0,0,
1318,11/9/2022,34.38630136986301,W,0,26.733333333333334,0,3,0.0,0,0,,0,0,,3,5,8,2,1,1,1,0,0,3.6,21.0,Thaddeus Young,0,3,0.0
1319,11/11/2022,34.391780821917806,L,0,9.25,1,1,1.0,0,0,,2,2,1.0,2,0,2,2,0,0,0,1,4,6.1,-10.0,Thaddeus Young,1,1,1.0
1320,11/12/2022,34.394520547945206,L,1,34.016666666666666,6,10,0.6,0,2,0.0,3,4,0.75,2,3,5,1,3,0,2,4,15,12.4,-13.0,Thaddeus Young,6,8,0.75
1321,11/14/2022,34.4,W,1,26.0,2,4,0.5,0,1,0.0,2,2,1.0,4,2,6,4,2,1,0,4,6,11.3,5.0,Thaddeus Young,2,3,0.6666666666666666
1322,11/16/2022,34.40547945205479,W,1,27.85,6,9,0.667,0,0,,0,0,,5,3,8,2,0,0,2,4,12,10.3,2.0,Thaddeus Young,6,9,0.6666666666666666
1323,11/19/2022,34.413698630136984,L,1,35.03333333333333,9,12,0.75,0,2,0.0,0,0,,3,6,9,4,4,0,1,3,18,21.7,-6.0,Thaddeus Young,9,10,0.9
1324,11/23/2022,34.42465753424658,L,1,27.666666666666668,6,10,0.6,0,2,0.0,0,0,,3,5,8,5,2,0,1,1,12,15.1,-13.0,Thaddeus Young,6,8,0.75
1325,11/26/2022,34.43287671232877,W,1,27.283333333333335,1,6,0.167,0,0,,2,2,1.0,4,2,6,4,2,0,3,5,4,3.4,4.0,Thaddeus Young,1,6,0.16666666666666666
1326,10/24/2022,29.783561643835615,W,0,11.7,4,5,0.8,2,2,1.0,0,0,,1,1,2,0,0,1,1,5,10,6.8,1.0,Chris Boucher,2,3,0.6666666666666666
1327,10/26/2022,29.78904109589041,W,0,17.25,5,9,0.556,2,4,0.5,1,2,0.5,1,3,4,0,0,0,1,3,13,7.7,11.0,Chris Boucher,3,5,0.6
1328,10/28/2022,29.794520547945204,L,0,22.083333333333332,3,6,0.5,1,2,0.5,1,3,0.333,0,3,3,1,1,3,1,3,8,6.7,-8.0,Chris Boucher,2,4,0.5
1329,10/31/2022,29.802739726027397,W,0,20.9,4,6,0.667,1,3,0.333,2,2,1.0,2,1,3,1,2,1,0,1,11,13.1,9.0,Chris Boucher,3,3,1.0
1330,11/2/2022,29.80821917808219,W,0,25.366666666666667,7,10,0.7,3,5,0.6,0,0,,2,6,8,2,2,1,1,4,17,17.5,22.0,Chris Boucher,4,5,0.8
1331,11/4/2022,29.813698630136987,L,0,29.616666666666667,6,13,0.462,2,6,0.333,3,4,0.75,4,5,9,1,0,1,0,4,17,14.0,20.0,Chris Boucher,4,7,0.5714285714285714
1332,11/6/2022,29.81917808219178,W,0,22.183333333333334,4,10,0.4,0,2,0.0,0,0,,6,0,6,1,1,2,3,3,8,5.7,-6.0,Chris Boucher,4,8,0.5
1333,11/7/2022,29.82191780821918,L,0,14.466666666666667,0,3,0.0,0,2,0.0,0,2,0.0,0,3,3,0,0,0,1,3,0,-4.2,-10.0,Chris Boucher,0,1,0.0
1334,11/9/2022,29.827397260273973,W,0,13.383333333333333,0,2,0.0,0,1,0.0,2,2,1.0,1,3,4,0,1,1,0,3,2,2.7,-10.0,Chris Boucher,0,1,0.0
1335,11/11/2022,29.832876712328765,L,0,31.15,6,9,0.667,0,2,0.0,8,10,0.8,4,8,12,1,2,1,3,1,20,20.5,-7.0,Chris Boucher,6,7,0.8571428571428571
1336,11/12/2022,29.835616438356166,L,0,28.2,6,17,0.353,2,8,0.25,5,7,0.714,4,3,7,0,1,1,1,2,19,12.3,-3.0,Chris Boucher,4,9,0.4444444444444444
1337,11/14/2022,29.84109589041096,W,0,31.216666666666665,7,12,0.583,1,3,0.333,5,5,1.0,1,3,4,1,1,0,1,4,20,15.1,-3.0,Chris Boucher,6,9,0.6666666666666666
1338,11/16/2022,29.846575342465755,W,0,25.0,4,7,0.571,1,3,0.333,6,9,0.667,2,8,10,1,1,0,1,3,15,13.8,7.0,Chris Boucher,3,4,0.75
1339,11/23/2022,29.865753424657534,L,0,28.85,2,15,0.133,0,3,0.0,8,8,1.0,8,8,16,0,1,1,0,0,12,12.0,0.0,Chris Boucher,2,12,0.16666666666666666
1340,11/26/2022,29.873972602739727,W,0,36.06666666666667,10,19,0.526,0,3,0.0,2,5,0.4,5,8,13,0,1,0,0,1,22,18.0,6.0,Chris Boucher,10,16,0.625
1341,10/19/2022,22.947945205479453,W,0,9.216666666666667,0,1,0.0,0,1,0.0,2,2,1.0,0,1,1,1,0,1,0,1,2,2.6,0.0,Dalano Banton,0,0,
1342,10/21/2022,22.953424657534246,L,0,12.966666666666667,2,4,0.5,0,1,0.0,0,0,,0,0,0,0,1,0,1,1,4,1.6,-15.0,Dalano Banton,2,3,0.6666666666666666
1343,10/22/2022,22.956164383561642,L,0,5.55,1,2,0.5,1,2,0.5,0,0,,0,0,0,0,0,1,0,1,3,2.3,-3.0,Dalano Banton,0,0,
1344,10/24/2022,22.96164383561644,W,0,7.683333333333334,0,2,0.0,0,1,0.0,0,0,,1,2,3,1,0,0,0,1,0,0.2,-5.0,Dalano Banton,0,1,0.0
1345,10/26/2022,22.96712328767123,W,0,4.466666666666667,1,1,1.0,0,0,,0,0,,0,1,1,1,0,0,0,0,2,2.7,-1.0,Dalano Banton,1,1,1.0
1346,10/28/2022,22.972602739726028,L,0,8.75,2,5,0.4,0,2,0.0,0,0,,1,1,2,0,1,0,1,0,4,2.3,-1.0,Dalano Banton,2,3,0.6666666666666666
1347,10/31/2022,22.980821917808218,W,0,5.366666666666666,2,3,0.667,1,1,1.0,0,0,,0,0,0,1,0,0,0,0,5,4.4,1.0,Dalano Banton,1,2,0.5
1348,11/2/2022,22.986301369863014,W,0,12.983333333333333,5,7,0.714,3,3,1.0,0,0,,0,0,0,0,0,1,0,0,13,10.8,8.0,Dalano Banton,2,4,0.5
1349,11/4/2022,22.991780821917807,L,0,3.6,0,1,0.0,0,0,,0,0,,0,0,0,0,0,1,1,1,0,-1.4,-7.0,Dalano Banton,0,1,0.0
1350,11/7/2022,23.0,L,0,9.616666666666667,2,7,0.286,0,3,0.0,0,0,,0,2,2,2,1,1,0,0,4,3.6,-3.0,Dalano Banton,2,4,0.5
1351,11/9/2022,23.005479452054793,W,0,11.983333333333333,2,7,0.286,0,3,0.0,4,6,0.667,2,1,3,2,1,1,3,4,8,3.3,5.0,Dalano Banton,2,4,0.5
1352,11/11/2022,23.01095890410959,L,0,17.316666666666666,2,8,0.25,1,4,0.25,0,0,,1,0,1,4,1,0,1,0,5,3.7,-1.0,Dalano Banton,1,4,0.25
1353,11/12/2022,23.013698630136986,L,0,13.016666666666667,5,8,0.625,2,3,0.667,2,2,1.0,1,1,2,0,0,2,1,1,14,11.4,4.0,Dalano Banton,3,5,0.6
1354,11/14/2022,23.019178082191782,W,1,24.916666666666668,9,16,0.563,3,7,0.429,6,6,1.0,0,4,4,4,3,2,2,4,27,24.2,0.0,Dalano Banton,6,9,0.6666666666666666
1355,11/16/2022,23.024657534246575,W,1,20.6,2,10,0.2,1,6,0.167,0,0,,1,0,1,1,1,0,0,3,5,0.0,-14.0,Dalano Banton,1,4,0.25
1356,10/19/2022,28.646575342465752,W,1,38.68333333333333,4,9,0.444,3,6,0.5,4,4,1.0,1,1,2,5,4,0,1,3,15,16.6,7.0,Fred VanVleet,1,3,0.3333333333333333
1357,10/21/2022,28.65205479452055,L,1,37.916666666666664,7,11,0.636,4,6,0.667,0,0,,1,6,7,9,4,1,0,3,18,25.4,3.0,Fred VanVleet,3,5,0.6
1358,10/22/2022,28.654794520547945,L,1,38.81666666666667,2,9,0.222,1,6,0.167,2,2,1.0,1,1,2,10,3,0,1,5,7,9.5,6.0,Fred VanVleet,1,3,0.3333333333333333
1359,10/24/2022,28.660273972602738,W,1,39.21666666666667,6,16,0.375,4,6,0.667,8,9,0.889,2,2,4,9,1,0,2,1,24,21.7,13.0,Fred VanVleet,2,10,0.2
1360,10/26/2022,28.665753424657535,W,1,38.833333333333336,5,12,0.417,2,5,0.4,3,3,1.0,0,6,6,8,2,3,2,1,15,17.7,8.0,Fred VanVleet,3,7,0.42857142857142855
1361,10/28/2022,28.671232876712327,L,1,34.21666666666667,0,11,0.0,0,8,0.0,1,3,0.333,1,2,3,5,1,0,1,3,1,-3.9,-19.0,Fred VanVleet,0,3,0.0
1362,11/6/2022,28.695890410958903,W,1,39.333333333333336,9,22,0.409,5,13,0.385,7,7,1.0,0,5,5,11,0,0,1,1,30,26.0,27.0,Fred VanVleet,4,9,0.4444444444444444
1363,11/7/2022,28.698630136986303,L,1,34.36666666666667,10,19,0.526,6,10,0.6,1,1,1.0,0,3,3,4,2,2,2,1,27,22.4,-8.0,Fred VanVleet,4,9,0.4444444444444444
1364,11/9/2022,28.704109589041096,W,1,35.11666666666667,12,26,0.462,7,16,0.438,1,1,1.0,0,3,3,4,4,1,1,3,32,24.8,-1.0,Fred VanVleet,5,10,0.5
1365,11/11/2022,28.70958904109589,L,1,28.583333333333332,5,12,0.417,3,7,0.429,2,5,0.4,0,2,2,3,2,0,3,3,15,7.9,-22.0,Fred VanVleet,2,5,0.4
1366,11/16/2022,28.723287671232878,W,1,39.266666666666666,7,21,0.333,3,10,0.3,6,7,0.857,0,1,1,8,0,0,3,5,23,11.6,10.0,Fred VanVleet,4,11,0.36363636363636365
1367,11/19/2022,28.731506849315068,L,1,44.45,4,18,0.222,1,11,0.091,6,6,1.0,1,1,2,5,0,0,2,3,15,5.3,-16.0,Fred VanVleet,3,7,0.42857142857142855
1368,11/26/2022,28.75068493150685,W,1,40.96666666666667,7,18,0.389,3,9,0.333,9,10,0.9,1,5,6,7,1,0,3,2,26,20.1,12.0,Fred VanVleet,4,9,0.4444444444444444
1369,10/19/2022,23.08219178082192,W,0,17.933333333333334,4,11,0.364,1,4,0.25,1,2,0.5,1,4,5,0,0,0,0,1,10,5.0,-4.0,Precious Achiuwa,3,7,0.42857142857142855
1370,10/21/2022,23.087671232876712,L,0,17.483333333333334,1,6,0.167,0,1,0.0,2,3,0.667,0,6,6,0,0,0,3,2,4,-2.2,-8.0,Precious Achiuwa,1,5,0.2
1371,10/22/2022,23.09041095890411,L,0,33.53333333333333,5,9,0.556,2,5,0.4,6,7,0.857,3,8,11,1,0,0,1,1,18,17.1,16.0,Precious Achiuwa,3,4,0.75
1372,10/24/2022,23.095890410958905,W,0,33.71666666666667,5,12,0.417,0,1,0.0,0,1,0.0,4,18,22,2,0,1,0,2,10,12.7,10.0,Precious Achiuwa,5,11,0.45454545454545453
1373,10/26/2022,23.101369863013698,W,0,21.3,3,7,0.429,1,3,0.333,0,0,,3,3,6,4,0,0,2,3,7,5.9,14.0,Precious Achiuwa,2,4,0.5
1374,10/28/2022,23.106849315068494,L,0,14.95,0,6,0.0,0,3,0.0,0,0,,2,1,3,1,0,1,2,1,0,-3.5,-10.0,Precious Achiuwa,0,3,0.0
1375,10/31/2022,23.115068493150684,W,0,17.75,2,3,0.667,0,1,0.0,6,6,1.0,0,3,3,1,0,0,1,1,10,8.9,11.0,Precious Achiuwa,2,2,1.0
1376,11/2/2022,23.12054794520548,W,0,21.0,4,9,0.444,0,3,0.0,4,4,1.0,0,6,6,1,1,1,1,1,12,10.1,6.0,Precious Achiuwa,4,6,0.6666666666666666
1377,11/4/2022,23.126027397260273,L,0,26.6,4,9,0.444,1,3,0.333,6,6,1.0,3,5,8,2,0,1,2,1,15,13.6,2.0,Precious Achiuwa,3,6,0.5
1378,11/6/2022,23.13150684931507,W,0,14.183333333333334,2,6,0.333,0,2,0.0,1,2,0.5,3,1,4,2,1,1,1,3,5,4.5,-20.0,Precious Achiuwa,2,4,0.5
1379,11/7/2022,23.134246575342466,L,0,13.866666666666667,4,6,0.667,0,0,,2,2,1.0,1,3,4,1,0,1,0,1,10,10.0,-16.0,Precious Achiuwa,4,6,0.6666666666666666
1380,11/9/2022,23.13972602739726,W,0,12.483333333333333,2,8,0.25,0,2,0.0,0,0,,4,2,6,1,0,1,2,2,4,1.2,-11.0,Precious Achiuwa,2,6,0.3333333333333333
1381,10/22/2022,24.45205479452055,L,0,8.533333333333333,2,4,0.5,2,4,0.5,0,0,,0,0,0,0,0,0,0,3,6,2.8,1.0,Malachi Flynn,0,0,
1382,10/24/2022,24.457534246575342,W,0,5.983333333333333,1,2,0.5,1,1,1.0,0,0,,0,0,0,0,0,0,0,0,3,2.0,-4.0,Malachi Flynn,0,1,0.0
1383,10/28/2022,24.46849315068493,L,0,5.116666666666666,0,0,,0,0,,0,0,,0,0,0,0,0,0,0,1,0,-0.4,-5.0,Malachi Flynn,0,0,
1384,10/31/2022,24.476712328767125,W,0,9.383333333333333,2,6,0.333,0,2,0.0,0,0,,1,0,1,1,1,0,0,2,4,2.2,-6.0,Malachi Flynn,2,4,0.5
1385,11/2/2022,24.482191780821918,W,0,9.866666666666667,3,5,0.6,2,2,1.0,0,0,,0,2,2,2,0,0,0,1,8,7.3,6.0,Malachi Flynn,1,3,0.3333333333333333
1386,11/7/2022,24.495890410958904,L,0,6.033333333333333,1,2,0.5,0,1,0.0,2,2,1.0,0,1,1,1,1,0,1,0,4,4.0,-1.0,Malachi Flynn,1,1,1.0
1387,11/11/2022,24.506849315068493,L,0,11.95,3,7,0.429,3,4,0.75,3,4,0.75,0,2,2,0,0,0,2,2,12,5.7,-3.0,Malachi Flynn,0,3,0.0
1388,11/12/2022,24.50958904109589,L,0,22.8,3,9,0.333,1,5,0.2,1,1,1.0,0,2,2,1,1,1,0,2,8,5.1,10.0,Malachi Flynn,2,4,0.5
1389,11/14/2022,24.515068493150686,W,0,15.266666666666667,3,6,0.5,2,4,0.5,4,4,1.0,0,3,3,4,0,0,2,2,12,9.9,8.0,Malachi Flynn,1,2,0.5
1390,11/19/2022,24.528767123287672,L,0,28.216666666666665,7,12,0.583,3,6,0.5,0,0,,1,4,5,3,2,0,1,6,17,14.0,9.0,Malachi Flynn,4,6,0.6666666666666666
1391,11/23/2022,24.53972602739726,L,1,30.066666666666666,3,12,0.25,2,3,0.667,0,0,,0,1,1,3,1,0,1,2,8,2.4,-19.0,Malachi Flynn,1,9,0.1111111111111111
1392,11/26/2022,24.54794520547945,W,0,6.066666666666666,0,1,0.0,0,1,0.0,0,0,,0,1,1,1,0,0,1,0,0,-0.7,6.0,Malachi Flynn,0,0,
1393,10/19/2022,27.057534246575344,W,0,7.083333333333333,0,0,,0,0,,0,0,,0,1,1,0,1,0,0,1,0,0.9,-8.0,Juancho Hernangómez,0,0,
1394,10/28/2022,27.08219178082192,L,0,3.2333333333333334,0,2,0.0,0,2,0.0,0,0,,0,0,0,0,0,0,1,0,0,-2.4,-1.0,Juancho Hernangómez,0,0,
1395,10/31/2022,27.09041095890411,W,0,5.2,0,0,,0,0,,0,0,,0,0,0,1,0,1,0,1,0,1.0,3.0,Juancho Hernangómez,0,0,
1396,11/2/2022,27.095890410958905,W,0,8.133333333333333,0,0,,0,0,,0,0,,0,1,1,1,0,0,0,0,0,1.0,5.0,Juancho Hernangómez,0,0,
1397,11/7/2022,27.10958904109589,L,0,10.566666666666666,2,3,0.667,1,2,0.5,0,0,,1,1,2,1,0,1,0,1,5,5.7,-9.0,Juancho Hernangómez,1,1,1.0
1398,11/11/2022,27.12054794520548,L,0,17.05,3,4,0.75,2,3,0.667,1,2,0.5,0,4,4,2,2,0,1,1,9,10.2,-4.0,Juancho Hernangómez,1,1,1.0
1399,11/12/2022,27.123287671232877,L,0,15.283333333333333,0,1,0.0,0,0,,0,0,,2,6,8,1,1,0,0,1,0,3.8,-4.0,Juancho Hernangómez,0,1,0.0
1400,11/14/2022,27.12876712328767,W,0,23.666666666666668,4,8,0.5,1,3,0.333,0,0,,1,5,6,3,0,0,2,2,9,6.5,11.0,Juancho Hernangómez,3,5,0.6
1401,11/16/2022,27.134246575342466,W,0,22.583333333333332,0,3,0.0,0,2,0.0,0,0,,0,4,4,1,1,0,1,1,0,-0.6,17.0,Juancho Hernangómez,0,1,0.0
1402,11/19/2022,27.14246575342466,L,1,31.966666666666665,5,9,0.556,0,3,0.0,0,1,0.0,2,7,9,0,2,0,1,1,10,9.4,0.0,Juancho Hernangómez,5,6,0.8333333333333334
1403,11/23/2022,27.153424657534245,L,0,32.81666666666667,4,9,0.444,1,5,0.2,1,2,0.5,6,4,10,0,3,0,2,4,10,9.7,4.0,Juancho Hernangómez,3,4,0.75
1404,11/26/2022,27.161643835616438,W,1,29.65,4,6,0.667,2,4,0.5,0,0,,0,5,5,0,0,0,0,3,10,7.7,3.0,Juancho Hernangómez,2,2,1.0
1405,10/19/2022,28.54794520547945,W,1,34.06666666666667,9,20,0.45,1,3,0.333,4,8,0.5,3,8,11,1,3,0,4,6,23,12.8,-1.0,Pascal Siakam,8,17,0.47058823529411764
1406,10/21/2022,28.553424657534247,L,1,36.8,15,21,0.714,2,6,0.333,5,9,0.556,2,10,12,11,0,0,3,4,37,34.2,2.0,Pascal Siakam,13,15,0.8666666666666667
1407,10/22/2022,28.556164383561644,L,1,40.18333333333333,8,19,0.421,0,2,0.0,7,8,0.875,1,7,8,9,1,1,1,4,23,20.7,-5.0,Pascal Siakam,8,17,0.47058823529411764
1408,10/24/2022,28.561643835616437,W,1,41.78333333333333,7,22,0.318,2,6,0.333,7,8,0.875,0,9,9,6,2,2,5,1,23,14.9,10.0,Pascal Siakam,5,16,0.3125
1409,10/26/2022,28.567123287671233,W,1,38.0,7,16,0.438,4,8,0.5,2,4,0.5,0,5,5,13,0,0,1,1,20,20.0,7.0,Pascal Siakam,3,8,0.375
1410,10/28/2022,28.572602739726026,L,1,35.78333333333333,9,15,0.6,1,3,0.333,7,9,0.778,2,8,10,6,0,0,5,3,26,20.1,-7.0,Pascal Siakam,8,12,0.6666666666666666
1411,10/31/2022,28.58082191780822,W,1,35.15,8,21,0.381,2,3,0.667,13,16,0.813,3,9,12,6,0,2,0,3,31,27.5,30.0,Pascal Siakam,6,18,0.3333333333333333
1412,11/2/2022,28.586301369863016,W,1,27.566666666666666,10,19,0.526,1,5,0.2,1,1,1.0,1,9,10,11,1,0,3,3,22,20.6,26.0,Pascal Siakam,9,14,0.6428571428571429
1413,11/4/2022,28.59178082191781,L,1,31.25,7,14,0.5,0,2,0.0,4,6,0.667,4,3,7,6,1,0,2,3,18,15.9,-7.0,Pascal Siakam,7,12,0.5833333333333334
1414,10/24/2022,30.07123287671233,W,0,6.566666666666666,1,2,0.5,0,0,,0,0,,1,1,2,0,0,0,0,1,2,1.6,4.0,Khem Birch,1,2,0.5
1415,10/26/2022,30.076712328767123,W,0,6.333333333333333,0,0,,0,0,,0,0,,0,1,1,0,0,1,0,4,0,-0.6,-1.0,Khem Birch,0,0,
1416,10/31/2022,30.09041095890411,W,0,9.116666666666667,1,1,1.0,1,1,1.0,2,2,1.0,2,0,2,0,2,0,0,1,5,7.7,7.0,Khem Birch,0,0,
1417,11/2/2022,30.095890410958905,W,0,11.7,1,2,0.5,0,0,,0,0,,0,0,0,1,1,0,1,2,2,0.9,7.0,Khem Birch,1,2,0.5
1418,11/14/2022,30.12876712328767,W,0,3.9166666666666665,1,1,1.0,0,0,,0,0,,0,0,0,1,0,0,1,2,2,0.6,-3.0,Khem Birch,1,1,1.0
1419,11/16/2022,30.134246575342466,W,0,7.15,1,2,0.5,0,0,,0,0,,1,0,1,1,1,0,0,2,2,2.6,2.0,Khem Birch,1,2,0.5
1420,11/19/2022,30.14246575342466,L,0,3.6,0,0,,0,0,,0,0,,0,1,1,0,0,0,0,0,0,0.3,1.0,Khem Birch,0,0,
1421,11/23/2022,30.153424657534245,L,0,10.666666666666666,1,1,1.0,0,0,,0,0,,0,3,3,0,0,0,0,1,2,2.2,2.0,Khem Birch,1,1,1.0
1422,11/26/2022,30.161643835616438,W,0,12.683333333333334,3,5,0.6,0,0,,0,0,,0,0,0,0,0,0,0,2,6,2.9,-3.0,Khem Birch,3,5,0.6
1423,11/2/2022,29.416438356164385,W,0,10.516666666666667,1,2,0.5,1,2,0.5,2,2,1.0,0,3,3,0,2,0,0,0,5,6.9,9.0,Otto Porter Jr.,0,0,
1424,11/4/2022,29.421917808219177,L,0,20.55,2,3,0.667,2,3,0.667,0,0,,0,0,0,0,2,0,0,1,6,6.3,7.0,Otto Porter Jr.,0,0,
1425,11/6/2022,29.427397260273974,W,0,18.783333333333335,1,3,0.333,0,1,0.0,0,0,,1,2,3,3,3,0,0,2,2,5.9,-4.0,Otto Porter Jr.,1,2,0.5
1426,11/7/2022,29.43013698630137,L,0,17.216666666666665,2,4,0.5,0,1,0.0,1,1,1.0,0,0,0,1,0,0,0,0,5,3.7,-14.0,Otto Porter Jr.,2,3,0.6666666666666666
1427,11/9/2022,29.435616438356163,W,0,23.466666666666665,5,8,0.625,2,5,0.4,2,2,1.0,3,3,6,0,1,0,2,1,14,12.0,3.0,Otto Porter Jr.,3,3,1.0
1428,11/11/2022,29.44109589041096,L,0,17.216666666666665,2,5,0.4,1,3,0.333,1,1,1.0,0,1,1,1,1,0,0,2,6,4.5,-12.0,Otto Porter Jr.,1,2,0.5
1429,11/12/2022,29.443835616438356,L,1,26.533333333333335,2,3,0.667,0,1,0.0,2,2,1.0,2,3,5,3,2,0,1,1,6,9.7,-13.0,Otto Porter Jr.,2,2,1.0
1430,11/14/2022,29.44931506849315,W,1,12.05,0,2,0.0,0,1,0.0,0,0,,0,1,1,0,0,0,1,0,0,-2.1,3.0,Otto Porter Jr.,0,1,0.0
1431,10/31/2022,25.476712328767125,W,0,5.366666666666666,2,2,1.0,0,0,,0,0,,0,1,1,1,0,0,0,0,4,4.4,1.0,Jeff Dowtin,2,2,1.0
1432,11/2/2022,25.482191780821918,W,0,3.0,0,2,0.0,0,0,,0,0,,0,0,0,1,0,0,0,0,0,-0.7,-2.0,Jeff Dowtin,0,2,0.0
1433,11/14/2022,25.515068493150686,W,0,15.016666666666667,2,3,0.667,0,1,0.0,0,0,,2,2,4,2,0,1,1,2,4,5.0,-5.0,Jeff Dowtin,2,2,1.0
1434,11/19/2022,25.528767123287672,L,0,3.6833333333333336,0,0,,0,0,,0,0,,0,0,0,0,0,0,0,0,0,0.0,9.0,Jeff Dowtin,0,0,
1435,11/23/2022,25.53972602739726,L,0,21.2,4,9,0.444,1,3,0.333,1,1,1.0,0,2,2,1,0,0,0,1,10,6.2,8.0,Jeff Dowtin,3,6,0.5
1436,11/26/2022,25.54794520547945,W,0,11.733333333333333,1,1,1.0,0,0,,0,0,,2,1,3,3,0,0,0,1,2,5.1,-5.0,Jeff Dowtin,1,1,1.0
1437,10/28/2022,21.33150684931507,L,0,3.2333333333333334,1,1,1.0,0,0,,0,0,,1,0,1,0,0,0,0,0,2,2.4,-1.0,Justin Champagnie,1,1,1.0
1438,10/31/2022,21.339726027397262,W,0,5.366666666666666,2,2,1.0,0,0,,0,0,,0,2,2,0,0,0,0,1,4,3.6,1.0,Justin Champagnie,2,2,1.0
1439,10/31/2022,22.553424657534247,W,0,3.15,0,1,0.0,0,1,0.0,0,0,,0,0,0,0,0,0,0,0,0,-0.7,-1.0,Ron Harper Jr.,0,0,
1440,11/23/2022,22.616438356164384,L,0,4.666666666666667,2,3,0.667,2,2,1.0,0,0,,0,1,1,0,0,0,0,0,6,5.0,6.0,Ron Harper Jr.,0,1,0.0
1441,10/18/2022,29.336986301369862,L,0,12.15,1,4,0.25,1,3,0.333,0,0,,0,0,0,1,0,0,0,1,3,0.9,-5.0,Georges Niang,0,1,0.0
1442,10/20/2022,29.34246575342466,L,0,8.133333333333333,0,1,0.0,0,1,0.0,0,0,,0,1,1,0,0,0,0,0,0,-0.4,0.0,Georges Niang,0,0,
1443,10/22/2022,29.34794520547945,L,0,15.033333333333333,3,4,0.75,2,3,0.667,0,0,,0,0,0,0,0,0,1,1,8,5.0,-8.0,Georges Niang,1,1,1.0
1444,10/24/2022,29.353424657534248,W,0,21.483333333333334,4,7,0.571,3,6,0.5,2,2,1.0,0,1,1,2,1,0,0,2,13,11.6,13.0,Georges Niang,1,1,1.0
1445,10/26/2022,29.35890410958904,L,0,14.316666666666666,1,4,0.25,1,4,0.25,0,0,,0,1,1,0,0,0,1,0,3,-0.1,-8.0,Georges Niang,0,0,
1446,10/28/2022,29.364383561643837,W,0,19.9,2,4,0.5,1,3,0.333,0,0,,0,5,5,0,0,1,2,4,5,1.6,10.0,Georges Niang,1,1,1.0
1447,10/29/2022,29.367123287671234,W,0,18.383333333333333,6,8,0.75,3,4,0.75,0,0,,1,2,3,0,0,0,0,3,15,11.9,6.0,Georges Niang,3,4,0.75
1448,10/31/2022,29.372602739726027,W,0,13.716666666666667,4,8,0.5,4,7,0.571,0,0,,0,2,2,1,0,0,1,1,12,7.9,7.0,Georges Niang,0,1,0.0
1449,11/2/2022,29.378082191780823,L,0,26.883333333333333,5,11,0.455,3,6,0.5,0,0,,1,2,3,0,0,1,0,4,13,7.7,-8.0,Georges Niang,2,5,0.4
1450,11/4/2022,29.383561643835616,L,0,19.083333333333332,2,8,0.25,2,7,0.286,0,0,,0,3,3,1,0,0,1,2,6,1.0,4.0,Georges Niang,0,1,0.0
1451,11/7/2022,29.39178082191781,W,0,27.05,7,11,0.636,7,10,0.7,0,0,,0,4,4,1,2,0,3,2,21,16.2,7.0,Georges Niang,0,1,0.0
1452,11/10/2022,29.4,L,0,23.333333333333332,2,8,0.25,1,7,0.143,4,4,1.0,0,1,1,2,1,1,0,3,9,6.4,-18.0,Georges Niang,1,1,1.0
1453,11/12/2022,29.405479452054795,W,0,14.283333333333333,1,2,0.5,1,2,0.5,1,1,1.0,0,0,0,2,0,2,1,2,4,4.0,-4.0,Georges Niang,0,0,
1454,11/13/2022,29.40821917808219,W,0,18.85,2,5,0.4,1,4,0.25,0,0,,1,1,2,0,1,1,0,0,5,5.0,-11.0,Georges Niang,1,1,1.0
1455,11/18/2022,29.421917808219177,W,0,30.433333333333334,6,11,0.545,4,8,0.5,1,1,1.0,0,3,3,0,1,0,2,2,17,10.8,3.0,Georges Niang,2,3,0.6666666666666666
1456,11/19/2022,29.424657534246574,L,0,32.38333333333333,5,12,0.417,1,7,0.143,4,4,1.0,1,1,2,1,1,0,1,4,15,8.7,10.0,Georges Niang,4,5,0.8
1457,11/22/2022,29.432876712328767,W,0,17.716666666666665,6,11,0.545,4,5,0.8,0,0,,0,5,5,2,0,1,0,3,16,13.1,5.0,Georges Niang,2,6,0.3333333333333333
1458,11/23/2022,29.435616438356163,L,0,18.683333333333334,3,10,0.3,3,8,0.375,0,0,,0,4,4,4,0,0,2,5,9,3.2,5.0,Georges Niang,0,2,0.0
1459,11/25/2022,29.44109589041096,W,0,23.083333333333332,6,8,0.75,5,7,0.714,1,2,0.5,0,1,1,2,0,0,1,1,18,14.7,-2.0,Georges Niang,1,1,1.0
1460,11/27/2022,29.446575342465753,W,0,19.716666666666665,4,9,0.444,1,5,0.2,0,1,0.0,0,4,4,5,1,0,0,4,9,8.0,10.0,Georges Niang,3,4,0.75
1461,10/18/2022,37.45479452054794,L,1,33.016666666666666,3,5,0.6,0,2,0.0,0,0,,2,2,4,0,0,1,2,2,6,3.6,-6.0,P.J. Tucker,3,3,1.0
1462,10/20/2022,37.46027397260274,L,1,39.18333333333333,1,3,0.333,1,2,0.5,2,2,1.0,4,1,5,1,2,1,1,4,5,7.2,-4.0,P.J. Tucker,0,1,0.0
1463,10/22/2022,37.465753424657535,L,1,28.6,1,2,0.5,1,2,0.5,0,0,,0,4,4,1,1,0,1,1,3,3.5,4.0,P.J. Tucker,0,0,
1464,10/24/2022,37.47123287671233,W,1,20.45,1,1,1.0,1,1,1.0,0,0,,1,2,3,1,0,0,0,2,3,3.9,-7.0,P.J. Tucker,0,0,
1465,10/26/2022,37.47671232876712,L,1,31.45,3,10,0.3,2,5,0.4,0,0,,1,3,4,0,0,0,1,1,8,2.4,1.0,P.J. Tucker,1,5,0.2
1466,10/28/2022,37.48219178082192,W,1,22.55,2,3,0.667,1,1,1.0,0,0,,2,3,5,1,1,0,0,4,5,6.1,15.0,P.J. Tucker,1,2,0.5
1467,10/29/2022,37.484931506849314,W,1,22.583333333333332,3,3,1.0,2,2,1.0,0,0,,0,6,6,0,0,2,4,4,8,4.7,1.0,P.J. Tucker,1,1,1.0
1468,10/31/2022,37.49041095890411,W,1,31.983333333333334,6,8,0.75,1,3,0.333,0,0,,2,3,5,1,1,0,1,3,13,11.6,-5.0,P.J. Tucker,5,5,1.0
1469,11/2/2022,37.49589041095891,L,1,28.1,2,2,1.0,1,1,1.0,0,0,,1,1,2,0,0,0,0,5,5,3.4,-4.0,P.J. Tucker,1,1,1.0
1470,11/4/2022,37.5013698630137,L,1,24.85,1,5,0.2,0,3,0.0,1,2,0.5,2,3,5,2,0,1,1,3,3,1.7,5.0,P.J. Tucker,1,2,0.5
1471,11/7/2022,37.50958904109589,W,1,29.85,2,2,1.0,0,0,,0,0,,2,6,8,1,0,1,1,1,4,6.6,11.0,P.J. Tucker,2,2,1.0
1472,11/10/2022,37.51780821917808,L,1,24.05,1,2,0.5,1,2,0.5,0,0,,0,3,3,0,0,1,1,1,3,2.2,1.0,P.J. Tucker,0,0,
1473,11/12/2022,37.52328767123288,W,1,31.116666666666667,1,1,1.0,0,0,,0,0,,1,5,6,2,2,0,1,3,2,5.1,18.0,P.J. Tucker,1,1,1.0
1474,11/13/2022,37.52602739726027,W,1,29.75,0,0,,0,0,,0,0,,0,1,1,1,1,0,1,2,0,0.2,13.0,P.J. Tucker,0,0,
1475,11/18/2022,37.53972602739726,W,1,32.35,0,1,0.0,0,1,0.0,0,0,,1,3,4,2,1,0,2,4,0,-0.3,11.0,P.J. Tucker,0,0,
1476,11/19/2022,37.54246575342466,L,1,33.483333333333334,0,1,0.0,0,0,,0,0,,0,5,5,1,0,0,2,3,0,-1.7,9.0,P.J. Tucker,0,1,0.0
1477,11/22/2022,37.55068493150685,W,1,37.06666666666667,0,6,0.0,0,2,0.0,0,0,,3,2,5,3,3,0,0,1,0,3.2,12.0,P.J. Tucker,0,4,0.0
1478,11/23/2022,37.553424657534244,L,1,33.68333333333333,1,4,0.25,1,3,0.333,0,0,,2,5,7,1,1,0,1,3,3,3.0,-6.0,P.J. Tucker,0,1,0.0
1479,11/25/2022,37.558904109589044,W,1,25.233333333333334,0,3,0.0,0,1,0.0,0,0,,2,3,5,1,0,0,1,1,0,-0.5,3.0,P.J. Tucker,0,2,0.0
1480,11/27/2022,37.56438356164384,W,1,15.8,0,0,,0,0,,0,0,,0,2,2,1,0,0,0,2,0,0.5,13.0,P.J. Tucker,0,0,
1481,10/18/2022,30.26027397260274,L,1,34.233333333333334,7,14,0.5,3,6,0.5,1,2,0.5,1,1,2,0,3,0,0,3,18,13.4,-1.0,Tobias Harris,4,8,0.5
1482,10/20/2022,30.265753424657536,L,1,33.38333333333333,4,10,0.4,1,4,0.25,0,0,,1,9,10,2,1,2,1,2,9,9.0,2.0,Tobias Harris,3,6,0.5
1483,10/22/2022,30.27123287671233,L,1,35.666666666666664,6,11,0.545,3,6,0.5,0,0,,0,4,4,2,0,0,1,2,15,10.5,-6.0,Tobias Harris,3,5,0.6
1484,10/24/2022,30.276712328767122,W,1,28.55,7,14,0.5,4,10,0.4,0,0,,2,6,8,2,1,1,0,3,18,16.1,14.0,Tobias Harris,3,4,0.75
1485,10/26/2022,30.28219178082192,L,1,34.25,1,5,0.2,1,3,0.333,0,0,,2,6,8,6,1,0,1,3,3,6.1,0.0,Tobias Harris,0,2,0.0
1486,10/28/2022,30.28767123287671,W,1,28.0,5,14,0.357,2,8,0.25,1,1,1.0,1,4,5,3,2,0,1,2,13,9.4,12.0,Tobias Harris,3,6,0.5
1487,10/29/2022,30.29041095890411,W,1,31.166666666666668,4,6,0.667,3,4,0.75,2,2,1.0,2,3,5,3,1,2,1,1,13,15.8,-2.0,Tobias Harris,1,2,0.5
1488,10/31/2022,30.295890410958904,W,1,34.28333333333333,6,10,0.6,1,3,0.333,3,7,0.429,0,5,5,1,4,1,0,3,16,15.5,0.0,Tobias Harris,5,7,0.7142857142857143
1489,11/2/2022,30.301369863013697,L,1,33.916666666666664,6,12,0.5,4,5,0.8,0,0,,2,7,9,4,0,0,1,1,16,14.9,-7.0,Tobias Harris,2,7,0.2857142857142857
1490,11/4/2022,30.306849315068494,L,1,37.45,9,15,0.6,3,7,0.429,2,2,1.0,2,7,9,4,1,2,2,2,23,22.0,-2.0,Tobias Harris,6,8,0.75
1491,11/7/2022,30.315068493150687,W,1,37.9,7,18,0.389,3,7,0.429,4,5,0.8,0,8,8,6,1,0,2,1,21,16.0,5.0,Tobias Harris,4,11,0.36363636363636365
1492,11/10/2022,30.323287671232876,L,1,33.53333333333333,5,15,0.333,0,4,0.0,2,2,1.0,0,2,2,3,5,0,1,1,12,9.8,-13.0,Tobias Harris,5,11,0.45454545454545453
1493,11/12/2022,30.328767123287673,W,1,38.53333333333333,7,13,0.538,1,3,0.333,6,6,1.0,1,5,6,2,2,0,2,2,21,17.5,5.0,Tobias Harris,6,10,0.6
1494,11/13/2022,30.33150684931507,W,1,31.55,4,12,0.333,0,3,0.0,0,0,,1,5,6,2,0,0,2,4,8,1.2,14.0,Tobias Harris,4,9,0.4444444444444444
1495,11/22/2022,30.356164383561644,W,1,33.75,10,21,0.476,1,3,0.333,3,4,0.75,1,5,6,3,0,0,3,2,24,13.4,8.0,Tobias Harris,9,18,0.5
1496,11/23/2022,30.35890410958904,L,1,37.38333333333333,9,20,0.45,1,9,0.111,0,0,,0,5,5,0,0,0,2,3,19,6.9,-6.0,Tobias Harris,8,11,0.7272727272727273
1497,11/25/2022,30.364383561643837,W,1,34.53333333333333,10,21,0.476,1,7,0.143,2,2,1.0,0,10,10,5,1,0,2,2,23,17.0,5.0,Tobias Harris,9,14,0.6428571428571429
1498,11/27/2022,30.36986301369863,W,1,29.716666666666665,10,14,0.714,2,2,1.0,3,3,1.0,0,5,5,5,2,1,1,2,25,25.1,20.0,Tobias Harris,8,12,0.6666666666666666
1499,10/18/2022,24.39178082191781,L,0,20.55,2,4,0.5,1,2,0.5,0,0,,0,0,0,0,1,0,0,2,5,3.2,-13.0,De'Anthony Melton,1,2,0.5
1500,10/20/2022,24.397260273972602,L,0,19.566666666666666,4,7,0.571,1,2,0.5,0,0,,0,2,2,0,1,0,0,0,9,7.3,5.0,De'Anthony Melton,3,5,0.6
1501,10/22/2022,24.4027397260274,L,0,15.583333333333334,0,3,0.0,0,2,0.0,0,0,,0,3,3,1,2,0,0,2,0,0.7,-7.0,De'Anthony Melton,0,1,0.0
1502,10/24/2022,24.40821917808219,W,0,17.0,3,6,0.5,2,4,0.5,3,3,1.0,0,5,5,1,1,0,0,1,11,10.8,11.0,De'Anthony Melton,1,2,0.5
1503,10/26/2022,24.413698630136988,L,0,21.683333333333334,5,7,0.714,2,4,0.5,0,0,,0,3,3,5,3,0,0,2,12,15.7,-13.0,De'Anthony Melton,3,3,1.0
1504,10/28/2022,24.41917808219178,W,1,30.75,6,15,0.4,1,5,0.2,0,0,,2,3,5,6,5,0,1,1,13,15.0,9.0,De'Anthony Melton,5,10,0.5
1505,10/29/2022,24.421917808219177,W,0,21.766666666666666,4,8,0.5,2,4,0.5,0,0,,0,3,3,4,1,1,1,0,10,10.4,-2.0,De'Anthony Melton,2,4,0.5
1506,10/31/2022,24.427397260273974,W,1,32.68333333333333,7,10,0.7,2,4,0.5,0,0,,0,2,2,1,2,0,1,3,16,12.9,-3.0,De'Anthony Melton,5,6,0.8333333333333334
1507,11/4/2022,24.438356164383563,L,1,30.283333333333335,4,18,0.222,3,11,0.273,1,2,0.5,4,1,5,9,2,2,3,2,12,9.6,0.0,De'Anthony Melton,1,7,0.14285714285714285
1508,11/7/2022,24.446575342465753,W,1,33.833333333333336,2,7,0.286,1,6,0.167,1,2,0.5,2,5,7,2,1,2,1,5,6,5.2,12.0,De'Anthony Melton,1,1,1.0
1509,11/10/2022,24.454794520547946,L,1,28.45,2,7,0.286,1,3,0.333,0,0,,4,6,10,1,0,0,3,0,5,3.2,-7.0,De'Anthony Melton,1,4,0.25
1510,11/13/2022,24.463013698630135,W,0,20.416666666666668,3,5,0.6,0,1,0.0,0,0,,2,4,6,2,0,1,1,1,6,7.0,-15.0,De'Anthony Melton,3,4,0.75
1511,11/18/2022,24.476712328767125,W,1,36.05,3,8,0.375,2,3,0.667,2,2,1.0,2,5,7,6,0,0,5,2,10,6.9,6.0,De'Anthony Melton,1,5,0.2
1512,11/19/2022,24.47945205479452,L,1,36.666666666666664,7,16,0.438,5,9,0.556,0,2,0.0,1,4,5,6,5,1,3,3,19,17.4,-2.0,De'Anthony Melton,2,7,0.2857142857142857
1513,11/22/2022,24.487671232876714,W,1,32.15,7,16,0.438,6,11,0.545,2,2,1.0,3,1,4,4,3,1,2,3,22,19.3,2.0,De'Anthony Melton,1,5,0.2
1514,11/23/2022,24.49041095890411,L,1,36.53333333333333,7,18,0.389,2,9,0.222,4,4,1.0,0,6,6,3,4,0,5,2,20,12.3,-1.0,De'Anthony Melton,5,9,0.5555555555555556
1515,11/25/2022,24.495890410958904,W,1,37.333333333333336,5,14,0.357,3,9,0.333,0,2,0.0,0,4,4,4,4,0,3,4,13,7.8,1.0,De'Anthony Melton,2,5,0.4
1516,11/27/2022,24.5013698630137,W,1,29.65,5,12,0.417,1,6,0.167,0,0,,1,2,3,2,3,1,3,1,11,7.6,14.0,De'Anthony Melton,4,6,0.6666666666666666
1517,10/18/2022,28.726027397260275,L,0,10.733333333333333,1,3,0.333,0,0,,0,0,,0,0,0,0,0,1,1,3,2,-1.2,4.0,Montrezl Harrell,1,3,0.3333333333333333
1518,10/20/2022,28.731506849315068,L,0,2.6,0,0,,0,0,,0,0,,0,0,0,0,0,0,0,0,0,0.0,-2.0,Montrezl Harrell,0,0,
1519,10/22/2022,28.736986301369864,L,0,9.233333333333333,0,0,,0,0,,0,0,,2,0,2,0,0,0,0,0,0,1.4,-12.0,Montrezl Harrell,0,0,
1520,10/24/2022,28.742465753424657,W,0,10.616666666666667,0,2,0.0,0,0,,5,6,0.833,0,0,0,0,0,1,0,1,5,3.5,7.0,Montrezl Harrell,0,2,0.0
1521,10/26/2022,28.747945205479454,L,0,4.25,0,0,,0,0,,0,2,0.0,0,1,1,0,0,0,0,0,0,-0.5,-4.0,Montrezl Harrell,0,0,
1522,10/28/2022,28.753424657534246,W,0,17.366666666666667,4,4,1.0,0,0,,1,1,1.0,0,2,2,2,0,1,2,1,9,8.1,12.0,Montrezl Harrell,4,4,1.0
1523,10/29/2022,28.756164383561643,W,0,11.983333333333333,1,4,0.25,0,0,,1,2,0.5,2,2,4,2,1,0,0,2,3,3.8,10.0,Montrezl Harrell,1,4,0.25
1524,10/31/2022,28.76164383561644,W,0,13.566666666666666,3,6,0.5,0,0,,1,1,1.0,1,3,4,0,1,2,0,2,7,7.2,8.0,Montrezl Harrell,3,6,0.5
1525,11/2/2022,28.767123287671232,L,0,12.4,0,1,0.0,0,0,,0,0,,0,1,1,0,0,0,0,2,0,-1.2,-9.0,Montrezl Harrell,0,1,0.0
1526,11/4/2022,28.77260273972603,L,1,29.083333333333332,4,6,0.667,0,0,,6,8,0.75,1,6,7,1,1,0,0,1,14,14.4,-4.0,Montrezl Harrell,4,6,0.6666666666666666
1527,11/10/2022,28.78904109589041,L,0,3.4333333333333336,3,3,1.0,0,0,,2,3,0.667,1,1,2,0,1,0,0,1,8,8.3,7.0,Montrezl Harrell,3,3,1.0
1528,11/13/2022,28.797260273972604,W,0,5.616666666666667,2,3,0.667,0,0,,0,0,,1,1,2,0,0,1,2,1,4,2.0,-7.0,Montrezl Harrell,2,3,0.6666666666666666
1529,11/18/2022,28.81095890410959,W,0,4.95,0,0,,0,0,,1,4,0.25,1,0,1,0,0,0,0,0,1,0.5,-2.0,Montrezl Harrell,0,0,
1530,11/19/2022,28.813698630136987,L,0,7.15,1,1,1.0,0,0,,1,2,0.5,0,0,0,1,0,0,2,3,3,-0.2,-1.0,Montrezl Harrell,1,1,1.0
1531,11/22/2022,28.82191780821918,W,1,15.75,2,8,0.25,0,0,,2,2,1.0,6,1,7,0,0,0,1,1,6,4.3,-10.0,Montrezl Harrell,2,8,0.25
1532,11/23/2022,28.824657534246576,L,1,21.783333333333335,4,7,0.571,0,0,,8,8,1.0,2,5,7,1,0,0,1,2,16,14.5,-4.0,Montrezl Harrell,4,7,0.5714285714285714
1533,11/25/2022,28.83013698630137,W,1,28.0,5,8,0.625,0,0,,4,4,1.0,3,5,8,1,0,0,2,1,14,12.3,16.0,Montrezl Harrell,5,8,0.625
1534,11/27/2022,28.835616438356166,W,1,17.866666666666667,3,6,0.5,0,0,,3,4,0.75,0,7,7,1,0,2,0,1,9,9.4,2.0,Montrezl Harrell,3,6,0.5
1535,10/18/2022,29.364383561643837,L,0,16.2,0,2,0.0,0,1,0.0,1,2,0.5,0,1,1,1,2,0,1,2,1,0.4,-5.0,Danuel House Jr.,0,1,0.0
1536,10/20/2022,29.36986301369863,L,0,21.266666666666666,2,4,0.5,0,2,0.0,0,0,,0,3,3,2,0,0,1,0,4,3.3,3.0,Danuel House Jr.,2,2,1.0
1537,10/22/2022,29.375342465753423,L,0,16.766666666666666,1,2,0.5,0,1,0.0,0,0,,2,0,2,1,0,1,2,1,2,1.4,-8.0,Danuel House Jr.,1,1,1.0
1538,10/24/2022,29.38082191780822,W,0,20.0,2,4,0.5,1,3,0.333,1,2,0.5,1,1,2,2,0,0,0,2,6,5.2,15.0,Danuel House Jr.,1,1,1.0
1539,10/26/2022,29.386301369863013,L,0,14.716666666666667,1,3,0.333,1,2,0.5,0,0,,0,0,0,0,0,0,0,1,3,0.9,-10.0,Danuel House Jr.,0,1,0.0
1540,10/28/2022,29.39178082191781,W,0,10.5,0,1,0.0,0,1,0.0,0,0,,0,2,2,0,0,0,1,1,0,-1.5,3.0,Danuel House Jr.,0,0,
1541,10/29/2022,29.394520547945206,W,0,9.7,1,1,1.0,1,1,1.0,0,0,,0,0,0,0,0,0,1,1,3,1.3,-2.0,Danuel House Jr.,0,0,
1542,10/31/2022,29.4,W,0,15.316666666666666,0,0,,0,0,,2,2,1.0,0,2,2,1,0,0,0,0,2,3.3,10.0,Danuel House Jr.,0,0,
1543,11/2/2022,29.405479452054795,L,0,23.6,3,10,0.3,2,5,0.4,4,5,0.8,1,5,6,2,1,0,0,4,12,8.8,-10.0,Danuel House Jr.,1,5,0.2
1544,11/10/2022,29.427397260273974,L,0,19.033333333333335,3,3,1.0,1,1,1.0,1,1,1.0,0,0,0,0,1,1,0,3,8,7.6,-14.0,Danuel House Jr.,2,2,1.0
1545,11/12/2022,29.432876712328767,W,0,17.816666666666666,2,4,0.5,1,3,0.333,0,0,,0,1,1,0,2,1,0,1,5,5.6,-6.0,Danuel House Jr.,1,1,1.0
1546,11/13/2022,29.435616438356163,W,0,16.75,0,1,0.0,0,1,0.0,1,2,0.5,0,1,1,1,0,0,0,1,1,0.5,-4.0,Danuel House Jr.,0,0,
1547,11/18/2022,29.44931506849315,W,1,30.6,3,6,0.5,1,2,0.5,2,2,1.0,0,2,2,1,0,1,0,2,9,7.2,3.0,Danuel House Jr.,2,4,0.5
1548,11/19/2022,29.45205479452055,L,1,39.05,4,9,0.444,3,6,0.5,0,0,,0,7,7,1,0,0,2,2,11,6.3,-12.0,Danuel House Jr.,1,3,0.3333333333333333
1549,11/22/2022,29.46027397260274,W,0,9.483333333333333,0,1,0.0,0,1,0.0,0,0,,0,2,2,1,0,0,0,0,0,0.6,-1.0,Danuel House Jr.,0,0,
1550,11/23/2022,29.463013698630135,L,0,11.016666666666667,0,1,0.0,0,1,0.0,1,2,0.5,0,1,1,0,0,0,1,1,1,-1.2,-2.0,Danuel House Jr.,0,0,
1551,11/25/2022,29.46849315068493,W,0,13.633333333333333,1,2,0.5,0,1,0.0,0,0,,0,1,1,0,0,0,0,1,2,0.9,8.0,Danuel House Jr.,1,1,1.0
1552,11/27/2022,29.473972602739725,W,0,25.483333333333334,5,8,0.625,1,4,0.25,8,10,0.8,0,2,2,2,0,1,1,1,19,15.9,16.0,Danuel House Jr.,4,4,1.0
1553,10/20/2022,23.350684931506848,L,0,4.916666666666667,0,0,,0,0,,0,0,,0,1,1,0,0,0,0,1,0,-0.1,1.0,Paul Reed,0,0,
1554,10/24/2022,23.361643835616437,W,0,8.966666666666667,0,2,0.0,0,0,,0,0,,0,1,1,0,1,1,1,1,0,-0.8,-3.0,Paul Reed,0,2,0.0
1555,10/26/2022,23.367123287671234,L,0,2.9333333333333336,0,0,,0,0,,0,0,,0,0,0,0,0,0,0,1,0,-0.4,-4.0,Paul Reed,0,0,
1556,10/28/2022,23.372602739726027,W,0,2.25,0,0,,0,0,,0,0,,0,1,1,0,1,0,0,0,0,1.3,3.0,Paul Reed,0,0,
1557,10/31/2022,23.38082191780822,W,0,2.45,0,0,,0,0,,0,0,,0,0,0,0,1,0,0,0,0,1.0,4.0,Paul Reed,0,0,
1558,11/2/2022,23.386301369863013,L,0,5.816666666666666,1,3,0.333,0,0,,0,0,,1,1,2,1,0,0,0,1,2,1.6,4.0,Paul Reed,1,3,0.3333333333333333
1559,11/4/2022,23.39178082191781,L,0,18.2,1,2,0.5,0,0,,0,0,,0,4,4,0,6,2,1,4,2,7.0,-3.0,Paul Reed,1,2,0.5
1560,11/7/2022,23.4,W,0,11.433333333333334,1,1,1.0,0,0,,0,0,,2,2,4,0,1,0,1,4,2,2.1,2.0,Paul Reed,1,1,1.0
1561,11/10/2022,23.40821917808219,L,0,9.2,0,3,0.0,0,2,0.0,0,0,,1,2,3,0,1,1,0,3,0,-0.3,-14.0,Paul Reed,0,1,0.0
1562,11/12/2022,23.413698630136988,W,0,7.983333333333333,0,0,,0,0,,0,0,,0,1,1,0,0,0,0,4,0,-1.3,-10.0,Paul Reed,0,0,
1563,11/13/2022,23.416438356164385,W,0,4.75,0,2,0.0,0,0,,0,0,,1,0,1,0,0,1,0,1,0,-0.4,-7.0,Paul Reed,0,2,0.0
1564,11/18/2022,23.43013698630137,W,0,12.433333333333334,1,2,0.5,0,0,,0,0,,1,5,6,0,1,0,0,3,2,3.0,5.0,Paul Reed,1,2,0.5
1565,11/19/2022,23.432876712328767,L,0,12.433333333333334,1,1,1.0,0,0,,0,0,,1,4,5,3,1,0,0,3,2,5.5,-9.0,Paul Reed,1,1,1.0
1566,11/22/2022,23.44109589041096,W,0,31.216666666666665,7,9,0.778,0,0,,5,6,0.833,5,5,10,0,3,2,2,1,19,22.1,21.0,Paul Reed,7,9,0.7777777777777778
1567,11/23/2022,23.443835616438356,L,0,21.716666666666665,3,4,0.75,0,0,,0,0,,1,7,8,1,2,3,2,4,6,8.4,-7.0,Paul Reed,3,4,0.75
1568,11/25/2022,23.44931506849315,W,0,19.533333333333335,3,7,0.429,0,1,0.0,0,0,,5,2,7,2,1,0,0,6,6,6.4,-6.0,Paul Reed,3,6,0.5
1569,11/27/2022,23.454794520547946,W,0,30.133333333333333,6,6,1.0,0,0,,0,0,,3,10,13,3,1,2,5,4,12,13.2,28.0,Paul Reed,6,6,1.0
1570,10/24/2022,26.076712328767123,W,0,6.216666666666667,0,0,,0,0,,0,0,,0,1,1,1,0,0,0,1,0,0.6,4.0,Shake Milton,0,0,
1571,10/28/2022,26.087671232876712,W,0,8.833333333333334,1,4,0.25,0,0,,0,0,,0,0,0,1,0,0,0,1,2,-0.1,7.0,Shake Milton,1,4,0.25
1572,10/29/2022,26.09041095890411,W,0,6.916666666666667,3,5,0.6,0,1,0.0,0,0,,1,1,2,1,0,1,0,0,6,6.1,5.0,Shake Milton,3,4,0.75
1573,10/31/2022,26.095890410958905,W,0,7.483333333333333,0,1,0.0,0,0,,0,0,,1,1,2,1,0,0,2,1,0,-1.4,5.0,Shake Milton,0,1,0.0
1574,11/2/2022,26.101369863013698,L,0,15.366666666666667,2,5,0.4,1,2,0.5,0,0,,0,2,2,2,0,0,4,3,5,-0.9,-9.0,Shake Milton,1,3,0.3333333333333333
1575,11/4/2022,26.106849315068494,L,0,17.466666666666665,3,7,0.429,0,2,0.0,0,0,,1,2,3,2,0,0,1,4,6,2.4,3.0,Shake Milton,3,5,0.6
1576,11/7/2022,26.115068493150684,W,0,12.316666666666666,0,1,0.0,0,0,,2,2,1.0,0,1,1,0,0,0,2,1,2,-0.8,1.0,Shake Milton,0,1,0.0
1577,11/10/2022,26.123287671232877,L,0,17.65,2,5,0.4,0,1,0.0,1,2,0.5,2,5,7,1,0,0,2,1,5,3.1,-5.0,Shake Milton,2,4,0.5
1578,11/12/2022,26.12876712328767,W,0,20.516666666666666,5,8,0.625,0,1,0.0,1,2,0.5,0,2,2,3,0,0,1,2,11,7.9,-3.0,Shake Milton,5,7,0.7142857142857143
1579,11/13/2022,26.13150684931507,W,0,11.483333333333333,1,1,1.0,0,0,,0,0,,0,0,0,2,0,1,0,0,2,3.8,-6.0,Shake Milton,1,1,1.0
1580,11/18/2022,26.145205479452056,W,0,31.183333333333334,6,12,0.5,1,4,0.25,2,4,0.5,0,3,3,6,1,0,3,2,15,10.5,17.0,Shake Milton,5,8,0.625
1581,11/19/2022,26.147945205479452,L,1,38.05,10,15,0.667,3,5,0.6,4,4,1.0,0,6,6,2,0,0,6,3,27,16.5,-2.0,Shake Milton,7,10,0.7
1582,11/22/2022,26.156164383561645,W,1,36.416666666666664,7,14,0.5,2,3,0.667,0,0,,1,5,6,5,0,0,1,1,16,13.3,8.0,Shake Milton,5,11,0.45454545454545453
1583,11/23/2022,26.15890410958904,L,1,38.86666666666667,9,16,0.563,1,4,0.25,3,4,0.75,3,4,7,9,2,0,4,1,22,21.2,-1.0,Shake Milton,8,12,0.6666666666666666
1584,11/25/2022,26.164383561643834,W,1,41.81666666666667,7,13,0.538,4,7,0.571,6,6,1.0,2,7,9,10,1,1,4,2,24,25.1,14.0,Shake Milton,3,6,0.5
1585,11/27/2022,26.16986301369863,W,1,37.7,10,13,0.769,3,6,0.5,6,6,1.0,2,3,5,7,1,0,1,1,29,30.7,26.0,Shake Milton,7,7,1.0
1586,10/18/2022,25.624657534246577,L,0,0.38333333333333336,0,0,,0,0,,0,0,,0,0,0,0,0,0,0,0,0,0.0,-1.0,Matisse Thybulle,0,0,
1587,10/20/2022,25.63013698630137,L,0,0.3,0,0,,0,0,,0,0,,0,0,0,0,0,0,0,0,0,0.0,-3.0,Matisse Thybulle,0,0,
1588,10/22/2022,25.635616438356166,L,0,3.2333333333333334,0,1,0.0,0,1,0.0,0,0,,0,0,0,0,0,0,0,0,0,-0.7,-3.0,Matisse Thybulle,0,0,
1589,10/24/2022,25.64109589041096,W,0,2.0,0,0,,0,0,,0,0,,0,0,0,0,0,0,0,0,0,0.0,-4.0,Matisse Thybulle,0,0,
1590,10/28/2022,25.65205479452055,W,0,21.783333333333335,2,6,0.333,2,5,0.4,0,0,,1,2,3,3,1,2,0,0,6,8.4,1.0,Matisse Thybulle,0,1,0.0
1591,10/29/2022,25.654794520547945,W,0,20.566666666666666,1,2,0.5,0,0,,0,0,,0,0,0,0,1,0,0,3,2,0.8,2.0,Matisse Thybulle,1,2,0.5
1592,10/31/2022,25.660273972602738,W,0,16.483333333333334,0,1,0.0,0,1,0.0,1,2,0.5,0,5,5,0,2,0,1,2,1,1.6,5.0,Matisse Thybulle,0,0,
1593,11/2/2022,25.665753424657535,L,1,15.7,1,2,0.5,0,0,,0,1,0.0,0,0,0,2,1,0,0,2,2,2.2,4.0,Matisse Thybulle,1,2,0.5
1594,11/4/2022,25.671232876712327,L,0,13.05,2,5,0.4,0,2,0.0,0,0,,1,2,3,0,1,1,0,4,4,2.7,-10.0,Matisse Thybulle,2,3,0.6666666666666666
1595,11/7/2022,25.67945205479452,W,0,10.516666666666667,0,1,0.0,0,1,0.0,0,0,,1,0,1,1,0,1,0,1,0,1.0,4.0,Matisse Thybulle,0,0,
1596,11/10/2022,25.687671232876713,L,0,8.35,0,2,0.0,0,1,0.0,0,0,,0,0,0,0,1,0,1,1,0,-1.8,6.0,Matisse Thybulle,0,1,0.0
1597,11/12/2022,25.693150684931506,W,1,29.866666666666667,1,5,0.2,1,4,0.25,0,0,,0,2,2,0,1,0,0,2,3,0.7,15.0,Matisse Thybulle,0,1,0.0
1598,11/13/2022,25.695890410958903,W,1,27.45,1,2,0.5,0,1,0.0,0,0,,1,5,6,2,5,1,0,2,2,9.5,18.0,Matisse Thybulle,1,1,1.0
1599,11/18/2022,25.70958904109589,W,0,4.333333333333333,0,0,,0,0,,0,0,,0,0,0,0,0,0,0,1,0,-0.4,-7.0,Matisse Thybulle,0,0,
1600,11/19/2022,25.71232876712329,L,0,4.933333333333334,0,1,0.0,0,1,0.0,0,0,,0,0,0,0,0,0,0,0,0,-0.7,-6.0,Matisse Thybulle,0,0,
1601,11/22/2022,25.720547945205478,W,0,3.3666666666666667,1,3,0.333,1,3,0.333,0,0,,0,0,0,0,0,0,0,0,3,1.3,-5.0,Matisse Thybulle,0,0,
1602,10/18/2022,21.953424657534246,L,1,38.18333333333333,8,16,0.5,2,5,0.4,3,3,1.0,0,1,1,2,2,0,1,5,21,13.7,-6.0,Tyrese Maxey,6,11,0.5454545454545454
1603,10/20/2022,21.958904109589042,L,1,34.166666666666664,6,13,0.462,0,3,0.0,3,4,0.75,0,2,2,0,0,0,1,3,15,6.3,-7.0,Tyrese Maxey,6,10,0.6
1604,10/22/2022,21.964383561643835,L,1,39.63333333333333,8,18,0.444,3,8,0.375,6,9,0.667,1,2,3,6,1,0,3,3,25,16.7,-11.0,Tyrese Maxey,5,10,0.5
1605,10/24/2022,21.96986301369863,W,1,37.78333333333333,3,11,0.273,2,5,0.4,0,0,,1,1,2,3,1,0,2,0,8,3.6,4.0,Tyrese Maxey,1,6,0.16666666666666666
1606,10/26/2022,21.975342465753425,L,1,43.233333333333334,12,21,0.571,4,8,0.5,3,4,0.75,1,4,5,6,2,1,4,0,31,25.5,-1.0,Tyrese Maxey,8,13,0.6153846153846154
1607,10/28/2022,21.980821917808218,W,1,39.81666666666667,15,20,0.75,9,12,0.75,5,6,0.833,0,8,8,4,1,0,2,3,44,38.6,29.0,Tyrese Maxey,6,8,0.75
1608,10/29/2022,21.983561643835618,W,1,29.283333333333335,5,14,0.357,2,6,0.333,2,3,0.667,0,5,5,3,1,0,2,4,14,6.8,5.0,Tyrese Maxey,3,8,0.375
1609,10/31/2022,21.98904109589041,W,1,34.416666666666664,12,22,0.545,2,6,0.333,2,2,1.0,0,3,3,3,1,0,3,3,28,17.2,-4.0,Tyrese Maxey,10,16,0.625
1610,11/2/2022,21.994520547945207,L,1,43.15,11,20,0.55,5,9,0.556,5,8,0.625,0,2,2,4,0,0,0,1,32,24.2,-2.0,Tyrese Maxey,6,11,0.5454545454545454
1611,11/4/2022,22.0,L,1,39.05,10,29,0.345,4,13,0.308,7,7,1.0,1,2,3,7,1,0,4,3,31,16.7,2.0,Tyrese Maxey,6,16,0.375
1612,11/7/2022,22.008219178082193,W,1,40.333333333333336,4,18,0.222,0,4,0.0,3,6,0.5,1,4,5,6,0,1,2,0,11,3.6,8.0,Tyrese Maxey,4,14,0.2857142857142857
1613,11/10/2022,22.016438356164382,L,1,33.266666666666666,5,17,0.294,2,6,0.333,3,4,0.75,1,3,4,5,0,0,1,2,15,8.0,-9.0,Tyrese Maxey,3,11,0.2727272727272727
1614,11/12/2022,22.02191780821918,W,1,35.916666666666664,10,18,0.556,3,5,0.6,3,4,0.75,0,2,2,9,1,0,3,4,26,20.3,24.0,Tyrese Maxey,7,13,0.5384615384615384
1615,11/13/2022,22.024657534246575,W,1,36.7,8,24,0.333,2,8,0.25,0,0,,0,3,3,3,4,1,1,4,18,9.5,15.0,Tyrese Maxey,6,16,0.375
1616,11/18/2022,22.03835616438356,W,1,20.833333333333332,9,12,0.75,3,4,0.75,3,5,0.6,0,4,4,5,0,1,1,0,24,22.8,-4.0,Tyrese Maxey,6,8,0.75
1617,10/18/2022,28.59178082191781,L,1,37.266666666666666,9,18,0.5,1,6,0.167,7,9,0.778,1,14,15,5,0,1,6,4,26,17.7,-13.0,Joel Embiid,8,12,0.6666666666666666
1618,10/20/2022,28.5972602739726,L,1,36.15,6,21,0.286,1,3,0.333,2,3,0.667,1,11,12,3,0,1,4,2,15,4.3,-10.0,Joel Embiid,5,18,0.2777777777777778
1619,10/22/2022,28.602739726027398,L,1,35.95,14,25,0.56,0,2,0.0,12,15,0.8,3,10,13,3,1,2,2,2,40,33.7,6.0,Joel Embiid,14,23,0.6086956521739131
1620,10/24/2022,28.60821917808219,W,1,28.283333333333335,8,13,0.615,1,3,0.333,9,9,1.0,1,4,5,2,1,3,3,5,26,21.5,8.0,Joel Embiid,7,10,0.7
1621,10/26/2022,28.613698630136987,L,1,37.516666666666666,12,17,0.706,2,4,0.5,5,7,0.714,0,5,5,3,0,0,2,2,31,23.9,-5.0,Joel Embiid,10,13,0.7692307692307693
1622,10/29/2022,28.621917808219177,W,1,31.65,9,15,0.6,1,2,0.5,6,9,0.667,2,5,7,4,1,0,5,4,25,17.0,5.0,Joel Embiid,8,13,0.6153846153846154
1623,11/7/2022,28.646575342465752,W,1,36.71666666666667,8,21,0.381,1,4,0.25,16,16,1.0,7,3,10,5,0,1,3,2,33,27.7,10.0,Joel Embiid,7,17,0.4117647058823529
1624,11/10/2022,28.654794520547945,L,1,31.75,9,18,0.5,0,3,0.0,8,10,0.8,0,13,13,2,0,1,8,5,26,12.2,10.0,Joel Embiid,9,15,0.6
1625,11/12/2022,28.660273972602738,W,1,40.016666666666666,14,25,0.56,1,6,0.167,13,16,0.813,0,10,10,6,2,2,4,5,42,33.5,22.0,Joel Embiid,13,19,0.6842105263157895
1626,11/13/2022,28.663013698630138,W,1,36.68333333333333,19,28,0.679,1,5,0.2,20,24,0.833,1,10,11,8,1,7,5,3,59,54.4,25.0,Joel Embiid,18,23,0.782608695652174
1627,11/18/2022,28.676712328767124,W,1,36.833333333333336,12,26,0.462,2,6,0.333,6,8,0.75,1,10,11,8,1,3,5,2,32,24.4,8.0,Joel Embiid,10,20,0.5
1628,11/19/2022,28.67945205479452,L,1,35.85,6,15,0.4,2,4,0.5,18,20,0.9,1,8,9,6,3,0,6,3,32,26.2,-2.0,Joel Embiid,4,11,0.36363636363636365
1629,10/18/2022,33.14520547945205,L,1,37.28333333333333,9,14,0.643,5,9,0.556,12,12,1.0,0,8,8,7,0,0,3,3,35,31.9,1.0,James Harden,4,5,0.8
1630,10/20/2022,33.15068493150685,L,1,40.333333333333336,13,24,0.542,1,7,0.143,4,4,1.0,0,8,8,9,2,1,2,2,31,28.0,5.0,James Harden,12,17,0.7058823529411765
1631,10/22/2022,33.156164383561645,L,1,40.3,4,18,0.222,1,6,0.167,3,4,0.75,4,5,9,12,1,2,2,3,12,12.5,0.0,James Harden,3,12,0.25
1632,10/24/2022,33.16164383561644,W,1,34.65,10,18,0.556,5,10,0.5,4,4,1.0,0,9,9,11,2,0,1,2,29,31.0,16.0,James Harden,5,8,0.625
1633,10/26/2022,33.16712328767123,L,1,35.65,5,12,0.417,3,6,0.5,5,6,0.833,0,7,7,9,0,1,3,2,18,16.5,-6.0,James Harden,2,6,0.3333333333333333
1634,10/28/2022,33.172602739726024,W,1,33.71666666666667,4,9,0.444,0,3,0.0,3,3,1.0,1,3,4,4,0,2,5,2,11,6.3,3.0,James Harden,4,6,0.6666666666666666
1635,10/29/2022,33.175342465753424,W,1,36.0,2,13,0.154,0,5,0.0,11,11,1.0,0,6,6,11,2,0,3,0,15,15.2,-3.0,James Harden,2,8,0.25
1636,10/31/2022,33.18082191780822,W,1,37.61666666666667,8,17,0.471,2,6,0.333,5,6,0.833,0,7,7,17,2,0,4,2,23,25.1,8.0,James Harden,6,11,0.5454545454545454
1637,11/2/2022,33.18630136986302,L,1,35.06666666666667,8,18,0.444,3,8,0.375,5,6,0.833,0,5,5,10,1,0,3,2,24,19.9,-9.0,James Harden,5,10,0.5
1638,10/24/2022,25.252054794520546,W,0,2.0,0,1,0.0,0,1,0.0,0,0,,0,0,0,0,0,0,0,0,0,-0.7,-4.0,Furkan Korkmaz,0,0,
1639,10/28/2022,25.263013698630136,W,0,2.25,0,0,,0,0,,0,0,,0,1,1,1,0,0,0,0,0,1.0,3.0,Furkan Korkmaz,0,0,
1640,11/4/2022,25.28219178082192,L,0,11.483333333333333,1,3,0.333,1,2,0.5,0,0,,1,1,2,1,0,0,2,0,3,1.0,-5.0,Furkan Korkmaz,0,1,0.0
1641,11/10/2022,25.2986301369863,L,0,7.95,0,0,,0,0,,4,4,1.0,0,0,0,1,0,0,0,1,4,4.3,11.0,Furkan Korkmaz,0,0,
1642,11/12/2022,25.304109589041097,W,0,3.95,3,4,0.75,0,0,,1,2,0.5,0,1,1,0,0,0,0,1,7,4.9,-1.0,Furkan Korkmaz,3,4,0.75
1643,11/22/2022,25.33150684931507,W,0,20.666666666666668,3,9,0.333,2,4,0.5,1,2,0.5,1,3,4,1,0,0,0,0,9,5.8,12.0,Furkan Korkmaz,1,5,0.2
1644,11/23/2022,25.334246575342465,L,0,20.333333333333332,2,6,0.333,1,4,0.25,0,0,,0,0,0,1,0,0,1,2,5,0.5,-8.0,Furkan Korkmaz,1,2,0.5
1645,11/25/2022,25.339726027397262,W,0,16.833333333333332,2,6,0.333,1,3,0.333,2,2,1.0,1,1,2,0,0,0,2,1,7,2.2,1.0,Furkan Korkmaz,1,3,0.3333333333333333
1646,11/27/2022,25.345205479452055,W,0,24.833333333333332,6,7,0.857,3,3,1.0,2,3,0.667,0,2,2,4,0,1,2,2,17,15.4,16.0,Furkan Korkmaz,3,4,0.75
1647,10/24/2022,20.07945205479452,W,0,2.0,0,1,0.0,0,0,,1,2,0.5,1,1,2,0,0,1,0,0,1,1.6,-4.0,Jaden Springer,0,1,0.0
1648,10/28/2022,20.09041095890411,W,0,2.25,2,2,1.0,0,0,,0,0,,0,0,0,0,0,0,0,1,4,3.0,3.0,Jaden Springer,2,2,1.0
1649,11/22/2022,21.4,W,0,1.3833333333333333,0,1,0.0,0,0,,0,0,,0,0,0,0,0,0,0,0,0,-0.7,-5.0,Julian Champagnie,0,1,0.0
1650,11/27/2022,21.413698630136988,W,0,5.283333333333333,0,1,0.0,0,1,0.0,0,0,,0,0,0,0,1,0,0,0,0,0.3,1.0,Julian Champagnie,0,0,
1651,11/22/2022,19.84931506849315,W,0,1.0333333333333334,0,0,,0,0,,0,0,,0,0,0,0,0,0,0,0,0,0.0,-2.0,Michael Foster Jr.,0,0,
1652,10/19/2022,34.054794520547944,L,1,31.766666666666666,11,21,0.524,2,6,0.333,8,9,0.889,0,3,3,2,1,4,4,4,32,21.8,-23.0,Kevin Durant,9,15,0.6
1653,10/21/2022,34.06027397260274,W,1,35.45,8,18,0.444,3,9,0.333,8,10,0.8,1,4,5,6,0,2,5,2,27,18.5,-8.0,Kevin Durant,5,9,0.5555555555555556
1654,10/24/2022,34.06849315068493,L,1,39.016666666666666,14,20,0.7,1,3,0.333,8,9,0.889,1,4,5,4,0,0,1,4,37,30.3,-10.0,Kevin Durant,13,17,0.7647058823529411
1655,10/26/2022,34.07397260273972,L,1,38.86666666666667,10,23,0.435,1,4,0.25,12,13,0.923,0,6,6,3,0,2,5,3,33,19.6,-17.0,Kevin Durant,9,19,0.47368421052631576
1656,10/27/2022,34.07671232876712,L,1,41.233333333333334,12,21,0.571,2,5,0.4,11,11,1.0,1,2,3,5,2,1,3,2,37,30.8,-6.0,Kevin Durant,10,16,0.625
1657,10/29/2022,34.082191780821915,L,1,38.78333333333333,8,20,0.4,1,5,0.2,9,9,1.0,1,4,5,2,3,4,3,0,26,21.3,-3.0,Kevin Durant,7,15,0.4666666666666667
1658,10/31/2022,34.087671232876716,W,1,39.06666666666667,13,22,0.591,2,5,0.4,8,8,1.0,0,9,9,7,1,1,3,2,36,31.3,8.0,Kevin Durant,11,17,0.6470588235294118
1659,11/1/2022,34.09041095890411,L,1,37.983333333333334,9,16,0.563,2,4,0.5,12,12,1.0,0,9,9,6,1,2,7,3,32,25.5,-7.0,Kevin Durant,7,12,0.5833333333333334
1660,11/4/2022,34.0986301369863,W,1,33.18333333333333,10,21,0.476,2,6,0.333,6,6,1.0,0,9,9,11,0,1,2,1,28,26.0,35.0,Kevin Durant,8,15,0.5333333333333333
1661,11/5/2022,34.1013698630137,W,1,37.333333333333336,10,20,0.5,1,4,0.25,6,6,1.0,0,8,8,2,0,3,3,2,27,19.1,13.0,Kevin Durant,9,16,0.5625
1662,11/7/2022,34.106849315068494,L,1,38.666666666666664,10,20,0.5,1,3,0.333,5,7,0.714,1,3,4,4,2,1,3,5,26,17.3,1.0,Kevin Durant,9,17,0.5294117647058824
1663,11/9/2022,34.11232876712329,W,1,34.53333333333333,10,19,0.526,1,5,0.2,8,10,0.8,1,11,12,12,1,2,1,1,29,32.3,32.0,Kevin Durant,9,14,0.6428571428571429
1664,11/12/2022,34.12054794520548,W,1,34.53333333333333,10,16,0.625,3,5,0.6,4,4,1.0,0,6,6,3,2,2,3,4,27,22.5,16.0,Kevin Durant,7,11,0.6363636363636364
1665,11/13/2022,34.12328767123287,L,1,37.833333333333336,8,16,0.5,2,3,0.667,13,15,0.867,0,9,9,7,0,2,3,2,31,27.4,-15.0,Kevin Durant,6,13,0.46153846153846156
1666,11/15/2022,34.12876712328767,L,1,30.65,8,15,0.533,0,1,0.0,11,11,1.0,0,4,4,6,0,1,2,2,27,23.0,-31.0,Kevin Durant,8,14,0.5714285714285714
1667,11/17/2022,34.134246575342466,W,1,38.8,13,22,0.591,1,4,0.25,8,10,0.8,0,8,8,3,0,1,4,4,35,23.6,15.0,Kevin Durant,12,18,0.6666666666666666
1668,11/20/2022,34.14246575342466,W,1,35.68333333333333,9,16,0.563,0,3,0.0,8,8,1.0,0,7,7,7,1,1,4,3,26,21.9,5.0,Kevin Durant,9,13,0.6923076923076923
1669,11/22/2022,34.14794520547945,L,1,36.766666666666666,9,14,0.643,0,1,0.0,2,2,1.0,0,5,5,5,0,2,3,0,20,17.2,-10.0,Kevin Durant,9,13,0.6923076923076923
1670,11/23/2022,34.15068493150685,W,1,32.8,5,10,0.5,2,5,0.4,0,0,,0,7,7,5,0,3,4,2,12,9.9,30.0,Kevin Durant,3,5,0.6
1671,11/25/2022,34.156164383561645,L,1,38.833333333333336,15,31,0.484,3,12,0.25,3,4,0.75,2,7,9,8,0,2,5,4,36,23.8,0.0,Kevin Durant,12,19,0.631578947368421
1672,11/27/2022,34.16164383561644,W,1,36.68333333333333,12,20,0.6,3,6,0.5,4,4,1.0,0,5,5,5,0,0,1,4,31,24.2,21.0,Kevin Durant,9,14,0.6428571428571429
1673,10/19/2022,29.372602739726027,L,1,34.15,4,7,0.571,2,3,0.667,0,0,,1,6,7,3,3,2,0,4,10,14.1,-27.0,Royce O'Neale,2,4,0.5
1674,10/21/2022,29.378082191780823,W,1,39.3,2,7,0.286,1,4,0.25,2,2,1.0,0,4,4,3,2,2,2,2,7,6.8,-5.0,Royce O'Neale,1,3,0.3333333333333333
1675,10/24/2022,29.386301369863013,L,1,35.71666666666667,3,12,0.25,2,7,0.286,0,0,,1,2,3,4,1,2,0,3,8,6.1,-9.0,Royce O'Neale,1,5,0.2
1676,10/26/2022,29.39178082191781,L,1,37.05,4,13,0.308,4,9,0.444,0,0,,0,0,0,0,2,0,2,4,12,2.9,-3.0,Royce O'Neale,0,4,0.0
1677,10/27/2022,29.394520547945206,L,1,40.75,4,11,0.364,2,8,0.25,0,0,,1,6,7,1,1,0,2,5,10,4.1,11.0,Royce O'Neale,2,3,0.6666666666666666
1678,10/29/2022,29.4,L,1,37.78333333333333,4,7,0.571,3,6,0.5,0,0,,0,1,1,5,0,0,0,4,11,9.9,-12.0,Royce O'Neale,1,1,1.0
1679,10/31/2022,29.405479452054795,W,1,36.81666666666667,3,9,0.333,2,6,0.333,0,0,,2,6,8,5,1,1,2,4,8,7.7,12.0,Royce O'Neale,1,3,0.3333333333333333
1680,11/1/2022,29.40821917808219,L,1,33.7,8,12,0.667,4,6,0.667,0,0,,2,3,5,3,1,0,1,3,20,18.0,-11.0,Royce O'Neale,4,6,0.6666666666666666
1681,11/4/2022,29.416438356164385,W,1,28.783333333333335,5,9,0.556,3,5,0.6,0,0,,1,2,3,8,1,0,0,3,13,15.4,22.0,Royce O'Neale,2,4,0.5
1682,11/5/2022,29.41917808219178,W,1,38.083333333333336,1,9,0.111,1,5,0.2,3,4,0.75,1,3,4,5,0,0,0,3,6,3.6,2.0,Royce O'Neale,0,4,0.0
1683,11/7/2022,29.424657534246574,L,1,40.95,5,12,0.417,4,8,0.5,1,2,0.5,2,2,4,8,2,2,3,3,15,15.0,0.0,Royce O'Neale,1,4,0.25
1684,11/9/2022,29.43013698630137,W,1,33.88333333333333,2,7,0.286,2,4,0.5,0,0,,4,6,10,5,2,0,1,3,6,9.8,44.0,Royce O'Neale,0,3,0.0
1685,11/12/2022,29.438356164383563,W,1,34.53333333333333,3,11,0.273,3,6,0.5,3,4,0.75,1,4,5,3,1,0,3,3,12,5.9,16.0,Royce O'Neale,0,5,0.0
1686,11/13/2022,29.44109589041096,L,1,37.233333333333334,2,8,0.25,1,4,0.25,1,2,0.5,0,4,4,4,2,0,1,4,6,4.2,-13.0,Royce O'Neale,1,4,0.25
1687,11/15/2022,29.446575342465753,L,1,24.133333333333333,1,4,0.25,1,4,0.25,0,0,,0,2,2,1,0,0,3,1,3,-1.5,-40.0,Royce O'Neale,0,0,
1688,11/17/2022,29.45205479452055,W,1,37.31666666666667,5,14,0.357,1,7,0.143,0,0,,1,9,10,11,0,1,2,3,11,11.8,-1.0,Royce O'Neale,4,7,0.5714285714285714
1689,11/20/2022,29.46027397260274,W,1,31.483333333333334,4,6,0.667,4,6,0.667,0,0,,0,5,5,8,0,1,1,4,12,14.6,12.0,Royce O'Neale,0,0,
1690,11/22/2022,29.465753424657535,L,1,39.11666666666667,4,4,1.0,3,3,1.0,0,0,,0,7,7,6,0,2,5,3,11,11.3,-13.0,Royce O'Neale,1,1,1.0
1691,11/23/2022,29.46849315068493,W,1,27.416666666666668,5,8,0.625,5,8,0.625,0,0,,0,4,4,7,4,0,3,3,15,17.3,16.0,Royce O'Neale,0,0,
1692,11/25/2022,29.473972602739725,L,1,40.733333333333334,3,8,0.375,3,7,0.429,0,0,,0,4,4,3,1,0,5,1,9,3.5,-11.0,Royce O'Neale,0,1,0.0
1693,11/27/2022,29.47945205479452,W,1,38.45,2,5,0.4,0,2,0.0,3,4,0.75,0,5,5,4,0,1,0,5,7,6.9,6.0,Royce O'Neale,2,3,0.6666666666666666
1694,10/19/2022,23.506849315068493,L,1,24.783333333333335,6,7,0.857,0,0,,1,2,0.5,3,7,10,0,1,2,4,3,13,11.5,-15.0,Nic Claxton,6,7,0.8571428571428571
1695,10/21/2022,23.512328767123286,W,1,33.833333333333336,8,11,0.727,0,0,,3,8,0.375,7,4,11,0,1,4,0,2,19,21.6,9.0,Nic Claxton,8,11,0.7272727272727273
1696,10/24/2022,23.52054794520548,L,1,33.1,7,10,0.7,0,0,,2,2,1.0,2,5,7,0,0,2,0,4,16,14.5,-2.0,Nic Claxton,7,10,0.7
1697,10/26/2022,23.526027397260275,L,1,23.433333333333334,1,4,0.25,0,0,,1,2,0.5,4,4,8,1,0,2,1,3,3,4.1,-10.0,Nic Claxton,1,4,0.25
1698,10/27/2022,23.528767123287672,L,1,28.666666666666668,3,7,0.429,0,1,0.0,1,4,0.25,3,3,6,1,0,0,1,1,7,4.4,3.0,Nic Claxton,3,6,0.5
1699,10/29/2022,23.534246575342465,L,1,22.083333333333332,4,6,0.667,0,0,,0,3,0.0,2,7,9,0,1,2,0,2,8,9.3,-6.0,Nic Claxton,4,6,0.6666666666666666
1700,10/31/2022,23.53972602739726,W,1,31.033333333333335,9,11,0.818,0,0,,1,2,0.5,3,6,9,4,1,4,4,4,19,19.4,17.0,Nic Claxton,9,11,0.8181818181818182
1701,11/1/2022,23.542465753424658,L,1,34.583333333333336,4,4,1.0,0,0,,2,4,0.5,0,10,10,2,0,1,3,2,10,9.3,-4.0,Nic Claxton,4,4,1.0
1702,11/4/2022,23.55068493150685,W,1,28.25,9,10,0.9,0,0,,0,0,,2,7,9,1,0,3,0,2,18,20.1,32.0,Nic Claxton,9,10,0.9
1703,11/5/2022,23.553424657534247,W,1,25.433333333333334,5,7,0.714,0,0,,1,1,1.0,3,6,9,3,3,4,3,4,11,15.3,-8.0,Nic Claxton,5,7,0.7142857142857143
1704,11/7/2022,23.55890410958904,L,1,31.933333333333334,5,8,0.625,0,0,,0,0,,7,7,14,1,3,1,2,4,10,14.2,5.0,Nic Claxton,5,8,0.625
1705,11/9/2022,23.564383561643837,W,1,19.516666666666666,5,7,0.714,0,0,,2,5,0.4,1,5,6,2,0,1,2,4,12,8.6,14.0,Nic Claxton,5,7,0.7142857142857143
1706,11/12/2022,23.572602739726026,W,1,31.766666666666666,6,9,0.667,0,0,,1,5,0.2,2,12,14,2,1,3,0,1,13,16.6,14.0,Nic Claxton,6,9,0.6666666666666666
1707,11/13/2022,23.575342465753426,L,1,15.85,4,4,1.0,0,0,,0,2,0.0,2,3,5,0,0,0,1,2,8,6.5,-16.0,Nic Claxton,4,4,1.0
1708,11/15/2022,23.58082191780822,L,1,17.9,3,5,0.6,0,0,,0,0,,0,1,1,1,0,0,1,3,6,2.5,-30.0,Nic Claxton,3,5,0.6
1709,11/17/2022,23.586301369863016,W,1,25.333333333333332,5,8,0.625,0,0,,1,2,0.5,1,4,5,2,2,0,1,3,11,10.1,-16.0,Nic Claxton,5,8,0.625
1710,11/22/2022,23.6,L,1,21.266666666666666,6,7,0.857,0,0,,0,0,,0,4,4,0,0,3,0,3,12,11.6,1.0,Nic Claxton,6,7,0.8571428571428571
1711,11/23/2022,23.602739726027398,W,1,30.266666666666666,6,7,0.857,0,0,,2,2,1.0,4,8,12,3,1,4,4,2,14,17.8,24.0,Nic Claxton,6,7,0.8571428571428571
1712,11/25/2022,23.60821917808219,L,1,28.066666666666666,6,6,1.0,0,0,,0,0,,2,9,11,1,0,5,1,5,12,15.5,-21.0,Nic Claxton,6,6,1.0
1713,11/27/2022,23.613698630136987,W,1,31.75,4,6,0.667,0,0,,4,6,0.667,2,5,7,2,2,1,2,3,12,12.4,12.0,Nic Claxton,4,6,0.6666666666666666
1714,10/19/2022,34.18904109589041,L,0,22.666666666666668,5,10,0.5,4,9,0.444,2,2,1.0,0,1,1,0,0,0,0,0,16,11.3,-2.0,Patty Mills,1,1,1.0
1715,10/21/2022,34.1945205479452,W,0,11.066666666666666,2,5,0.4,2,4,0.5,4,4,1.0,0,0,0,0,0,0,0,0,10,7.3,15.0,Patty Mills,0,1,0.0
1716,10/24/2022,34.202739726027396,L,0,19.233333333333334,2,4,0.5,2,4,0.5,0,0,,1,0,1,2,0,0,0,0,6,6.1,-7.0,Patty Mills,0,0,
1717,10/26/2022,34.20821917808219,L,0,17.733333333333334,0,2,0.0,0,2,0.0,0,0,,0,1,1,3,0,0,1,0,0,0.0,-7.0,Patty Mills,0,0,
1718,10/27/2022,34.21095890410959,L,0,16.733333333333334,1,3,0.333,1,2,0.5,0,0,,1,1,2,1,0,0,1,1,3,1.6,0.0,Patty Mills,0,1,0.0
1719,10/29/2022,34.21643835616438,L,0,6.533333333333333,2,3,0.667,1,2,0.5,3,3,1.0,0,0,0,0,0,0,0,1,8,6.3,0.0,Patty Mills,1,1,1.0
1720,10/31/2022,34.221917808219175,W,0,5.6,0,1,0.0,0,1,0.0,0,0,,0,0,0,0,1,0,0,0,0,0.3,2.0,Patty Mills,0,0,
1721,11/1/2022,34.224657534246575,L,0,9.65,3,6,0.5,2,4,0.5,1,1,1.0,0,1,1,0,0,0,0,3,9,5.1,-4.0,Patty Mills,1,2,0.5
1722,11/4/2022,34.23287671232877,W,0,16.316666666666666,2,4,0.5,1,2,0.5,0,0,,0,1,1,1,1,1,0,1,5,5.3,16.0,Patty Mills,1,2,0.5
1723,11/5/2022,34.23561643835617,W,0,13.183333333333334,4,6,0.667,3,5,0.6,0,0,,0,0,0,2,0,0,1,1,11,8.4,-9.0,Patty Mills,1,1,1.0
1724,11/7/2022,34.24109589041096,L,0,7.983333333333333,0,2,0.0,0,2,0.0,0,0,,0,1,1,0,0,0,0,0,0,-1.1,-5.0,Patty Mills,0,0,
1725,11/9/2022,34.24657534246575,W,0,8.866666666666667,0,3,0.0,0,2,0.0,0,0,,0,1,1,1,0,0,0,0,0,-1.1,0.0,Patty Mills,0,1,0.0
1726,11/12/2022,34.25479452054795,W,0,11.55,2,5,0.4,2,4,0.5,0,0,,1,0,1,1,0,0,0,0,6,4.7,-3.0,Patty Mills,0,1,0.0
1727,11/13/2022,34.25753424657534,L,0,12.933333333333334,1,6,0.167,0,4,0.0,0,0,,1,0,1,1,1,0,0,0,2,0.6,-17.0,Patty Mills,1,2,0.5
1728,11/15/2022,34.26301369863014,L,0,4.116666666666666,1,1,1.0,1,1,1.0,0,0,,0,2,2,1,0,0,0,0,3,4.0,0.0,Patty Mills,0,0,
1729,11/17/2022,34.26849315068493,W,0,3.7,1,2,0.5,0,1,0.0,0,0,,0,0,0,2,1,0,1,0,2,2.4,-3.0,Patty Mills,1,1,1.0
1730,11/20/2022,34.276712328767125,W,0,6.366666666666666,2,2,1.0,0,0,,0,0,,0,1,1,1,0,0,1,0,4,3.4,6.0,Patty Mills,2,2,1.0
1731,11/22/2022,34.28219178082192,L,0,13.25,1,3,0.333,1,3,0.333,0,0,,1,0,1,2,0,0,0,2,3,2.6,0.0,Patty Mills,0,0,
1732,11/23/2022,34.28493150684932,W,0,6.4,0,2,0.0,0,2,0.0,0,0,,0,1,1,1,0,0,1,0,0,-1.4,-11.0,Patty Mills,0,0,
1733,11/25/2022,34.29041095890411,L,0,5.083333333333333,1,1,1.0,1,1,1.0,0,0,,0,0,0,2,0,0,1,1,3,2.7,-3.0,Patty Mills,0,0,
1734,10/21/2022,31.123287671232877,W,0,17.85,1,3,0.333,1,2,0.5,0,0,,1,1,2,2,0,0,0,1,3,3.3,-10.0,Joe Harris,0,1,0.0
1735,10/24/2022,31.13150684931507,L,0,22.533333333333335,3,9,0.333,2,7,0.286,0,0,,2,3,5,2,0,1,0,4,8,5.7,12.0,Joe Harris,1,2,0.5
1736,10/26/2022,31.136986301369863,L,0,20.6,1,5,0.2,1,3,0.333,0,0,,1,3,4,2,0,0,0,2,3,2.1,-12.0,Joe Harris,0,2,0.0
1737,10/29/2022,31.145205479452056,L,0,24.066666666666666,4,7,0.571,2,5,0.4,1,1,1.0,0,3,3,1,0,1,1,2,11,8.2,-1.0,Joe Harris,2,2,1.0
1738,10/31/2022,31.15068493150685,W,1,29.066666666666666,3,6,0.5,1,2,0.5,0,0,,0,0,0,2,3,1,1,3,7,6.9,13.0,Joe Harris,2,4,0.5
1739,11/1/2022,31.153424657534245,L,1,21.216666666666665,3,8,0.375,2,7,0.286,0,2,0.0,0,2,2,2,0,0,1,1,8,3.4,-4.0,Joe Harris,1,1,1.0
1740,11/4/2022,31.161643835616438,W,1,24.45,3,5,0.6,2,4,0.5,0,0,,0,4,4,3,1,0,0,4,8,8.4,17.0,Joe Harris,1,1,1.0
1741,11/5/2022,31.164383561643834,W,1,30.666666666666668,2,10,0.2,1,8,0.125,0,0,,4,3,7,2,0,0,0,2,5,3.1,9.0,Joe Harris,1,2,0.5
1742,11/7/2022,31.16986301369863,L,1,33.13333333333333,6,10,0.6,2,5,0.4,0,0,,2,3,5,4,1,0,0,2,14,14.7,13.0,Joe Harris,4,5,0.8
1743,11/9/2022,31.175342465753424,W,1,31.933333333333334,4,11,0.364,2,6,0.333,0,0,,0,4,4,1,1,0,1,2,10,5.0,27.0,Joe Harris,2,5,0.4
1744,11/12/2022,31.183561643835617,W,1,31.633333333333333,2,6,0.333,2,5,0.4,1,2,0.5,0,2,2,3,1,0,1,1,7,5.5,7.0,Joe Harris,0,1,0.0
1745,11/13/2022,31.186301369863013,L,1,31.016666666666666,4,7,0.571,2,4,0.5,0,0,,0,5,5,0,0,0,1,3,10,6.0,-26.0,Joe Harris,2,3,0.6666666666666666
1746,11/15/2022,31.19178082191781,L,1,20.2,1,7,0.143,1,5,0.2,1,1,1.0,0,1,1,1,0,0,1,0,4,-0.5,-37.0,Joe Harris,0,2,0.0
1747,11/17/2022,31.197260273972603,W,1,33.416666666666664,5,12,0.417,4,8,0.5,1,1,1.0,0,3,3,4,0,1,3,4,15,8.4,10.0,Joe Harris,1,4,0.25
1748,11/20/2022,31.205479452054796,W,1,28.266666666666666,4,7,0.571,4,6,0.667,1,2,0.5,0,2,2,3,1,1,0,5,13,11.7,14.0,Joe Harris,0,1,0.0
1749,11/22/2022,31.21095890410959,L,0,23.033333333333335,1,8,0.125,1,7,0.143,0,0,,0,2,2,0,0,0,1,1,3,-3.0,-16.0,Joe Harris,0,1,0.0
1750,11/23/2022,31.213698630136985,W,0,14.1,1,7,0.143,1,6,0.167,0,0,,0,2,2,1,0,0,0,1,3,-0.6,-7.0,Joe Harris,0,1,0.0
1751,11/25/2022,31.21917808219178,L,0,12.033333333333333,0,3,0.0,0,3,0.0,0,0,,0,1,1,1,0,0,0,3,0,-2.3,-8.0,Joe Harris,0,0,
1752,11/27/2022,31.224657534246575,W,0,16.216666666666665,1,6,0.167,1,6,0.167,1,1,1.0,0,0,0,0,0,0,0,3,4,-1.0,4.0,Joe Harris,0,0,
1753,10/19/2022,26.8,L,0,18.9,2,5,0.4,0,3,0.0,2,2,1.0,0,1,1,3,0,0,3,1,6,2.3,2.0,Edmond Sumner,2,2,1.0
1754,10/24/2022,26.813698630136987,L,0,2.95,0,0,,0,0,,0,0,,0,0,0,1,0,0,1,0,0,-0.3,-1.0,Edmond Sumner,0,0,
1755,10/26/2022,26.81917808219178,L,0,6.183333333333334,4,6,0.667,0,1,0.0,1,1,1.0,0,0,0,1,1,0,0,0,9,8.1,-7.0,Edmond Sumner,4,5,0.8
1756,10/27/2022,26.82191780821918,L,0,15.266666666666667,0,4,0.0,0,2,0.0,6,6,1.0,0,3,3,0,1,0,1,1,6,3.7,-7.0,Edmond Sumner,0,2,0.0
1757,10/31/2022,26.832876712328765,W,0,11.866666666666667,1,4,0.25,0,1,0.0,4,4,1.0,0,0,0,1,0,0,0,0,6,4.3,-1.0,Edmond Sumner,1,3,0.3333333333333333
1758,11/1/2022,26.835616438356166,L,0,21.966666666666665,2,6,0.333,0,1,0.0,0,0,,0,1,1,5,0,1,1,2,4,3.3,1.0,Edmond Sumner,2,5,0.4
1759,11/4/2022,26.843835616438355,W,1,25.133333333333333,3,7,0.429,1,2,0.5,4,4,1.0,1,3,4,0,2,0,2,1,11,8.5,16.0,Edmond Sumner,2,5,0.4
1760,11/5/2022,26.846575342465755,W,1,17.833333333333332,2,6,0.333,2,3,0.667,0,0,,1,3,4,1,1,1,2,2,6,3.8,-9.0,Edmond Sumner,0,3,0.0
1761,11/7/2022,26.852054794520548,L,1,19.9,2,5,0.4,0,2,0.0,0,0,,0,2,2,0,1,1,1,4,4,1.0,6.0,Edmond Sumner,2,3,0.6666666666666666
1762,11/9/2022,26.85753424657534,W,1,18.516666666666666,7,10,0.7,3,4,0.75,1,2,0.5,1,4,5,1,2,0,0,2,18,17.2,24.0,Edmond Sumner,4,6,0.6666666666666666
1763,11/12/2022,26.865753424657534,W,1,22.8,4,10,0.4,2,6,0.333,1,1,1.0,0,1,1,4,3,1,2,1,11,10.0,6.0,Edmond Sumner,2,4,0.5
1764,11/13/2022,26.86849315068493,L,1,25.883333333333333,5,12,0.417,1,5,0.2,2,2,1.0,1,0,1,1,1,0,3,2,13,5.2,-5.0,Edmond Sumner,4,7,0.5714285714285714
1765,11/15/2022,26.873972602739727,L,1,21.583333333333332,4,9,0.444,1,4,0.25,9,9,1.0,0,1,1,1,2,0,1,3,18,14.1,-20.0,Edmond Sumner,3,5,0.6
1766,11/17/2022,26.87945205479452,W,1,5.95,0,0,,0,0,,0,0,,0,0,0,1,0,0,1,0,0,-0.3,4.0,Edmond Sumner,0,0,
1767,11/22/2022,26.893150684931506,L,0,3.1333333333333333,3,3,1.0,0,0,,1,1,1.0,0,0,0,0,0,0,0,0,7,6.1,5.0,Edmond Sumner,3,3,1.0
1768,11/23/2022,26.895890410958906,W,0,21.2,3,8,0.375,0,2,0.0,0,1,0.0,1,1,2,1,1,1,3,5,6,-0.4,-2.0,Edmond Sumner,3,6,0.5
1769,11/27/2022,26.90684931506849,W,0,10.7,1,2,0.5,0,0,,0,0,,0,0,0,1,0,0,0,1,2,1.3,12.0,Edmond Sumner,1,2,0.5
1770,10/19/2022,26.24931506849315,L,1,23.166666666666668,2,3,0.667,0,0,,0,2,0.0,0,5,5,5,0,0,3,6,4,1.5,-26.0,Ben Simmons,2,3,0.6666666666666666
1771,10/21/2022,26.254794520547946,W,1,32.483333333333334,3,5,0.6,0,0,,0,0,,0,10,10,8,0,2,3,2,6,9.9,-3.0,Ben Simmons,3,5,0.6
1772,10/24/2022,26.263013698630136,L,1,28.116666666666667,2,5,0.4,0,1,0.0,3,5,0.6,0,3,3,8,1,0,5,6,7,3.6,-16.0,Ben Simmons,2,4,0.5
1773,10/26/2022,26.268493150684932,L,1,34.46666666666667,2,7,0.286,0,0,,0,2,0.0,1,4,5,9,2,1,2,4,4,6.4,2.0,Ben Simmons,2,7,0.2857142857142857
1774,10/27/2022,26.27123287671233,L,1,37.1,3,7,0.429,0,0,,1,1,1.0,3,5,8,5,3,0,1,4,7,10.8,1.0,Ben Simmons,3,7,0.42857142857142855
1775,10/29/2022,26.276712328767122,L,1,35.7,3,7,0.429,0,0,,3,5,0.6,2,6,8,9,1,1,2,4,9,12.1,-11.0,Ben Simmons,3,7,0.42857142857142855
1776,11/7/2022,26.301369863013697,L,0,15.933333333333334,1,3,0.333,0,0,,0,0,,1,2,3,2,1,0,2,3,2,0.8,-7.0,Ben Simmons,1,3,0.3333333333333333
1777,11/9/2022,26.306849315068494,W,0,23.883333333333333,3,6,0.5,0,0,,0,0,,2,7,9,4,2,1,2,4,6,8.4,18.0,Ben Simmons,3,6,0.5
1778,11/12/2022,26.315068493150687,W,0,14.466666666666667,1,2,0.5,0,0,,0,0,,1,4,5,3,0,0,0,4,2,3.4,-1.0,Ben Simmons,1,2,0.5
1779,11/15/2022,26.323287671232876,L,0,20.366666666666667,5,7,0.714,0,0,,1,2,0.5,0,5,5,3,1,0,2,0,11,10.3,-3.0,Ben Simmons,5,7,0.7142857142857143
1780,11/17/2022,26.328767123287673,W,0,32.18333333333333,6,6,1.0,0,0,,3,4,0.75,1,12,13,7,0,1,1,6,15,19.3,13.0,Ben Simmons,6,6,1.0
1781,11/20/2022,26.336986301369862,W,1,34.7,11,13,0.846,0,0,,0,1,0.0,1,7,8,5,1,0,5,3,22,18.0,19.0,Ben Simmons,11,13,0.8461538461538461
1782,11/22/2022,26.34246575342466,L,1,32.38333333333333,4,7,0.571,0,0,,3,6,0.5,2,5,7,11,3,3,3,3,11,18.0,-9.0,Ben Simmons,4,7,0.5714285714285714
1783,11/23/2022,26.345205479452055,W,1,32.5,7,9,0.778,0,0,,0,0,,0,2,2,6,3,2,1,5,14,16.7,15.0,Ben Simmons,7,9,0.7777777777777778
1784,11/25/2022,26.350684931506848,L,1,34.18333333333333,8,8,1.0,0,0,,4,5,0.8,1,5,6,3,0,1,3,6,20,16.8,-5.0,Ben Simmons,8,8,1.0
1785,11/27/2022,26.356164383561644,W,1,33.61666666666667,1,3,0.333,0,0,,0,0,,1,11,12,8,3,0,2,2,2,10.1,-1.0,Ben Simmons,1,3,0.3333333333333333
1786,10/19/2022,21.016438356164382,L,0,12.7,1,4,0.25,0,1,0.0,0,0,,0,0,0,1,0,0,0,0,2,0.3,3.0,Cam Thomas,1,3,0.3333333333333333
1787,10/26/2022,21.035616438356165,L,0,0.9666666666666667,0,0,,0,0,,0,0,,0,0,0,0,0,0,0,0,0,0.0,1.0,Cam Thomas,0,0,
1788,11/1/2022,21.052054794520547,L,0,0.8166666666666667,0,0,,0,0,,0,0,,0,0,0,0,0,0,0,0,0,0.0,2.0,Cam Thomas,0,0,
1789,11/4/2022,21.06027397260274,W,0,31.833333333333332,6,13,0.462,2,4,0.5,3,3,1.0,0,4,4,6,1,0,0,2,17,15.9,36.0,Cam Thomas,4,9,0.4444444444444444
1790,11/5/2022,21.063013698630137,W,0,28.783333333333335,5,11,0.455,1,2,0.5,10,11,0.909,0,4,4,4,1,1,1,2,21,18.8,13.0,Cam Thomas,4,9,0.4444444444444444
1791,11/7/2022,21.068493150684933,L,0,29.7,5,13,0.385,2,4,0.5,7,9,0.778,1,0,1,2,2,0,1,2,19,13.4,-7.0,Cam Thomas,3,9,0.3333333333333333
1792,11/9/2022,21.073972602739726,W,0,22.083333333333332,3,8,0.375,0,1,0.0,0,0,,0,2,2,2,1,1,3,1,6,1.9,-8.0,Cam Thomas,3,7,0.42857142857142855
1793,11/12/2022,21.08219178082192,W,0,25.05,1,6,0.167,0,1,0.0,2,2,1.0,0,2,2,3,1,0,2,2,4,1.1,2.0,Cam Thomas,1,5,0.2
1794,11/13/2022,21.084931506849315,L,0,22.566666666666666,4,9,0.444,0,2,0.0,7,9,0.778,0,3,3,2,1,0,1,1,15,11.4,8.0,Cam Thomas,4,7,0.5714285714285714
1795,11/15/2022,21.09041095890411,L,0,20.683333333333334,4,8,0.5,1,2,0.5,3,4,0.75,0,2,2,3,1,0,2,0,12,9.3,14.0,Cam Thomas,3,6,0.5
1796,11/17/2022,21.095890410958905,W,0,7.166666666666667,0,3,0.0,0,0,,0,0,,0,0,0,0,0,0,1,0,0,-3.1,-7.0,Cam Thomas,0,3,0.0
1797,11/20/2022,21.104109589041094,W,0,4.233333333333333,0,1,0.0,0,0,,0,2,0.0,0,1,1,0,0,0,0,1,0,-1.6,-9.0,Cam Thomas,0,1,0.0
1798,11/22/2022,21.10958904109589,L,0,3.1333333333333333,0,0,,0,0,,0,0,,0,1,1,1,0,0,0,0,0,1.0,5.0,Cam Thomas,0,0,
1799,11/23/2022,21.112328767123287,W,0,17.35,2,5,0.4,0,1,0.0,1,2,0.5,0,3,3,2,0,0,1,2,5,2.4,-3.0,Cam Thomas,2,4,0.5
1800,11/27/2022,21.123287671232877,W,0,5.966666666666667,1,4,0.25,0,1,0.0,0,0,,0,1,1,0,0,0,0,1,2,-0.5,0.0,Cam Thomas,1,3,0.3333333333333333
1801,10/19/2022,28.016438356164382,L,0,8.583333333333334,0,1,0.0,0,1,0.0,0,2,0.0,0,0,0,0,0,0,0,0,0,-1.5,2.0,Yuta Watanabe,0,0,
1802,10/24/2022,28.03013698630137,L,0,6.1,0,1,0.0,0,1,0.0,0,0,,0,0,0,0,0,0,0,1,0,-1.1,0.0,Yuta Watanabe,0,0,
1803,10/26/2022,28.035616438356165,L,0,7.6,2,2,1.0,1,1,1.0,0,0,,0,1,1,0,0,0,0,0,5,4.7,12.0,Yuta Watanabe,1,1,1.0
1804,10/27/2022,28.03835616438356,L,0,22.483333333333334,2,3,0.667,2,2,1.0,0,0,,0,4,4,2,0,1,0,5,6,6.0,4.0,Yuta Watanabe,0,1,0.0
1805,10/29/2022,28.043835616438358,L,0,12.9,2,3,0.667,1,2,0.5,0,0,,0,2,2,0,0,0,1,1,5,2.9,-3.0,Yuta Watanabe,1,1,1.0
1806,10/31/2022,28.04931506849315,W,0,22.466666666666665,2,4,0.5,1,2,0.5,0,0,,0,2,2,0,0,0,1,1,5,2.2,-16.0,Yuta Watanabe,1,2,0.5
1807,11/1/2022,28.052054794520547,L,0,27.8,4,6,0.667,2,3,0.667,0,0,,2,2,4,0,0,2,0,0,10,10.8,-12.0,Yuta Watanabe,2,3,0.6666666666666666
1808,11/4/2022,28.06027397260274,W,0,24.033333333333335,6,8,0.75,2,3,0.667,0,0,,3,5,8,0,1,2,1,0,14,15.8,21.0,Yuta Watanabe,4,5,0.8
1809,11/5/2022,28.063013698630137,W,0,23.2,3,6,0.5,2,4,0.5,0,0,,0,3,3,3,2,1,0,2,8,9.9,10.0,Yuta Watanabe,1,2,0.5
1810,11/7/2022,28.068493150684933,L,0,4.633333333333333,1,3,0.333,1,3,0.333,0,0,,0,0,0,0,0,0,0,0,3,1.3,-7.0,Yuta Watanabe,0,0,
1811,11/13/2022,28.084931506849315,L,0,22.75,5,8,0.625,0,2,0.0,1,1,1.0,2,3,5,2,0,1,0,1,11,11.4,-9.0,Yuta Watanabe,5,6,0.8333333333333334
1812,11/15/2022,28.09041095890411,L,0,19.283333333333335,4,8,0.5,3,5,0.6,0,0,,1,1,2,1,0,0,1,2,11,6.9,-10.0,Yuta Watanabe,1,3,0.3333333333333333
1813,11/17/2022,28.095890410958905,W,0,28.583333333333332,5,7,0.714,5,7,0.714,5,6,0.833,2,5,7,2,0,0,0,1,20,20.6,-10.0,Yuta Watanabe,0,0,
1814,11/20/2022,28.104109589041094,W,0,24.683333333333334,6,9,0.667,4,6,0.667,0,0,,0,3,3,3,0,0,1,2,16,13.3,-1.0,Yuta Watanabe,2,3,0.6666666666666666
1815,10/19/2022,20.95068493150685,L,0,22.516666666666666,1,8,0.125,0,1,0.0,2,2,1.0,5,3,8,1,2,2,0,4,4,5.7,-10.0,Day'Ron Sharpe,1,7,0.14285714285714285
1816,10/21/2022,20.956164383561642,W,0,10.183333333333334,2,3,0.667,0,0,,0,2,0.0,2,5,7,0,0,1,0,3,4,4.3,-11.0,Day'Ron Sharpe,2,3,0.6666666666666666
1817,10/24/2022,20.964383561643835,L,0,14.516666666666667,2,2,1.0,0,0,,1,2,0.5,0,3,3,1,0,0,1,5,5,2.6,-8.0,Day'Ron Sharpe,2,2,1.0
1818,10/26/2022,20.96986301369863,L,0,13.15,1,3,0.333,0,0,,1,2,0.5,1,2,3,3,1,1,2,4,3,2.4,-6.0,Day'Ron Sharpe,1,3,0.3333333333333333
1819,10/31/2022,20.983561643835618,W,0,11.066666666666666,2,2,1.0,0,0,,0,0,,1,2,3,0,0,1,2,2,4,2.6,-9.0,Day'Ron Sharpe,2,2,1.0
1820,11/4/2022,20.994520547945207,W,0,7.716666666666667,0,1,0.0,0,0,,0,0,,0,1,1,0,0,0,1,2,0,-2.2,5.0,Day'Ron Sharpe,0,1,0.0
1821,11/7/2022,21.002739726027396,L,0,0.08333333333333333,0,0,,0,0,,0,0,,0,0,0,0,0,0,0,0,0,0.0,0.0,Day'Ron Sharpe,0,0,
1822,11/9/2022,21.008219178082193,W,0,4.6,0,0,,0,0,,0,0,,0,2,2,0,0,0,1,1,0,-0.8,-5.0,Day'Ron Sharpe,0,0,
1823,11/12/2022,21.016438356164382,W,0,1.9166666666666665,1,1,1.0,0,0,,2,2,1.0,0,1,1,1,0,0,0,0,4,4.7,2.0,Day'Ron Sharpe,1,1,1.0
1824,11/13/2022,21.019178082191782,L,0,3.65,0,1,0.0,0,0,,0,0,,1,3,4,0,0,0,1,0,0,-0.1,5.0,Day'Ron Sharpe,0,1,0.0
1825,11/15/2022,21.024657534246575,L,0,12.0,2,4,0.5,1,1,1.0,2,2,1.0,0,3,3,3,0,1,0,1,7,8.3,1.0,Day'Ron Sharpe,1,3,0.3333333333333333
1826,11/20/2022,21.03835616438356,W,0,2.65,1,2,0.5,0,0,,0,0,,0,1,1,0,0,0,0,0,2,1.3,-5.0,Day'Ron Sharpe,1,2,0.5
1827,11/22/2022,21.043835616438358,L,0,3.1333333333333333,0,0,,0,0,,0,0,,1,0,1,0,0,0,0,2,0,-0.1,5.0,Day'Ron Sharpe,0,0,
1828,11/23/2022,21.046575342465754,W,0,3.9,2,3,0.667,1,1,1.0,0,0,,1,2,3,0,0,1,0,0,5,5.7,-5.0,Day'Ron Sharpe,1,2,0.5
1829,10/19/2022,30.575342465753426,L,1,34.166666666666664,6,19,0.316,0,6,0.0,3,3,1.0,0,2,2,5,2,0,2,3,15,7.0,-18.0,Kyrie Irving,6,13,0.46153846153846156
1830,10/21/2022,30.58082191780822,W,1,40.56666666666667,11,24,0.458,5,13,0.385,3,3,1.0,1,0,1,7,0,1,2,4,30,20.3,22.0,Kyrie Irving,6,11,0.5454545454545454
1831,10/24/2022,30.589041095890412,L,1,38.71666666666667,14,24,0.583,2,6,0.333,7,8,0.875,2,6,8,5,2,2,3,3,37,31.3,-9.0,Kyrie Irving,12,18,0.6666666666666666
1832,10/26/2022,30.594520547945205,L,1,38.983333333333334,9,21,0.429,0,7,0.0,9,10,0.9,0,9,9,1,1,0,1,4,27,17.3,-9.0,Kyrie Irving,9,14,0.6428571428571429
1833,10/27/2022,30.5972602739726,L,1,42.06666666666667,14,31,0.452,5,14,0.357,6,6,1.0,2,5,7,4,3,4,3,3,39,30.2,-3.0,Kyrie Irving,9,17,0.5294117647058824
1834,10/29/2022,30.602739726027398,L,1,39.516666666666666,13,22,0.591,5,12,0.417,4,5,0.8,1,1,2,6,0,0,2,2,35,26.8,0.0,Kyrie Irving,8,10,0.8
1835,10/31/2022,30.60821917808219,W,1,42.7,9,19,0.474,4,11,0.364,6,6,1.0,0,6,6,6,3,1,3,1,28,24.6,14.0,Kyrie Irving,5,8,0.625
1836,11/1/2022,30.610958904109587,L,1,32.766666666666666,2,12,0.167,0,6,0.0,0,0,,0,6,6,7,0,1,3,4,4,-0.8,-14.0,Kyrie Irving,2,6,0.3333333333333333
1837,11/20/2022,30.663013698630138,W,1,26.033333333333335,5,12,0.417,2,5,0.4,2,2,1.0,0,5,5,0,1,1,4,3,14,5.6,16.0,Kyrie Irving,3,7,0.42857142857142855
1838,11/22/2022,30.66849315068493,L,1,30.533333333333335,10,18,0.556,2,8,0.25,1,1,1.0,0,2,2,2,1,2,2,0,23,16.8,-9.0,Kyrie Irving,8,10,0.8
1839,11/23/2022,30.671232876712327,W,1,28.266666666666666,11,16,0.688,5,8,0.625,2,2,1.0,0,1,1,3,0,0,1,3,29,22.4,16.0,Kyrie Irving,6,8,0.75
1840,11/25/2022,30.676712328767124,L,1,38.13333333333333,8,17,0.471,3,9,0.333,1,1,1.0,0,4,4,4,0,0,1,4,20,12.7,1.0,Kyrie Irving,5,8,0.625
1841,11/27/2022,30.682191780821917,W,1,37.95,8,17,0.471,4,10,0.4,2,3,0.667,1,4,5,6,0,0,0,3,22,17.8,2.0,Kyrie Irving,4,7,0.5714285714285714
1842,10/27/2022,23.03835616438356,L,0,20.7,4,6,0.667,0,1,0.0,2,2,1.0,2,3,5,1,0,0,1,6,10,7.0,-23.0,David Duke Jr.,4,5,0.8
1843,11/1/2022,23.052054794520547,L,0,18.7,1,4,0.25,0,1,0.0,0,0,,0,0,0,2,2,0,2,2,2,0.2,6.0,David Duke Jr.,1,3,0.3333333333333333
1844,11/4/2022,23.06027397260274,W,0,12.75,5,8,0.625,0,0,,1,1,1.0,0,3,3,0,0,0,1,2,11,6.5,3.0,David Duke Jr.,5,8,0.625
1845,11/5/2022,23.063013698630137,W,0,4.116666666666666,0,2,0.0,0,1,0.0,0,0,,0,0,0,0,1,0,0,1,0,-0.8,0.0,David Duke Jr.,0,1,0.0
1846,11/7/2022,23.068493150684933,L,0,4.05,0,1,0.0,0,1,0.0,0,0,,0,0,0,1,0,0,1,1,0,-1.4,-7.0,David Duke Jr.,0,0,
1847,11/9/2022,23.073972602739726,W,0,8.983333333333333,1,2,0.5,0,0,,0,0,,1,0,1,0,1,0,1,3,2,0.5,-14.0,David Duke Jr.,1,2,0.5
1848,11/12/2022,23.08219178082192,W,0,1.9166666666666665,1,1,1.0,0,0,,0,0,,1,0,1,1,0,0,0,0,2,3.1,2.0,David Duke Jr.,1,1,1.0
1849,11/13/2022,23.084931506849315,L,0,6.25,1,3,0.333,0,0,,0,0,,0,0,0,0,0,1,0,0,2,1.0,5.0,David Duke Jr.,1,3,0.3333333333333333
1850,11/15/2022,23.09041095890411,L,0,13.433333333333334,2,3,0.667,0,0,,0,0,,0,0,0,1,0,0,3,2,4,-0.4,1.0,David Duke Jr.,2,3,0.6666666666666666
1851,11/20/2022,23.104109589041094,W,0,1.8,0,0,,0,0,,0,0,,0,0,0,0,0,0,0,2,0,-0.8,-7.0,David Duke Jr.,0,0,
1852,11/22/2022,23.10958904109589,L,0,3.1333333333333333,1,3,0.333,0,0,,0,1,0.0,0,2,2,2,0,0,0,0,2,1.9,5.0,David Duke Jr.,1,3,0.3333333333333333
1853,11/23/2022,23.112328767123287,W,0,3.9,0,2,0.0,0,0,,0,0,,0,0,0,1,0,0,0,0,0,-0.7,-5.0,David Duke Jr.,0,2,0.0
1854,11/25/2022,23.117808219178084,L,0,0.9666666666666667,0,0,,0,0,,0,0,,0,0,0,0,0,0,0,0,0,0.0,1.0,David Duke Jr.,0,0,
1855,10/19/2022,33.12876712328767,L,0,2.7333333333333334,1,1,1.0,1,1,1.0,0,0,,0,0,0,0,0,0,0,0,3,2.7,5.0,Markieff Morris,0,0,
1856,10/21/2022,33.134246575342466,W,0,19.266666666666666,1,4,0.25,1,3,0.333,0,0,,1,3,4,0,0,1,1,3,3,0.7,11.0,Markieff Morris,0,1,0.0
1857,10/29/2022,33.156164383561645,L,0,5.133333333333334,1,2,0.5,1,2,0.5,0,0,,0,2,2,0,0,0,0,1,3,2.2,4.0,Markieff Morris,0,0,
1858,10/31/2022,33.16164383561644,W,0,10.283333333333333,1,2,0.5,1,2,0.5,0,0,,0,2,2,1,1,0,3,1,3,0.9,-5.0,Markieff Morris,0,0,
1859,11/4/2022,33.172602739726024,W,0,7.55,1,4,0.25,1,2,0.5,0,0,,0,2,2,2,1,0,0,1,3,3.2,7.0,Markieff Morris,0,2,0.0
1860,11/5/2022,33.175342465753424,W,0,6.483333333333333,0,3,0.0,0,2,0.0,0,0,,0,2,2,1,0,0,0,2,0,-1.6,-6.0,Markieff Morris,0,1,0.0
1861,11/9/2022,33.18630136986302,W,0,5.2,0,0,,0,0,,0,0,,0,0,0,0,0,0,2,0,0,-2.0,-3.0,Markieff Morris,0,0,
1862,11/13/2022,33.1972602739726,L,0,20.383333333333333,2,6,0.333,1,3,0.333,0,0,,1,3,4,5,0,1,1,2,5,5.6,13.0,Markieff Morris,1,3,0.3333333333333333
1863,11/20/2022,33.21643835616438,W,0,17.266666666666666,3,5,0.6,2,4,0.5,0,0,,2,5,7,1,1,0,0,2,8,9.5,5.0,Markieff Morris,1,1,1.0
1864,11/22/2022,33.221917808219175,L,0,4.116666666666666,0,0,,0,0,,0,0,,0,1,1,0,0,0,0,0,0,0.3,-6.0,Markieff Morris,0,0,
1865,11/23/2022,33.224657534246575,W,0,18.0,3,4,0.75,3,4,0.75,0,0,,1,1,2,2,1,0,1,1,9,9.4,7.0,Markieff Morris,0,0,
1866,11/25/2022,33.23013698630137,L,0,13.166666666666666,1,4,0.25,1,3,0.333,0,0,,0,1,1,0,1,0,0,2,3,1.1,-5.0,Markieff Morris,0,1,0.0
1867,10/29/2022,32.18356164383562,L,0,17.5,0,5,0.0,0,5,0.0,0,0,,0,2,2,6,1,1,0,3,0,1.8,-13.0,Seth Curry,0,0,
1868,11/5/2022,32.202739726027396,W,0,14.883333333333333,1,4,0.25,1,2,0.5,0,0,,0,0,0,0,0,0,1,0,3,-0.4,5.0,Seth Curry,0,2,0.0
1869,11/7/2022,32.20821917808219,L,0,12.966666666666667,0,3,0.0,0,1,0.0,1,1,1.0,0,0,0,0,1,0,0,2,1,-0.9,-2.0,Seth Curry,0,2,0.0
1870,11/9/2022,32.21369863013699,W,0,23.4,7,13,0.538,6,11,0.545,3,3,1.0,1,2,3,2,1,0,0,1,23,20.0,11.0,Seth Curry,1,2,0.5
1871,11/12/2022,32.221917808219175,W,0,27.916666666666668,9,15,0.6,4,8,0.5,0,1,0.0,0,3,3,3,0,0,1,2,22,15.9,12.0,Seth Curry,5,7,0.7142857142857143
1872,11/15/2022,32.23013698630137,L,0,23.65,3,6,0.5,1,2,0.5,2,2,1.0,0,3,3,3,0,0,1,3,9,6.8,-6.0,Seth Curry,2,4,0.5
1873,11/17/2022,32.23561643835617,W,0,27.5,0,5,0.0,0,2,0.0,0,0,,0,1,1,0,1,1,3,3,0,-5.7,5.0,Seth Curry,0,3,0.0
1874,11/20/2022,32.24383561643835,W,0,25.033333333333335,5,10,0.5,0,4,0.0,0,0,,2,3,5,5,0,1,1,0,10,10.5,12.0,Seth Curry,5,6,0.8333333333333334
1875,11/22/2022,32.24931506849315,L,0,23.833333333333332,5,12,0.417,2,6,0.333,2,2,1.0,0,2,2,2,1,1,1,1,14,9.9,-8.0,Seth Curry,3,6,0.5
1876,11/25/2022,32.25753424657534,L,0,27.833333333333332,5,9,0.556,4,6,0.667,0,0,,0,2,2,5,0,0,2,2,14,11.0,-5.0,Seth Curry,1,3,0.3333333333333333
1877,11/27/2022,32.26301369863014,W,0,28.666666666666668,11,15,0.733,7,10,0.7,0,0,,0,3,3,1,1,0,2,2,29,22.7,14.0,Seth Curry,4,5,0.8
1878,10/19/2022,22.194520547945206,L,0,3.8666666666666667,1,3,0.333,1,2,0.5,0,0,,0,2,2,2,1,0,0,0,3,4.3,-1.0,Kessler Edwards,0,1,0.0
1879,10/26/2022,22.213698630136985,L,0,0.9666666666666667,0,0,,0,0,,0,0,,0,0,0,0,0,0,0,0,0,0.0,1.0,Kessler Edwards,0,0,
1880,11/1/2022,22.23013698630137,L,0,0.8166666666666667,0,0,,0,0,,0,0,,0,0,0,0,0,0,0,0,0,0.0,2.0,Kessler Edwards,0,0,
1881,11/9/2022,22.252054794520546,W,0,4.6,0,1,0.0,0,1,0.0,0,0,,0,0,0,0,0,0,0,0,0,-0.7,-5.0,Kessler Edwards,0,0,
1882,11/12/2022,22.26027397260274,W,0,1.9166666666666665,0,1,0.0,0,0,,0,0,,0,0,0,0,0,0,0,0,0,-0.7,2.0,Kessler Edwards,0,1,0.0
1883,11/13/2022,22.263013698630136,L,0,3.65,0,0,,0,0,,0,0,,0,0,0,0,0,0,0,0,0,0.0,5.0,Kessler Edwards,0,0,
1884,11/15/2022,22.268493150684932,L,0,12.0,2,4,0.5,1,3,0.333,1,2,0.5,2,1,3,0,1,1,0,1,6,6.6,1.0,Kessler Edwards,1,1,1.0
1885,11/20/2022,22.28219178082192,W,0,1.8,0,0,,0,0,,0,0,,0,0,0,0,0,0,1,0,0,-1.0,-7.0,Kessler Edwards,0,0,
1886,11/22/2022,22.28767123287671,L,0,3.1333333333333333,0,1,0.0,0,0,,0,0,,0,0,0,0,0,0,0,0,0,-0.7,5.0,Kessler Edwards,0,1,0.0
1887,11/23/2022,22.29041095890411,W,0,3.9,0,1,0.0,0,1,0.0,0,0,,0,0,0,0,0,0,0,0,0,-0.7,-5.0,Kessler Edwards,0,0,
1888,11/25/2022,22.295890410958904,L,0,0.9666666666666667,0,1,0.0,0,0,,0,0,,0,0,0,0,0,0,0,0,0,-0.7,1.0,Kessler Edwards,0,1,0.0
1889,10/19/2022,26.134246575342466,L,1,36.083333333333336,7,18,0.389,1,4,0.25,0,0,,2,4,6,9,0,0,0,3,15,12.9,3.0,Jalen Brunson,6,14,0.42857142857142855
1890,10/21/2022,26.13972602739726,W,1,28.366666666666667,6,11,0.545,2,4,0.5,3,5,0.6,0,2,2,6,1,0,0,2,17,15.9,3.0,Jalen Brunson,4,7,0.5714285714285714
1891,10/24/2022,26.147945205479452,W,1,33.03333333333333,8,16,0.5,2,4,0.5,3,3,1.0,0,3,3,6,2,0,3,5,21,15.1,17.0,Jalen Brunson,6,12,0.5
1892,10/26/2022,26.153424657534245,W,1,40.583333333333336,10,15,0.667,2,5,0.4,5,5,1.0,0,7,7,13,1,1,3,2,27,29.6,7.0,Jalen Brunson,8,10,0.8
1893,10/28/2022,26.15890410958904,L,1,33.13333333333333,3,10,0.3,1,4,0.25,6,9,0.667,0,3,3,2,1,0,3,3,13,5.1,-19.0,Jalen Brunson,2,6,0.3333333333333333
1894,10/30/2022,26.164383561643834,L,1,33.95,8,19,0.421,0,3,0.0,0,1,0.0,0,4,4,7,3,0,1,2,16,12.8,2.0,Jalen Brunson,8,16,0.5
1895,11/2/2022,26.172602739726027,L,1,31.0,8,15,0.533,1,4,0.25,3,4,0.75,0,1,1,5,0,1,3,2,20,13.0,-4.0,Jalen Brunson,7,11,0.6363636363636364
1896,11/4/2022,26.17808219178082,W,1,35.81666666666667,7,15,0.467,1,4,0.25,8,9,0.889,1,5,6,7,0,0,1,3,23,19.8,11.0,Jalen Brunson,6,11,0.5454545454545454
1897,11/5/2022,26.18082191780822,L,1,32.68333333333333,10,17,0.588,0,2,0.0,2,2,1.0,0,3,3,10,0,0,0,1,22,21.6,-3.0,Jalen Brunson,10,15,0.6666666666666666
1898,11/7/2022,26.186301369863013,W,1,33.583333333333336,9,14,0.643,2,5,0.4,3,3,1.0,1,4,5,8,0,0,3,3,23,20.1,5.0,Jalen Brunson,7,9,0.7777777777777778
1899,11/9/2022,26.19178082191781,L,1,30.966666666666665,4,14,0.286,1,5,0.2,5,5,1.0,1,3,4,2,0,0,3,0,14,5.8,-22.0,Jalen Brunson,3,9,0.3333333333333333
1900,11/11/2022,26.197260273972603,W,1,32.68333333333333,8,16,0.5,2,5,0.4,8,8,1.0,0,1,1,7,4,0,0,3,26,26.0,8.0,Jalen Brunson,6,11,0.5454545454545454
1901,11/13/2022,26.202739726027396,L,1,23.966666666666665,5,9,0.556,0,2,0.0,7,7,1.0,0,1,1,7,3,0,1,2,17,19.1,-20.0,Jalen Brunson,5,7,0.7142857142857143
1902,11/15/2022,26.208219178082192,W,1,34.4,10,20,0.5,1,4,0.25,4,4,1.0,1,2,3,8,3,0,4,5,25,18.9,9.0,Jalen Brunson,9,16,0.5625
1903,11/16/2022,26.21095890410959,W,1,31.116666666666667,7,13,0.538,2,4,0.5,5,5,1.0,0,5,5,7,0,0,1,2,21,19.3,1.0,Jalen Brunson,5,9,0.5555555555555556
1904,11/18/2022,26.216438356164385,L,1,31.683333333333334,2,13,0.154,1,5,0.2,8,8,1.0,0,5,5,4,2,0,2,1,13,8.6,-5.0,Jalen Brunson,1,8,0.125
1905,11/20/2022,26.221917808219178,L,1,29.283333333333335,11,21,0.524,2,4,0.5,3,4,0.75,1,2,3,3,0,1,1,1,27,19.0,-22.0,Jalen Brunson,9,17,0.5294117647058824
1906,11/21/2022,26.224657534246575,W,1,34.25,14,20,0.7,1,6,0.167,5,6,0.833,0,0,0,9,1,0,2,1,34,30.1,5.0,Jalen Brunson,13,14,0.9285714285714286
1907,11/25/2022,26.235616438356164,L,1,41.3,10,22,0.455,3,8,0.375,9,9,1.0,1,4,5,4,0,0,1,5,32,22.3,-6.0,Jalen Brunson,7,14,0.5
1908,11/27/2022,26.24109589041096,L,1,35.583333333333336,8,20,0.4,3,5,0.6,11,12,0.917,1,4,5,9,1,0,2,5,30,24.0,-1.0,Jalen Brunson,5,15,0.3333333333333333
1909,10/19/2022,27.887671232876713,L,1,34.916666666666664,9,16,0.563,2,6,0.333,4,5,0.8,2,9,11,6,2,0,3,6,24,20.9,7.0,Julius Randle,7,10,0.7
1910,10/21/2022,27.893150684931506,W,1,25.45,5,12,0.417,2,3,0.667,3,4,0.75,1,5,6,0,0,0,0,2,15,9.6,-1.0,Julius Randle,3,9,0.3333333333333333
1911,10/24/2022,27.9013698630137,W,1,34.11666666666667,10,19,0.526,2,9,0.222,3,5,0.6,4,8,12,4,1,0,2,5,25,19.9,4.0,Julius Randle,8,10,0.8
1912,10/26/2022,27.90684931506849,W,1,39.833333333333336,7,19,0.368,0,2,0.0,3,4,0.75,2,4,6,2,2,1,1,5,17,9.8,6.0,Julius Randle,7,17,0.4117647058823529
1913,10/28/2022,27.912328767123288,L,1,31.233333333333334,3,10,0.3,0,2,0.0,8,9,0.889,4,8,12,2,1,0,3,4,14,10.8,-14.0,Julius Randle,3,8,0.375
1914,10/30/2022,27.91780821917808,L,1,32.8,5,13,0.385,0,3,0.0,5,10,0.5,0,9,9,7,2,0,4,5,15,9.5,-8.0,Julius Randle,5,10,0.5
1915,11/2/2022,27.926027397260274,L,1,29.55,4,12,0.333,0,4,0.0,6,9,0.667,2,4,6,2,0,1,4,2,14,5.9,-10.0,Julius Randle,4,8,0.5
1916,11/4/2022,27.931506849315067,W,1,36.61666666666667,6,13,0.462,1,5,0.2,4,5,0.8,3,7,10,5,0,1,6,1,17,11.9,7.0,Julius Randle,5,8,0.625
1917,11/5/2022,27.934246575342467,L,1,40.1,10,19,0.526,3,7,0.429,6,6,1.0,5,4,9,2,0,0,3,3,29,21.6,-8.0,Julius Randle,7,12,0.5833333333333334
1918,11/7/2022,27.93972602739726,W,1,32.516666666666666,9,16,0.563,8,13,0.615,5,6,0.833,2,6,8,3,0,0,5,5,31,21.3,4.0,Julius Randle,1,3,0.3333333333333333
1919,11/9/2022,27.945205479452056,L,1,31.266666666666666,7,15,0.467,4,8,0.5,6,9,0.667,1,10,11,3,0,0,4,1,24,16.5,-29.0,Julius Randle,3,7,0.42857142857142855
1920,11/11/2022,27.95068493150685,W,1,32.983333333333334,8,18,0.444,0,7,0.0,5,5,1.0,4,4,8,5,0,0,2,5,21,15.1,13.0,Julius Randle,8,11,0.7272727272727273
1921,11/13/2022,27.956164383561642,L,1,33.25,7,14,0.5,3,6,0.5,8,10,0.8,3,7,10,3,0,0,2,3,25,20.3,-10.0,Julius Randle,4,8,0.5
1922,11/15/2022,27.96164383561644,W,1,31.216666666666665,5,11,0.455,2,6,0.333,3,3,1.0,1,4,5,1,0,1,4,2,15,7.8,-12.0,Julius Randle,3,5,0.6
1923,11/16/2022,27.964383561643835,W,1,32.28333333333333,11,21,0.524,3,10,0.3,9,13,0.692,3,8,11,4,4,0,3,3,34,29.2,7.0,Julius Randle,8,11,0.7272727272727273
1924,11/18/2022,27.96986301369863,L,1,30.25,7,15,0.467,3,7,0.429,3,4,0.75,4,3,7,2,0,0,4,3,20,11.8,-17.0,Julius Randle,4,8,0.5
1925,11/20/2022,27.975342465753425,L,1,26.55,4,11,0.364,1,4,0.25,0,0,,1,5,6,2,1,0,3,1,9,4.1,-6.0,Julius Randle,3,7,0.42857142857142855
1926,11/21/2022,27.97808219178082,W,1,33.233333333333334,9,16,0.563,2,6,0.333,5,6,0.833,1,10,11,1,0,0,2,5,25,17.4,8.0,Julius Randle,7,10,0.7
1927,11/25/2022,27.98904109589041,L,1,38.516666666666666,8,19,0.421,3,8,0.375,4,4,1.0,0,6,6,3,3,0,2,4,23,16.2,-17.0,Julius Randle,5,11,0.45454545454545453
1928,11/27/2022,27.994520547945207,L,1,34.6,4,9,0.444,1,5,0.2,5,6,0.833,2,8,10,9,0,0,1,4,14,16.4,-2.0,Julius Randle,3,4,0.75
1929,10/19/2022,22.34794520547945,L,1,37.6,3,18,0.167,0,6,0.0,5,6,0.833,2,6,8,3,0,0,2,2,11,1.7,0.0,RJ Barrett,3,12,0.25
1930,10/21/2022,22.353424657534248,W,1,27.6,8,15,0.533,0,3,0.0,2,2,1.0,0,3,3,4,0,1,1,2,18,13.3,12.0,RJ Barrett,8,12,0.6666666666666666
1931,10/24/2022,22.361643835616437,W,1,37.8,7,19,0.368,3,7,0.429,3,4,0.75,1,5,6,1,0,0,3,2,20,8.2,22.0,RJ Barrett,4,12,0.3333333333333333
1932,10/26/2022,22.367123287671234,W,1,38.516666666666666,9,21,0.429,0,5,0.0,4,4,1.0,4,4,8,1,0,1,4,1,22,11.9,8.0,RJ Barrett,9,16,0.5625
1933,10/28/2022,22.372602739726027,L,1,36.45,7,17,0.412,1,7,0.143,5,8,0.625,0,5,5,2,0,0,1,2,20,10.8,-8.0,RJ Barrett,6,10,0.6
1934,10/30/2022,22.378082191780823,L,1,32.516666666666666,6,10,0.6,3,4,0.75,0,0,,1,4,5,2,0,0,1,3,15,11.5,-9.0,RJ Barrett,3,6,0.5
1935,11/2/2022,22.386301369863013,L,1,33.016666666666666,8,18,0.444,2,6,0.333,1,1,1.0,1,4,5,5,1,0,2,2,19,13.2,-13.0,RJ Barrett,6,12,0.5
1936,11/4/2022,22.39178082191781,W,1,37.18333333333333,8,16,0.5,2,8,0.25,4,6,0.667,0,9,9,2,1,0,2,2,22,15.5,1.0,RJ Barrett,6,8,0.75
1937,11/5/2022,22.394520547945206,L,1,36.53333333333333,9,15,0.6,3,5,0.6,6,6,1.0,0,4,4,4,1,0,6,2,27,18.3,-14.0,RJ Barrett,6,10,0.6
1938,11/7/2022,22.4,W,1,36.8,7,18,0.389,3,7,0.429,5,6,0.833,0,5,5,5,2,0,1,0,22,17.8,4.0,RJ Barrett,4,11,0.36363636363636365
1939,11/9/2022,22.405479452054795,L,1,30.233333333333334,5,14,0.357,2,4,0.5,4,8,0.5,2,4,6,3,1,0,3,3,16,8.1,-22.0,RJ Barrett,3,10,0.3
1940,11/11/2022,22.410958904109588,W,1,37.516666666666666,10,17,0.588,3,8,0.375,7,8,0.875,1,4,5,5,0,0,1,3,30,24.9,11.0,RJ Barrett,7,9,0.7777777777777778
1941,11/13/2022,22.416438356164385,L,1,19.416666666666668,2,10,0.2,0,2,0.0,0,0,,1,0,1,0,1,0,2,4,4,-4.1,-14.0,RJ Barrett,2,8,0.25
1942,11/15/2022,22.421917808219177,W,1,37.46666666666667,5,18,0.278,0,5,0.0,8,14,0.571,0,3,3,4,0,0,1,2,18,6.9,3.0,RJ Barrett,5,13,0.38461538461538464
1943,11/16/2022,22.424657534246574,W,1,30.983333333333334,4,18,0.222,0,9,0.0,3,4,0.75,0,3,3,2,1,0,1,3,11,0.7,-18.0,RJ Barrett,4,9,0.4444444444444444
1944,11/18/2022,22.43013698630137,L,1,39.666666666666664,6,19,0.316,1,6,0.167,5,5,1.0,0,4,4,5,0,0,3,2,18,8.0,-10.0,RJ Barrett,5,13,0.38461538461538464
1945,11/20/2022,22.435616438356163,L,1,26.85,3,11,0.273,1,3,0.333,5,6,0.833,2,2,4,2,0,0,1,2,12,6.7,-24.0,RJ Barrett,2,8,0.25
1946,11/21/2022,22.438356164383563,W,1,37.483333333333334,10,16,0.625,3,4,0.75,2,2,1.0,2,6,8,2,1,0,6,3,25,16.2,3.0,RJ Barrett,7,12,0.5833333333333334
1947,11/25/2022,22.44931506849315,L,1,44.03333333333333,6,22,0.273,1,7,0.143,6,8,0.75,1,9,10,5,1,0,3,3,19,8.9,-6.0,RJ Barrett,5,15,0.3333333333333333
1948,11/27/2022,22.454794520547946,L,1,37.06666666666667,9,17,0.529,2,6,0.333,2,2,1.0,1,6,7,4,0,0,2,1,22,16.6,-8.0,RJ Barrett,7,11,0.6363636363636364
1949,10/19/2022,23.339726027397262,L,0,16.916666666666668,0,6,0.0,0,3,0.0,0,0,,0,3,3,0,0,0,0,0,0,-3.3,-6.0,Immanuel Quickley,0,3,0.0
1950,10/21/2022,23.345205479452055,W,0,27.083333333333332,8,14,0.571,3,8,0.375,1,1,1.0,1,6,7,7,0,0,3,2,20,17.0,27.0,Immanuel Quickley,5,6,0.8333333333333334
1951,10/24/2022,23.353424657534248,W,0,23.216666666666665,0,5,0.0,0,4,0.0,0,0,,1,5,6,8,1,0,2,2,0,2.5,0.0,Immanuel Quickley,0,1,0.0
1952,10/26/2022,23.35890410958904,W,0,18.933333333333334,3,6,0.5,2,3,0.667,3,4,0.75,1,2,3,3,0,0,3,1,11,7.6,-5.0,Immanuel Quickley,1,3,0.3333333333333333
1953,10/28/2022,23.364383561643837,L,0,27.9,5,11,0.455,2,4,0.5,2,4,0.5,1,3,4,3,3,1,1,1,14,13.5,11.0,Immanuel Quickley,3,7,0.42857142857142855
1954,10/30/2022,23.36986301369863,L,0,19.116666666666667,2,7,0.286,1,4,0.25,2,3,0.667,0,3,3,3,0,0,1,1,7,4.1,-6.0,Immanuel Quickley,1,3,0.3333333333333333
1955,11/2/2022,23.378082191780823,L,0,29.333333333333332,3,7,0.429,1,3,0.333,4,4,1.0,2,14,16,4,0,0,2,2,11,12.9,7.0,Immanuel Quickley,2,4,0.5
1956,11/4/2022,23.383561643835616,W,0,21.2,1,7,0.143,1,4,0.25,1,1,1.0,0,6,6,2,2,0,4,2,4,-0.1,-5.0,Immanuel Quickley,0,3,0.0
1957,11/5/2022,23.386301369863013,L,0,13.266666666666667,2,6,0.333,0,2,0.0,0,0,,0,2,2,1,1,0,0,0,4,2.9,-16.0,Immanuel Quickley,2,4,0.5
1958,11/7/2022,23.39178082191781,W,0,16.683333333333334,3,6,0.5,1,2,0.5,2,2,1.0,1,3,4,1,2,0,1,2,9,8.5,15.0,Immanuel Quickley,2,4,0.5
1959,11/9/2022,23.397260273972602,L,0,19.733333333333334,1,8,0.125,0,6,0.0,0,0,,0,4,4,4,1,0,1,3,2,-0.4,-17.0,Immanuel Quickley,1,2,0.5
1960,11/11/2022,23.4027397260274,W,0,21.25,3,6,0.5,2,3,0.667,0,0,,1,4,5,1,2,0,0,4,8,8.0,2.0,Immanuel Quickley,1,3,0.3333333333333333
1961,11/13/2022,23.40821917808219,L,0,23.383333333333333,8,17,0.471,1,4,0.25,7,8,0.875,0,1,1,5,3,1,0,3,24,21.2,5.0,Immanuel Quickley,7,13,0.5384615384615384
1962,11/15/2022,23.413698630136988,W,0,25.516666666666666,5,10,0.5,3,6,0.5,0,0,,0,3,3,2,4,0,0,5,13,12.3,18.0,Immanuel Quickley,2,4,0.5
1963,11/16/2022,23.416438356164385,W,0,27.816666666666666,2,5,0.4,0,2,0.0,2,3,0.667,0,5,5,6,1,0,1,1,6,8.2,11.0,Immanuel Quickley,2,3,0.6666666666666666
1964,11/18/2022,23.421917808219177,L,0,26.716666666666665,0,5,0.0,0,3,0.0,6,6,1.0,0,6,6,1,2,0,3,0,6,4.0,-8.0,Immanuel Quickley,0,2,0.0
1965,11/20/2022,23.427397260273974,L,0,28.0,1,6,0.167,0,2,0.0,4,4,1.0,0,1,1,2,0,1,2,0,6,2.6,-1.0,Immanuel Quickley,1,4,0.25
1966,11/21/2022,23.43013698630137,W,0,25.2,6,8,0.75,4,5,0.8,2,2,1.0,1,2,3,4,1,0,0,3,18,18.7,11.0,Immanuel Quickley,2,3,0.6666666666666666
1967,11/25/2022,23.44109589041096,L,0,32.416666666666664,6,17,0.353,4,10,0.4,2,2,1.0,1,3,4,5,1,0,1,4,18,12.0,7.0,Immanuel Quickley,2,7,0.2857142857142857
1968,11/27/2022,23.446575342465753,L,0,8.9,2,3,0.667,1,1,1.0,1,1,1.0,1,2,3,2,0,0,0,0,6,7.4,2.0,Immanuel Quickley,1,2,0.5
1969,10/19/2022,24.627397260273973,L,0,13.483333333333333,1,3,0.333,0,0,,0,0,,0,3,3,1,0,0,1,1,2,0.5,-7.0,Obi Toppin,1,3,0.3333333333333333
1970,10/21/2022,24.632876712328766,W,0,20.733333333333334,7,12,0.583,2,5,0.4,0,0,,1,3,4,3,0,1,0,1,16,14.4,25.0,Obi Toppin,5,7,0.7142857142857143
1971,10/24/2022,24.64109589041096,W,0,13.883333333333333,4,6,0.667,0,1,0.0,2,2,1.0,2,2,4,1,1,0,1,0,10,10.1,9.0,Obi Toppin,4,5,0.8
1972,10/26/2022,24.646575342465752,W,0,13.166666666666666,3,6,0.5,3,4,0.75,0,0,,1,2,3,2,0,0,0,1,9,8.3,-3.0,Obi Toppin,0,2,0.0
1973,10/28/2022,24.65205479452055,L,0,16.766666666666666,4,7,0.571,3,5,0.6,0,0,,0,3,3,2,0,0,0,0,11,10.0,3.0,Obi Toppin,1,2,0.5
1974,10/30/2022,24.65753424657534,L,0,15.2,4,7,0.571,1,3,0.333,0,0,,0,4,4,0,0,0,3,2,9,3.1,-5.0,Obi Toppin,3,4,0.75
1975,11/2/2022,24.665753424657535,L,0,18.45,5,13,0.385,2,6,0.333,0,0,,2,1,3,0,0,0,0,0,12,6.6,-3.0,Obi Toppin,3,7,0.42857142857142855
1976,11/4/2022,24.671232876712327,W,0,20.233333333333334,6,10,0.6,3,6,0.5,2,2,1.0,0,3,3,0,0,0,3,2,17,9.5,6.0,Obi Toppin,3,4,0.75
1977,11/5/2022,24.673972602739727,L,0,14.916666666666666,3,9,0.333,1,5,0.2,0,0,,2,4,6,0,1,1,0,1,7,5.8,-22.0,Obi Toppin,2,4,0.5
1978,11/7/2022,24.67945205479452,W,0,25.766666666666666,4,10,0.4,3,8,0.375,4,4,1.0,1,6,7,3,4,0,2,1,15,15.8,13.0,Obi Toppin,1,2,0.5
1979,11/9/2022,24.684931506849313,L,0,20.766666666666666,2,7,0.286,0,2,0.0,1,1,1.0,1,3,4,1,1,0,0,0,5,4.2,-19.0,Obi Toppin,2,5,0.4
1980,11/11/2022,24.69041095890411,W,0,22.383333333333333,3,9,0.333,2,7,0.286,0,0,,1,4,5,1,1,1,1,2,8,5.4,-5.0,Obi Toppin,1,2,0.5
1981,11/13/2022,24.695890410958903,L,0,14.75,4,5,0.8,2,3,0.667,0,0,,0,2,2,0,0,0,3,1,10,5.3,0.0,Obi Toppin,2,2,1.0
1982,11/15/2022,24.7013698630137,W,0,18.05,3,4,0.75,3,4,0.75,0,0,,1,5,6,4,0,0,0,1,9,12.0,23.0,Obi Toppin,0,0,
1983,11/16/2022,24.704109589041096,W,0,23.133333333333333,3,8,0.375,1,5,0.2,0,0,,0,3,3,0,0,0,1,0,7,2.5,7.0,Obi Toppin,2,3,0.6666666666666666
1984,11/18/2022,24.70958904109589,L,0,18.983333333333334,0,5,0.0,0,3,0.0,1,2,0.5,0,5,5,0,0,1,1,3,1,-2.9,-2.0,Obi Toppin,0,2,0.0
1985,11/20/2022,24.715068493150685,L,0,16.35,0,4,0.0,0,2,0.0,0,0,,0,3,3,1,0,0,0,1,0,-1.6,-15.0,Obi Toppin,0,2,0.0
1986,11/21/2022,24.71780821917808,W,0,17.65,2,11,0.182,1,5,0.2,0,0,,1,2,3,1,1,0,0,4,5,-0.5,4.0,Obi Toppin,1,6,0.16666666666666666
1987,11/25/2022,24.72876712328767,L,0,14.483333333333333,1,3,0.333,1,3,0.333,0,0,,0,2,2,1,0,0,0,2,3,1.8,14.0,Obi Toppin,0,0,
1988,11/27/2022,24.734246575342464,L,0,14.6,4,8,0.5,1,4,0.25,0,0,,1,2,3,0,0,1,1,1,9,5.6,-2.0,Obi Toppin,3,4,0.75
1989,10/19/2022,24.457534246575342,L,0,40.25,7,11,0.636,0,3,0.0,2,2,1.0,7,1,8,4,0,1,3,5,16,14.8,1.0,Isaiah Hartenstein,7,8,0.875
1990,10/21/2022,24.463013698630135,W,0,21.166666666666668,2,4,0.5,1,2,0.5,1,2,0.5,4,7,11,0,2,1,1,4,6,8.6,21.0,Isaiah Hartenstein,1,2,0.5
1991,10/24/2022,24.471232876712328,W,0,18.316666666666666,2,5,0.4,0,0,,3,4,0.75,4,5,9,0,1,0,1,1,7,7.8,6.0,Isaiah Hartenstein,2,5,0.4
1992,10/26/2022,24.476712328767125,W,0,15.933333333333334,4,5,0.8,0,1,0.0,0,0,,2,1,3,0,1,1,0,2,8,8.7,-7.0,Isaiah Hartenstein,4,4,1.0
1993,10/28/2022,24.482191780821918,L,0,27.566666666666666,3,8,0.375,0,1,0.0,0,0,,2,6,8,2,1,2,1,3,6,6.4,-5.0,Isaiah Hartenstein,3,7,0.42857142857142855
1994,10/30/2022,24.487671232876714,L,0,27.233333333333334,6,10,0.6,0,1,0.0,0,0,,5,4,9,1,1,1,1,3,12,12.3,-6.0,Isaiah Hartenstein,6,9,0.6666666666666666
1995,11/2/2022,24.495890410958904,L,0,24.933333333333334,1,4,0.25,1,2,0.5,0,0,,2,4,6,1,1,4,1,2,3,5.9,-4.0,Isaiah Hartenstein,0,2,0.0
1996,11/4/2022,24.5013698630137,W,0,20.733333333333334,4,8,0.5,0,1,0.0,0,0,,4,6,10,0,1,3,0,1,8,11.3,2.0,Isaiah Hartenstein,4,7,0.5714285714285714
1997,11/5/2022,24.504109589041096,L,1,38.45,5,6,0.833,0,0,,0,0,,3,11,14,1,0,1,0,3,10,13.4,7.0,Isaiah Hartenstein,5,6,0.8333333333333334
1998,11/7/2022,24.50958904109589,W,0,20.85,1,3,0.333,0,1,0.0,2,2,1.0,2,4,6,2,0,1,1,4,4,4.4,9.0,Isaiah Hartenstein,1,2,0.5
1999,11/9/2022,24.515068493150686,L,0,14.7,1,2,0.5,0,0,,0,0,,3,2,5,0,0,0,1,3,2,1.5,-6.0,Isaiah Hartenstein,1,2,0.5
2000,11/11/2022,24.52054794520548,W,1,32.516666666666666,3,5,0.6,0,0,,0,0,,5,7,12,0,0,1,3,5,6,5.0,9.0,Isaiah Hartenstein,3,5,0.6
2001,11/13/2022,24.526027397260275,L,1,22.883333333333333,5,8,0.625,1,2,0.5,3,4,0.75,5,2,7,1,1,0,2,1,14,13.4,-19.0,Isaiah Hartenstein,4,6,0.6666666666666666
2002,11/15/2022,24.53150684931507,W,1,22.166666666666668,1,4,0.25,0,1,0.0,0,0,,2,7,9,1,1,1,0,4,2,3.9,6.0,Isaiah Hartenstein,1,3,0.3333333333333333
2003,11/16/2022,24.534246575342465,W,1,21.783333333333335,0,1,0.0,0,0,,0,0,,0,3,3,0,1,1,0,4,0,0.3,-6.0,Isaiah Hartenstein,0,1,0.0
2004,11/18/2022,24.53972602739726,L,1,17.4,3,4,0.75,1,1,1.0,1,1,1.0,2,3,5,0,1,1,1,3,8,8.2,-9.0,Isaiah Hartenstein,2,3,0.6666666666666666
2005,11/20/2022,24.545205479452054,L,1,15.366666666666667,2,5,0.4,0,0,,3,3,1.0,1,2,3,1,1,1,1,2,7,6.2,-11.0,Isaiah Hartenstein,2,5,0.4
2006,11/21/2022,24.54794520547945,W,0,15.8,1,4,0.25,0,1,0.0,0,0,,5,3,8,0,1,1,0,0,2,5.7,3.0,Isaiah Hartenstein,1,3,0.3333333333333333
2007,11/25/2022,24.55890410958904,L,0,16.9,2,3,0.667,0,0,,2,2,1.0,0,2,2,2,2,0,0,3,6,7.5,-6.0,Isaiah Hartenstein,2,3,0.6666666666666666
2008,11/27/2022,24.564383561643837,L,0,15.05,2,3,0.667,0,1,0.0,0,0,,2,2,4,0,0,1,1,2,4,3.6,-3.0,Isaiah Hartenstein,2,2,1.0
2009,10/19/2022,34.04109589041096,L,0,12.05,2,8,0.25,0,3,0.0,0,0,,1,3,4,2,0,1,1,0,4,1.9,-4.0,Derrick Rose,2,5,0.4
2010,10/21/2022,34.04657534246575,W,0,16.216666666666665,4,6,0.667,3,4,0.75,2,2,1.0,0,3,3,6,0,0,2,2,13,12.7,23.0,Derrick Rose,1,2,0.5
2011,10/24/2022,34.054794520547944,W,0,8.716666666666667,1,4,0.25,1,3,0.333,0,0,,0,0,0,0,0,0,0,1,3,0.2,-10.0,Derrick Rose,0,1,0.0
2012,10/26/2022,34.06027397260274,W,0,12.416666666666666,5,7,0.714,1,2,0.5,1,1,1.0,0,2,2,2,0,0,1,0,12,10.1,-4.0,Derrick Rose,4,5,0.8
2013,10/28/2022,34.06575342465754,L,0,14.866666666666667,5,8,0.625,2,3,0.667,0,0,,1,3,4,4,0,0,1,0,12,11.8,8.0,Derrick Rose,3,5,0.6
2014,10/30/2022,34.07123287671233,L,0,14.05,3,5,0.6,1,2,0.5,0,0,,0,1,1,2,1,0,1,1,7,6.0,-15.0,Derrick Rose,2,3,0.6666666666666666
2015,11/2/2022,34.07945205479452,L,0,17.0,1,4,0.25,1,2,0.5,0,0,,0,1,1,1,0,0,1,1,3,0.2,-9.0,Derrick Rose,0,2,0.0
2016,11/4/2022,34.084931506849315,W,0,6.983333333333333,0,2,0.0,0,1,0.0,0,0,,0,0,0,1,0,1,4,1,0,-4.4,4.0,Derrick Rose,0,1,0.0
2017,11/5/2022,34.087671232876716,L,0,13.516666666666667,4,10,0.4,2,3,0.667,0,0,,1,2,3,1,1,0,1,0,10,6.6,3.0,Derrick Rose,2,7,0.2857142857142857
2018,11/7/2022,34.09315068493151,W,0,13.566666666666666,1,10,0.1,0,5,0.0,0,0,,1,2,3,1,3,0,0,0,2,0.4,11.0,Derrick Rose,1,5,0.2
2019,11/9/2022,34.0986301369863,L,0,10.933333333333334,0,4,0.0,0,3,0.0,0,0,,0,2,2,2,0,0,0,0,0,-0.8,-8.0,Derrick Rose,0,1,0.0
2020,11/11/2022,34.104109589041094,W,0,15.316666666666666,2,7,0.286,0,1,0.0,4,4,1.0,0,0,0,2,0,0,1,1,8,3.9,1.0,Derrick Rose,2,6,0.3333333333333333
2021,11/13/2022,34.10958904109589,L,0,16.733333333333334,3,6,0.5,1,2,0.5,0,0,,0,2,2,4,0,0,2,1,7,5.0,3.0,Derrick Rose,2,4,0.5
2022,11/15/2022,34.11506849315069,W,0,13.6,3,6,0.5,0,1,0.0,0,0,,0,0,0,3,0,0,1,0,6,4.1,-2.0,Derrick Rose,3,5,0.6
2023,11/16/2022,34.11780821917808,W,0,16.883333333333333,5,10,0.5,2,3,0.667,1,1,1.0,1,0,1,3,0,1,0,2,13,10.7,2.0,Derrick Rose,3,7,0.42857142857142855
2024,11/18/2022,34.12328767123287,L,0,13.8,3,7,0.429,1,3,0.333,2,2,1.0,0,0,0,2,0,2,0,0,9,8.1,-10.0,Derrick Rose,2,4,0.5
2025,11/20/2022,34.12876712328767,L,0,7.85,3,5,0.6,1,2,0.5,0,0,,2,2,4,0,0,0,0,0,7,6.7,3.0,Derrick Rose,2,3,0.6666666666666666
2026,11/27/2022,34.14794520547945,L,0,11.7,3,7,0.429,0,2,0.0,0,0,,0,1,1,0,0,0,0,2,6,1.8,-3.0,Derrick Rose,3,5,0.6
2027,10/19/2022,23.13150684931507,L,0,28.033333333333335,9,15,0.6,3,6,0.5,1,1,1.0,1,4,5,0,3,1,2,2,22,17.9,-1.0,Cam Reddish,6,9,0.6666666666666666
2028,10/21/2022,23.136986301369863,W,0,18.583333333333332,3,8,0.375,0,2,0.0,0,0,,0,4,4,0,0,0,2,3,6,-0.4,12.0,Cam Reddish,3,6,0.5
2029,10/24/2022,23.145205479452056,W,0,14.4,3,4,0.75,1,1,1.0,0,0,,1,1,2,2,0,0,1,3,7,5.6,2.0,Cam Reddish,2,3,0.6666666666666666
2030,10/26/2022,23.15068493150685,W,0,24.516666666666666,1,3,0.333,1,2,0.5,2,2,1.0,0,3,3,0,0,1,2,4,5,1.3,1.0,Cam Reddish,0,1,0.0
2031,10/28/2022,23.156164383561645,L,0,11.55,1,5,0.2,0,2,0.0,0,0,,0,2,2,1,0,0,0,0,2,0.2,-3.0,Cam Reddish,1,3,0.3333333333333333
2032,10/30/2022,23.161643835616438,L,0,16.333333333333332,3,6,0.5,1,2,0.5,0,0,,0,0,0,1,0,1,0,1,7,5.0,-8.0,Cam Reddish,2,4,0.5
2033,11/2/2022,23.16986301369863,L,0,14.983333333333333,2,5,0.4,1,4,0.25,1,2,0.5,0,0,0,1,0,0,0,0,6,3.6,0.0,Cam Reddish,1,1,1.0
2034,11/4/2022,23.175342465753424,W,0,15.166666666666666,4,4,1.0,1,1,1.0,2,2,1.0,0,0,0,3,1,1,0,3,11,12.4,19.0,Cam Reddish,3,3,1.0
2035,11/5/2022,23.17808219178082,L,1,37.083333333333336,1,6,0.167,1,2,0.5,1,2,0.5,1,1,2,2,1,1,1,1,4,2.5,4.0,Cam Reddish,0,4,0.0
2036,11/7/2022,23.183561643835617,W,1,28.733333333333334,2,7,0.286,2,5,0.4,2,2,1.0,0,0,0,0,0,0,0,2,8,3.1,-2.0,Cam Reddish,0,2,0.0
2037,11/9/2022,23.18904109589041,L,1,17.65,0,7,0.0,0,4,0.0,0,0,,0,0,0,1,0,0,0,2,0,-5.0,-17.0,Cam Reddish,0,3,0.0
2038,11/11/2022,23.194520547945206,W,1,17.716666666666665,2,6,0.333,0,3,0.0,0,0,,0,3,3,1,0,0,0,1,4,1.8,7.0,Cam Reddish,2,3,0.6666666666666666
2039,11/13/2022,23.2,L,1,32.63333333333333,10,17,0.588,2,5,0.4,4,4,1.0,1,2,3,2,4,1,1,0,26,24.5,2.0,Cam Reddish,8,12,0.6666666666666666
2040,11/15/2022,23.205479452054796,W,1,33.016666666666666,7,13,0.538,2,5,0.4,3,3,1.0,0,1,1,1,1,1,2,1,19,13.0,-7.0,Cam Reddish,5,8,0.625
2041,11/16/2022,23.208219178082192,W,1,37.2,3,5,0.6,0,1,0.0,4,5,0.8,1,2,3,0,2,1,0,3,10,10.1,13.0,Cam Reddish,3,4,0.75
2042,11/18/2022,23.213698630136985,L,1,25.383333333333333,3,8,0.375,1,4,0.25,4,4,1.0,2,0,2,1,2,0,0,1,11,10.3,-12.0,Cam Reddish,2,4,0.5
2043,11/27/2022,23.23835616438356,L,0,23.85,4,6,0.667,1,2,0.5,2,2,1.0,0,0,0,2,1,0,0,3,11,9.6,4.0,Cam Reddish,3,4,0.75
2044,10/21/2022,24.002739726027396,W,0,3.4166666666666665,0,0,,0,0,,0,0,,0,1,1,0,0,0,0,0,0,0.3,-2.0,Jericho Sims,0,0,
2045,10/28/2022,24.02191780821918,L,0,0.016666666666666666,0,0,,0,0,,0,0,,0,0,0,0,0,0,0,0,0,0.0,1.0,Jericho Sims,0,0,
2046,11/4/2022,24.041095890410958,W,0,4.9,0,0,,0,0,,0,0,,1,0,1,0,0,0,0,0,0,0.7,-12.0,Jericho Sims,0,0,
2047,11/5/2022,24.043835616438358,L,0,2.533333333333333,1,1,1.0,0,0,,0,0,,0,0,0,0,0,1,0,1,2,2.0,-7.0,Jericho Sims,1,1,1.0
2048,11/7/2022,24.04931506849315,W,1,16.866666666666667,2,2,1.0,0,0,,0,0,,1,3,4,0,0,1,1,5,4,2.7,0.0,Jericho Sims,2,2,1.0
2049,11/9/2022,24.054794520547944,L,1,26.616666666666667,3,3,1.0,0,0,,1,2,0.5,3,3,6,0,1,3,0,3,7,10.6,-7.0,Jericho Sims,3,3,1.0
2050,11/11/2022,24.06027397260274,W,0,8.116666666666667,1,1,1.0,0,0,,0,0,,2,2,4,0,0,1,1,4,2,1.8,1.0,Jericho Sims,1,1,1.0
2051,11/13/2022,24.065753424657533,L,0,25.116666666666667,4,4,1.0,0,0,,0,0,,3,5,8,1,0,0,0,2,8,10.3,9.0,Jericho Sims,4,4,1.0
2052,11/15/2022,24.07123287671233,W,0,24.566666666666666,5,7,0.714,0,0,,1,1,1.0,8,5,13,2,1,0,0,5,11,15.6,-3.0,Jericho Sims,5,7,0.7142857142857143
2053,11/16/2022,24.073972602739726,W,0,18.8,2,3,0.667,0,0,,0,0,,1,5,6,2,3,2,0,0,4,10.7,-2.0,Jericho Sims,2,3,0.6666666666666666
2054,11/18/2022,24.07945205479452,L,0,27.25,4,7,0.571,0,0,,2,2,1.0,5,5,10,0,0,3,2,3,10,10.6,3.0,Jericho Sims,4,7,0.5714285714285714
2055,11/20/2022,24.084931506849315,L,0,16.0,1,2,0.5,0,0,,3,4,0.75,3,2,5,1,0,1,1,3,5,5.5,-10.0,Jericho Sims,1,2,0.5
2056,11/21/2022,24.087671232876712,W,0,15.2,3,5,0.6,0,0,,0,0,,3,4,7,0,0,1,1,3,6,5.5,-1.0,Jericho Sims,3,5,0.6
2057,11/25/2022,24.0986301369863,L,0,12.6,2,3,0.667,0,0,,1,1,1.0,2,0,2,0,0,2,0,2,5,5.7,-7.0,Jericho Sims,2,3,0.6666666666666666
2058,10/19/2022,29.972602739726028,L,1,33.0,4,11,0.364,3,6,0.5,3,3,1.0,1,3,4,3,2,0,0,2,14,12.8,-1.0,Evan Fournier,1,5,0.2
2059,10/21/2022,29.97808219178082,W,1,19.95,3,8,0.375,2,5,0.4,0,0,,0,1,1,2,1,1,1,4,8,4.4,-1.0,Evan Fournier,1,3,0.3333333333333333
2060,10/24/2022,29.986301369863014,W,1,26.833333333333332,2,8,0.25,2,8,0.25,2,2,1.0,0,2,2,2,0,0,0,2,8,4.4,8.0,Evan Fournier,0,0,
2061,10/26/2022,29.991780821917807,W,1,24.083333333333332,6,11,0.545,2,6,0.333,0,0,,0,3,3,2,1,0,2,6,14,7.6,4.0,Evan Fournier,4,5,0.8
2062,10/28/2022,29.997260273972604,L,1,20.066666666666666,4,12,0.333,3,7,0.429,0,0,,0,4,4,0,0,0,2,1,11,3.0,-22.0,Evan Fournier,1,5,0.2
2063,10/30/2022,30.002739726027396,L,1,28.033333333333335,6,9,0.667,3,5,0.6,1,2,0.5,0,3,3,1,1,0,0,2,16,13.5,-3.0,Evan Fournier,3,4,0.75
2064,11/2/2022,30.01095890410959,L,1,18.666666666666668,1,6,0.167,1,4,0.25,0,0,,0,2,2,1,0,0,2,3,3,-2.7,-20.0,Evan Fournier,0,2,0.0
2065,11/4/2022,30.016438356164382,W,0,14.383333333333333,1,4,0.25,0,2,0.0,0,0,,0,2,2,2,0,1,1,1,2,0.9,-1.0,Evan Fournier,1,2,0.5
2066,11/5/2022,30.019178082191782,L,0,10.9,1,1,1.0,1,1,1.0,0,0,,0,1,1,1,1,0,2,2,3,1.9,-19.0,Evan Fournier,0,0,
2067,11/7/2022,30.024657534246575,W,0,12.083333333333334,1,3,0.333,0,2,0.0,0,0,,0,1,1,3,2,0,2,1,2,2.3,15.0,Evan Fournier,1,1,1.0
2068,11/9/2022,30.03013698630137,L,0,20.0,2,7,0.286,2,5,0.4,0,0,,0,2,2,2,0,1,1,3,6,2.4,-6.0,Evan Fournier,0,2,0.0
2069,11/11/2022,30.035616438356165,W,0,11.8,0,5,0.0,0,3,0.0,3,4,0.75,1,1,2,1,0,0,1,0,3,-0.2,-2.0,Evan Fournier,0,2,0.0
2070,11/13/2022,30.041095890410958,L,0,19.916666666666668,0,5,0.0,0,3,0.0,0,0,,0,0,0,2,1,0,0,1,0,-1.5,0.0,Evan Fournier,0,2,0.0
2071,10/19/2022,24.55068493150685,L,1,12.666666666666666,2,3,0.667,0,0,,0,1,0.0,2,0,2,0,0,2,0,5,4,3.1,-7.0,Mitchell Robinson,2,3,0.6666666666666666
2072,10/21/2022,24.556164383561644,W,1,23.416666666666668,3,3,1.0,0,0,,2,4,0.5,4,1,5,1,0,2,2,2,8,8.7,5.0,Mitchell Robinson,3,3,1.0
2073,10/24/2022,24.564383561643837,W,1,29.683333333333334,6,7,0.857,0,0,,2,5,0.4,5,1,6,0,1,3,0,3,14,16.0,7.0,Mitchell Robinson,6,7,0.8571428571428571
2074,10/26/2022,24.56986301369863,W,1,37.016666666666666,4,4,1.0,0,0,,1,2,0.5,2,6,8,1,0,6,0,2,9,14.7,8.0,Mitchell Robinson,4,4,1.0
2075,10/28/2022,24.575342465753426,L,1,20.4,2,5,0.4,0,0,,1,2,0.5,5,4,9,1,0,2,0,5,5,6.7,-7.0,Mitchell Robinson,2,5,0.4
2076,10/30/2022,24.58082191780822,L,1,20.766666666666666,2,6,0.333,0,0,,0,0,,6,1,7,2,1,0,2,5,4,3.5,-7.0,Mitchell Robinson,2,6,0.3333333333333333
2077,11/2/2022,24.589041095890412,L,1,18.433333333333334,4,5,0.8,0,0,,0,0,,3,9,12,2,1,3,1,4,8,12.8,-15.0,Mitchell Robinson,4,5,0.8
2078,11/4/2022,24.594520547945205,W,1,11.766666666666667,0,0,,0,0,,0,0,,1,1,2,1,0,0,0,3,0,0.5,-2.0,Mitchell Robinson,0,0,
2079,11/20/2022,24.638356164383563,L,0,16.633333333333333,1,2,0.5,0,0,,0,0,,0,4,4,0,1,2,0,1,2,4.2,0.0,Mitchell Robinson,1,2,0.5
2080,11/21/2022,24.64109589041096,W,1,13.166666666666666,1,1,1.0,0,0,,1,2,0.5,0,2,2,1,1,0,0,2,3,3.8,5.0,Mitchell Robinson,1,1,1.0
2081,11/25/2022,24.65205479452055,L,1,23.083333333333332,6,7,0.857,0,0,,0,2,0.0,5,3,8,0,0,2,1,6,12,11.1,7.0,Mitchell Robinson,6,7,0.8571428571428571
2082,11/27/2022,24.65753424657534,L,1,31.566666666666666,6,7,0.857,0,0,,4,7,0.571,4,3,7,0,0,5,0,4,16,17.9,2.0,Mitchell Robinson,6,7,0.8571428571428571
2083,11/2/2022,22.487671232876714,L,0,4.633333333333333,0,1,0.0,0,1,0.0,0,0,,0,0,0,1,0,0,0,1,0,-0.4,6.0,Quentin Grimes,0,0,
2084,11/4/2022,22.493150684931507,W,1,15.016666666666667,0,1,0.0,0,1,0.0,2,2,1.0,0,1,1,1,0,1,0,2,2,2.2,-20.0,Quentin Grimes,0,0,
2085,11/9/2022,22.506849315068493,L,0,4.6,1,1,1.0,1,1,1.0,0,0,,0,0,0,0,0,0,1,0,3,1.7,5.0,Quentin Grimes,0,0,
2086,11/11/2022,22.512328767123286,W,0,7.716666666666667,2,4,0.5,1,3,0.333,0,0,,1,1,2,0,0,0,1,3,5,1.8,0.0,Quentin Grimes,1,1,1.0
2087,11/13/2022,22.517808219178082,L,0,7.95,0,2,0.0,0,2,0.0,0,0,,0,0,0,0,0,0,0,0,0,-1.4,-6.0,Quentin Grimes,0,0,
2088,11/18/2022,22.53150684931507,L,0,2.1166666666666667,1,1,1.0,1,1,1.0,0,0,,0,0,0,0,0,0,0,0,3,2.7,5.0,Quentin Grimes,0,0,
2089,11/20/2022,22.536986301369865,L,1,32.18333333333333,4,10,0.4,1,5,0.2,1,2,0.5,0,5,5,8,0,1,1,2,10,10.2,-12.0,Quentin Grimes,3,5,0.6
2090,11/21/2022,22.53972602739726,W,1,33.4,4,10,0.4,0,4,0.0,0,0,,1,4,5,1,2,0,1,5,8,4.2,9.0,Quentin Grimes,4,6,0.6666666666666666
2091,11/25/2022,22.55068493150685,L,1,29.966666666666665,3,6,0.5,1,4,0.25,0,0,,2,3,5,5,0,1,2,5,7,6.5,-4.0,Quentin Grimes,2,2,1.0
2092,11/27/2022,22.556164383561644,L,1,26.366666666666667,2,7,0.286,1,4,0.25,0,0,,0,2,2,4,1,0,1,4,5,2.7,-9.0,Quentin Grimes,1,3,0.3333333333333333
2093,10/21/2022,22.117808219178084,W,0,3.4166666666666665,0,0,,0,0,,0,2,0.0,0,0,0,0,0,0,0,1,0,-1.2,-2.0,Miles McBride,0,0,
2094,10/28/2022,22.136986301369863,L,0,0.016666666666666666,0,0,,0,0,,0,0,,0,0,0,0,0,0,0,0,0,0.0,0.0,Miles McBride,0,0,
2095,11/7/2022,22.164383561643834,W,0,0.85,0,0,,0,0,,0,0,,0,0,0,0,0,0,0,0,0,0.0,-3.0,Miles McBride,0,0,
2096,11/9/2022,22.16986301369863,L,0,6.1,0,2,0.0,0,2,0.0,0,0,,0,0,0,2,0,0,0,0,0,0.0,3.0,Miles McBride,0,0,
2097,11/18/2022,22.194520547945206,L,0,2.5166666666666666,1,3,0.333,0,1,0.0,0,0,,0,1,1,1,0,0,0,0,2,1.3,5.0,Miles McBride,1,2,0.5
2098,11/20/2022,22.2,L,0,13.9,4,6,0.667,1,2,0.5,0,0,,0,0,0,0,1,0,0,2,9,6.6,-10.0,Miles McBride,3,4,0.75
2099,11/21/2022,22.202739726027396,W,0,14.616666666666667,1,6,0.167,0,3,0.0,1,2,0.5,0,1,1,2,2,0,1,2,3,0.7,3.0,Miles McBride,1,3,0.3333333333333333
2100,11/25/2022,22.213698630136985,L,0,11.7,2,3,0.667,0,1,0.0,0,0,,0,0,0,2,0,0,0,1,4,3.7,3.0,Miles McBride,2,2,1.0
2101,11/27/2022,22.21917808219178,L,0,0.7166666666666667,0,0,,0,0,,0,0,,0,0,0,0,0,0,0,1,0,-0.4,0.0,Miles McBride,0,0,
2102,10/21/2022,25.364383561643837,W,0,1.8166666666666667,1,1,1.0,1,1,1.0,0,0,,0,2,2,0,0,0,0,0,3,3.3,0.0,Svi Mykhailiuk,0,0,
2103,11/7/2022,25.410958904109588,W,0,0.85,0,0,,0,0,,0,0,,0,0,0,0,0,0,0,0,0,0.0,-3.0,Svi Mykhailiuk,0,0,
2104,11/9/2022,25.416438356164385,L,0,3.216666666666667,2,2,1.0,2,2,1.0,0,1,0.0,0,0,0,0,0,0,1,0,6,4.0,5.0,Svi Mykhailiuk,0,0,
2105,11/18/2022,25.44109589041096,L,0,2.1166666666666667,0,0,,0,0,,0,0,,0,0,0,0,0,0,0,0,0,0.0,5.0,Svi Mykhailiuk,0,0,
2106,11/20/2022,25.446575342465753,L,0,5.1,0,0,,0,0,,1,2,0.5,0,1,1,0,0,0,0,0,1,0.9,0.0,Svi Mykhailiuk,0,0,
2107,10/21/2022,28.572602739726026,W,0,1.8166666666666667,0,0,,0,0,,0,0,,0,0,0,0,0,0,0,1,0,-0.4,0.0,Ryan Arcidiacono,0,0,
2108,11/7/2022,28.61917808219178,W,0,0.85,0,0,,0,0,,0,0,,0,0,0,0,0,0,0,0,0,0.0,-3.0,Ryan Arcidiacono,0,0,
2109,11/9/2022,28.624657534246577,L,0,3.216666666666667,0,1,0.0,0,1,0.0,0,0,,0,2,2,1,1,0,0,0,0,1.6,5.0,Ryan Arcidiacono,0,0,
2110,11/18/2022,28.649315068493152,L,0,2.1166666666666667,0,0,,0,0,,0,0,,0,0,0,0,1,0,0,0,0,1.0,5.0,Ryan Arcidiacono,0,0,
2111,11/20/2022,28.654794520547945,L,0,5.933333333333334,0,2,0.0,0,1,0.0,0,0,,0,0,0,0,0,0,0,0,0,-1.4,3.0,Ryan Arcidiacono,0,1,0.0
2112,10/21/2022,19.153424657534245,W,0,0.95,0,1,0.0,0,1,0.0,0,0,,0,1,1,0,0,0,0,0,0,-0.4,-2.0,Trevor Keels,0,0,
2113,10/19/2022,25.410958904109588,W,1,33.05,6,12,0.5,3,7,0.429,2,2,1.0,0,4,4,4,2,0,1,3,17,14.8,4.0,Lauri Markkanen,3,5,0.6
2114,10/21/2022,25.416438356164385,W,1,39.13333333333333,10,23,0.435,2,10,0.2,2,2,1.0,5,8,13,5,0,1,1,1,24,20.6,7.0,Lauri Markkanen,8,13,0.6153846153846154
2115,10/23/2022,25.421917808219177,W,1,39.266666666666666,9,17,0.529,2,6,0.333,11,11,1.0,3,9,12,2,2,1,2,3,31,28.4,6.0,Lauri Markkanen,7,11,0.6363636363636364
2116,10/24/2022,25.424657534246574,L,1,30.9,7,19,0.368,0,6,0.0,0,3,0.0,3,3,6,1,0,0,1,0,14,5.0,1.0,Lauri Markkanen,7,13,0.5384615384615384
2117,10/26/2022,25.43013698630137,W,1,34.0,10,15,0.667,1,4,0.25,3,4,0.75,1,8,9,3,0,1,4,1,24,18.6,10.0,Lauri Markkanen,9,11,0.8181818181818182
2118,10/28/2022,25.435616438356163,L,1,25.933333333333334,7,14,0.5,3,6,0.5,0,0,,2,8,10,1,0,0,3,3,17,10.3,-10.0,Lauri Markkanen,4,8,0.5
2119,10/29/2022,25.438356164383563,W,1,37.93333333333333,9,21,0.429,2,9,0.222,3,3,1.0,2,7,9,5,1,1,2,1,23,18.2,9.0,Lauri Markkanen,7,12,0.5833333333333334
2120,10/31/2022,25.443835616438356,W,1,31.566666666666666,11,15,0.733,4,6,0.667,5,6,0.833,4,7,11,2,1,4,2,2,31,31.8,15.0,Lauri Markkanen,7,9,0.7777777777777778
2121,11/2/2022,25.44931506849315,L,1,33.53333333333333,6,10,0.6,0,4,0.0,2,3,0.667,0,7,7,0,0,0,2,3,14,7.9,3.0,Lauri Markkanen,6,6,1.0
2122,11/4/2022,25.454794520547946,W,1,32.7,9,17,0.529,3,9,0.333,6,6,1.0,3,10,13,4,1,1,1,1,27,26.9,4.0,Lauri Markkanen,6,8,0.75
2123,11/6/2022,25.46027397260274,W,1,33.35,5,9,0.556,1,3,0.333,7,7,1.0,2,7,9,3,1,1,2,3,18,17.8,8.0,Lauri Markkanen,4,6,0.6666666666666666
2124,11/7/2022,25.463013698630135,W,1,27.733333333333334,10,15,0.667,1,4,0.25,2,3,0.667,1,2,3,2,0,1,1,2,23,17.7,14.0,Lauri Markkanen,9,11,0.8181818181818182
2125,11/9/2022,25.46849315068493,W,1,31.35,9,18,0.5,6,8,0.75,8,8,1.0,2,6,8,0,0,1,3,2,32,23.1,-12.0,Lauri Markkanen,3,10,0.3
2126,11/12/2022,25.476712328767125,L,1,31.216666666666665,8,14,0.571,1,3,0.333,0,0,,1,4,5,1,0,2,1,0,17,13.4,-23.0,Lauri Markkanen,7,11,0.6363636363636364
2127,11/13/2022,25.47945205479452,L,1,34.13333333333333,6,13,0.462,2,5,0.4,1,4,0.25,3,7,10,0,0,0,4,1,15,6.9,-15.0,Lauri Markkanen,4,8,0.5
2128,11/15/2022,25.484931506849314,L,1,29.533333333333335,5,11,0.455,2,5,0.4,1,2,0.5,4,2,6,4,0,2,2,4,13,10.9,16.0,Lauri Markkanen,3,6,0.5
2129,11/18/2022,25.493150684931507,W,1,34.6,15,18,0.833,2,3,0.667,6,8,0.75,1,5,6,3,1,0,1,2,38,34.1,5.0,Lauri Markkanen,13,15,0.8666666666666667
2130,11/19/2022,25.495890410958904,W,1,32.46666666666667,7,13,0.538,3,5,0.6,6,8,0.75,3,7,10,2,1,0,3,4,23,17.9,-2.0,Lauri Markkanen,4,8,0.5
2131,11/21/2022,25.5013698630137,L,1,38.81666666666667,10,21,0.476,1,5,0.2,4,4,1.0,7,3,10,3,1,1,2,1,25,21.5,14.0,Lauri Markkanen,9,16,0.5625
2132,11/23/2022,25.506849315068493,L,1,34.36666666666667,4,13,0.308,3,7,0.429,2,2,1.0,0,8,8,2,0,0,3,3,13,5.1,-3.0,Lauri Markkanen,1,6,0.16666666666666666
2133,11/25/2022,25.512328767123286,L,1,37.2,9,17,0.529,5,11,0.455,1,1,1.0,3,3,6,1,0,0,4,3,24,14.2,12.0,Lauri Markkanen,4,6,0.6666666666666666
2134,11/26/2022,25.515068493150686,L,1,35.61666666666667,4,13,0.308,2,8,0.25,5,7,0.714,1,9,10,2,0,0,2,3,15,8.3,2.0,Lauri Markkanen,2,5,0.4
2135,10/19/2022,30.367123287671234,W,1,29.55,3,9,0.333,1,4,0.25,3,4,0.75,1,4,5,5,0,0,6,0,10,3.9,-4.0,Jordan Clarkson,2,5,0.4
2136,10/21/2022,30.372602739726027,W,1,34.88333333333333,10,17,0.588,7,12,0.583,2,2,1.0,2,3,5,6,0,1,2,1,29,25.9,8.0,Jordan Clarkson,3,5,0.6
2137,10/23/2022,30.378082191780823,W,1,36.733333333333334,7,19,0.368,3,10,0.3,1,2,0.5,0,1,1,6,0,1,3,0,18,9.3,4.0,Jordan Clarkson,4,9,0.4444444444444444
2138,10/24/2022,30.38082191780822,L,1,28.183333333333334,7,14,0.5,2,6,0.333,1,1,1.0,2,2,4,4,0,1,3,3,17,11.3,1.0,Jordan Clarkson,5,8,0.625
2139,10/26/2022,30.386301369863013,W,1,28.916666666666668,6,14,0.429,5,10,0.5,3,4,0.75,3,3,6,5,2,1,0,4,20,19.8,8.0,Jordan Clarkson,1,4,0.25
2140,10/28/2022,30.39178082191781,L,1,22.383333333333333,1,10,0.1,0,7,0.0,4,5,0.8,0,5,5,3,1,2,1,3,6,2.8,-3.0,Jordan Clarkson,1,3,0.3333333333333333
2141,10/29/2022,30.394520547945206,W,1,32.75,9,17,0.529,3,7,0.429,0,1,0.0,3,0,3,6,0,0,3,0,21,15.6,7.0,Jordan Clarkson,6,10,0.6
2142,10/31/2022,30.4,W,1,33.333333333333336,3,14,0.214,2,8,0.25,3,5,0.6,1,6,7,7,0,0,1,4,11,6.4,14.0,Jordan Clarkson,1,6,0.16666666666666666
2143,11/2/2022,30.405479452054795,L,1,33.333333333333336,9,20,0.45,4,9,0.444,0,0,,2,3,5,8,1,0,4,3,22,15.3,-3.0,Jordan Clarkson,5,11,0.45454545454545453
2144,11/4/2022,30.410958904109588,W,1,29.3,9,19,0.474,2,7,0.286,0,0,,0,7,7,3,0,0,0,5,20,12.5,11.0,Jordan Clarkson,7,12,0.5833333333333334
2145,11/6/2022,30.416438356164385,W,1,30.15,8,15,0.533,6,9,0.667,1,1,1.0,2,1,3,5,0,1,5,0,23,16.6,6.0,Jordan Clarkson,2,6,0.3333333333333333
2146,11/7/2022,30.41917808219178,W,1,28.65,8,12,0.667,5,6,0.833,1,1,1.0,2,2,4,4,1,0,3,3,22,18.4,16.0,Jordan Clarkson,3,6,0.5
2147,11/9/2022,30.424657534246574,W,1,34.85,7,18,0.389,2,7,0.286,7,7,1.0,1,3,4,5,0,0,2,1,23,15.9,16.0,Jordan Clarkson,5,11,0.45454545454545453
2148,11/12/2022,30.432876712328767,L,1,25.15,8,18,0.444,2,8,0.25,0,0,,0,0,0,1,0,0,2,2,18,6.5,-9.0,Jordan Clarkson,6,10,0.6
2149,11/13/2022,30.435616438356163,L,1,27.066666666666666,4,15,0.267,2,7,0.286,2,2,1.0,4,1,5,3,0,1,0,0,12,9.0,-9.0,Jordan Clarkson,2,8,0.25
2150,11/15/2022,30.44109589041096,L,1,33.53333333333333,5,16,0.313,3,11,0.273,2,2,1.0,0,2,2,5,0,0,5,1,15,4.5,6.0,Jordan Clarkson,2,5,0.4
2151,11/18/2022,30.44931506849315,W,1,30.833333333333332,8,16,0.5,2,6,0.333,2,2,1.0,1,1,2,3,0,0,1,1,20,13.7,15.0,Jordan Clarkson,6,10,0.6
2152,11/19/2022,30.45205479452055,W,1,35.63333333333333,10,23,0.435,2,7,0.286,6,6,1.0,0,2,2,4,1,0,6,2,28,13.5,6.0,Jordan Clarkson,8,16,0.5
2153,11/21/2022,30.457534246575342,L,1,39.15,8,18,0.444,4,11,0.364,6,7,0.857,1,3,4,4,1,1,1,0,26,21.3,7.0,Jordan Clarkson,4,7,0.5714285714285714
2154,11/23/2022,30.463013698630135,L,1,37.45,9,17,0.529,3,8,0.375,3,3,1.0,0,3,3,2,1,0,3,1,24,15.6,-12.0,Jordan Clarkson,6,9,0.6666666666666666
2155,11/25/2022,30.46849315068493,L,1,34.766666666666666,9,18,0.5,0,7,0.0,3,4,0.75,0,4,4,10,0,0,3,1,21,16.4,-12.0,Jordan Clarkson,9,11,0.8181818181818182
2156,11/26/2022,30.471232876712328,L,1,33.5,8,18,0.444,2,4,0.5,4,4,1.0,3,2,5,5,0,0,2,2,22,16.0,9.0,Jordan Clarkson,6,14,0.42857142857142855
2157,10/19/2022,25.895890410958906,W,0,24.933333333333334,5,13,0.385,3,9,0.333,2,2,1.0,2,3,5,1,1,0,0,0,15,11.9,20.0,Malik Beasley,2,4,0.5
2158,10/21/2022,25.9013698630137,W,0,29.95,6,16,0.375,3,9,0.333,0,0,,0,3,3,1,0,0,0,0,15,7.8,-1.0,Malik Beasley,3,7,0.42857142857142855
2159,10/23/2022,25.90684931506849,W,0,20.966666666666665,2,5,0.4,0,2,0.0,0,1,0.0,0,1,1,2,1,0,2,1,4,1.2,2.0,Malik Beasley,2,3,0.6666666666666666
2160,10/24/2022,25.90958904109589,L,0,19.816666666666666,5,9,0.556,2,4,0.5,0,0,,0,0,0,0,2,1,0,1,12,10.0,-7.0,Malik Beasley,3,5,0.6
2161,10/26/2022,25.915068493150685,W,0,29.65,5,12,0.417,2,7,0.286,2,2,1.0,2,2,4,1,4,1,1,0,14,14.0,-4.0,Malik Beasley,3,5,0.6
2162,10/28/2022,25.92054794520548,L,0,22.083333333333332,1,7,0.143,0,2,0.0,3,3,1.0,0,0,0,0,0,0,0,1,5,0.1,-32.0,Malik Beasley,1,5,0.2
2163,10/29/2022,25.923287671232877,W,0,31.566666666666666,4,7,0.571,4,6,0.667,0,0,,0,3,3,0,1,0,0,1,12,10.2,-4.0,Malik Beasley,0,1,0.0
2164,10/31/2022,25.92876712328767,W,0,26.35,7,12,0.583,4,9,0.444,0,0,,0,4,4,4,0,0,2,1,18,14.0,14.0,Malik Beasley,3,3,1.0
2165,11/2/2022,25.934246575342467,L,0,22.666666666666668,3,11,0.273,3,5,0.6,0,0,,4,4,8,1,0,0,0,0,9,7.2,1.0,Malik Beasley,0,6,0.0
2166,11/4/2022,25.93972602739726,W,0,14.966666666666667,1,7,0.143,1,4,0.25,0,0,,0,2,2,1,2,0,0,2,3,1.0,-4.0,Malik Beasley,0,3,0.0
2167,11/6/2022,25.945205479452056,W,1,31.283333333333335,3,8,0.375,2,7,0.286,2,2,1.0,1,3,4,0,0,0,3,1,10,3.8,0.0,Malik Beasley,1,1,1.0
2168,11/7/2022,25.947945205479453,W,1,21.55,5,8,0.625,4,7,0.571,0,0,,0,2,2,1,0,0,1,2,14,9.9,11.0,Malik Beasley,1,1,1.0
2169,11/9/2022,25.953424657534246,W,0,29.35,6,11,0.545,6,10,0.6,0,0,,1,5,6,1,2,0,1,2,18,15.8,13.0,Malik Beasley,0,1,0.0
2170,11/12/2022,25.96164383561644,L,0,29.45,6,13,0.462,4,9,0.444,0,0,,0,6,6,3,1,0,0,2,16,13.4,-1.0,Malik Beasley,2,4,0.5
2171,11/13/2022,25.964383561643835,L,0,28.95,6,13,0.462,4,10,0.4,2,2,1.0,0,4,4,2,1,0,1,2,18,13.1,3.0,Malik Beasley,2,3,0.6666666666666666
2172,11/15/2022,25.96986301369863,L,0,23.866666666666667,5,12,0.417,3,8,0.375,1,1,1.0,1,3,4,0,0,1,1,1,14,8.5,5.0,Malik Beasley,2,4,0.5
2173,11/18/2022,25.97808219178082,W,0,31.266666666666666,10,17,0.588,7,13,0.538,0,0,,0,3,3,1,1,1,2,0,27,20.4,-10.0,Malik Beasley,3,4,0.75
2174,11/19/2022,25.980821917808218,W,0,29.233333333333334,10,18,0.556,6,14,0.429,3,3,1.0,0,3,3,1,0,0,1,2,29,20.2,10.0,Malik Beasley,4,4,1.0
2175,11/21/2022,25.986301369863014,L,0,30.166666666666668,2,11,0.182,2,10,0.2,0,0,,0,6,6,1,1,0,2,2,6,-0.2,-14.0,Malik Beasley,0,1,0.0
2176,11/23/2022,25.991780821917807,L,0,29.283333333333335,9,18,0.5,8,15,0.533,3,4,0.75,2,9,11,5,0,0,1,2,29,25.4,-8.0,Malik Beasley,1,3,0.3333333333333333
2177,11/25/2022,25.997260273972604,L,0,20.383333333333333,4,14,0.286,2,8,0.25,0,0,,2,3,5,1,5,0,1,0,10,8.8,-12.0,Malik Beasley,2,6,0.3333333333333333
2178,11/26/2022,26.0,L,0,35.25,6,13,0.462,2,7,0.286,0,0,,0,5,5,4,0,0,2,2,14,8.8,-2.0,Malik Beasley,4,6,0.6666666666666666
2179,10/19/2022,23.78904109589041,W,0,20.783333333333335,6,12,0.5,1,4,0.25,7,8,0.875,1,4,5,2,0,0,2,2,20,14.1,8.0,Collin Sexton,5,8,0.625
2180,10/21/2022,23.794520547945204,W,0,19.316666666666666,2,6,0.333,0,0,,7,8,0.875,2,1,3,4,0,0,0,1,11,11.3,-7.0,Collin Sexton,2,6,0.3333333333333333
2181,10/23/2022,23.8,W,0,18.85,2,10,0.2,1,3,0.333,3,4,0.75,3,2,5,1,2,0,2,1,8,4.4,11.0,Collin Sexton,1,7,0.14285714285714285
2182,10/24/2022,23.802739726027397,L,0,15.483333333333333,4,7,0.571,1,2,0.5,1,1,1.0,1,4,5,1,0,0,1,3,10,7.1,-5.0,Collin Sexton,3,5,0.6
2183,10/26/2022,23.80821917808219,W,0,10.366666666666667,2,3,0.667,0,1,0.0,0,1,0.0,0,0,0,0,1,0,1,1,4,1.9,10.0,Collin Sexton,2,2,1.0
2184,10/28/2022,23.813698630136987,L,0,16.5,5,9,0.556,1,4,0.25,2,3,0.667,0,0,0,1,1,0,1,5,13,7.0,-32.0,Collin Sexton,4,5,0.8
2185,10/29/2022,23.816438356164383,W,1,31.866666666666667,7,12,0.583,3,6,0.5,2,2,1.0,1,1,2,4,0,1,3,2,19,14.1,7.0,Collin Sexton,4,6,0.6666666666666666
2186,10/31/2022,23.82191780821918,W,0,24.25,4,9,0.444,2,4,0.5,5,5,1.0,1,1,2,0,2,0,2,4,15,9.7,19.0,Collin Sexton,2,5,0.4
2187,11/2/2022,23.827397260273973,L,0,30.866666666666667,7,16,0.438,1,4,0.25,4,5,0.8,1,2,3,3,2,0,3,2,19,11.8,-4.0,Collin Sexton,6,12,0.5
2188,11/4/2022,23.832876712328765,W,0,28.6,7,13,0.538,3,5,0.6,0,0,,2,2,4,3,0,0,2,3,17,11.6,7.0,Collin Sexton,4,8,0.5
2189,11/6/2022,23.838356164383562,W,0,27.233333333333334,6,13,0.462,2,5,0.4,8,9,0.889,0,3,3,2,1,0,3,1,22,14.8,3.0,Collin Sexton,4,8,0.5
2190,11/7/2022,23.84109589041096,W,0,27.95,5,10,0.5,1,4,0.25,6,7,0.857,0,5,5,3,0,0,0,2,17,14.4,19.0,Collin Sexton,4,6,0.6666666666666666
2191,11/9/2022,23.846575342465755,W,0,13.15,1,6,0.167,0,0,,1,2,0.5,0,0,0,0,1,0,1,1,3,-1.6,-10.0,Collin Sexton,1,6,0.16666666666666666
2192,11/12/2022,23.854794520547944,L,0,21.85,6,9,0.667,1,2,0.5,4,4,1.0,1,3,4,2,0,0,2,3,17,12.9,-4.0,Collin Sexton,5,7,0.7142857142857143
2193,11/13/2022,23.85753424657534,L,0,24.866666666666667,7,15,0.467,0,1,0.0,1,5,0.2,1,1,2,1,1,0,2,2,15,5.6,-3.0,Collin Sexton,7,14,0.5
2194,11/15/2022,23.863013698630137,L,0,17.4,1,5,0.2,0,1,0.0,1,1,1.0,0,1,1,4,0,0,1,2,3,1.2,-17.0,Collin Sexton,1,4,0.25
2195,11/18/2022,23.87123287671233,W,0,21.566666666666666,5,10,0.5,0,1,0.0,3,4,0.75,0,1,1,0,0,0,1,3,13,5.7,-20.0,Collin Sexton,5,9,0.5555555555555556
2196,11/19/2022,23.873972602739727,W,0,20.116666666666667,2,5,0.4,1,2,0.5,4,4,1.0,1,0,1,4,1,0,2,0,9,8.8,-9.0,Collin Sexton,1,3,0.3333333333333333
2197,11/21/2022,23.87945205479452,L,1,28.0,5,13,0.385,0,2,0.0,0,0,,0,2,2,1,0,0,0,2,10,3.4,-9.0,Collin Sexton,5,11,0.45454545454545453
2198,11/23/2022,23.884931506849316,L,1,35.1,7,12,0.583,1,4,0.25,2,2,1.0,0,0,0,12,0,0,2,5,17,15.8,-11.0,Collin Sexton,6,8,0.75
2199,11/25/2022,23.89041095890411,L,1,24.15,4,8,0.5,1,2,0.5,4,4,1.0,1,0,1,7,1,0,0,3,13,14.4,2.0,Collin Sexton,3,6,0.5
2200,11/26/2022,23.893150684931506,L,1,29.816666666666666,7,11,0.636,0,1,0.0,6,8,0.75,1,1,2,5,2,0,2,3,20,17.6,1.0,Collin Sexton,7,10,0.7
2201,10/19/2022,31.5013698630137,W,1,14.933333333333334,3,5,0.6,2,3,0.667,0,0,,0,0,0,1,0,0,3,5,8,1.4,-8.0,Kelly Olynyk,1,2,0.5
2202,10/21/2022,31.506849315068493,W,1,34.583333333333336,8,14,0.571,5,6,0.833,0,0,,1,2,3,3,4,1,4,6,21,16.1,7.0,Kelly Olynyk,3,8,0.375
2203,10/23/2022,31.512328767123286,W,1,37.28333333333333,7,12,0.583,2,3,0.667,4,5,0.8,1,2,3,5,1,0,1,4,20,17.2,-8.0,Kelly Olynyk,5,9,0.5555555555555556
2204,10/24/2022,31.515068493150686,L,1,26.733333333333334,4,5,0.8,2,2,1.0,3,4,0.75,3,6,9,4,0,0,5,2,13,11.6,8.0,Kelly Olynyk,2,3,0.6666666666666666
2205,10/26/2022,31.52054794520548,W,1,29.233333333333334,1,8,0.125,0,2,0.0,2,6,0.333,3,5,8,6,1,0,4,6,4,-0.4,8.0,Kelly Olynyk,1,6,0.16666666666666666
2206,10/28/2022,31.526027397260275,L,1,20.466666666666665,3,6,0.5,1,3,0.333,0,0,,1,2,3,3,1,1,1,4,7,6.5,-5.0,Kelly Olynyk,2,3,0.6666666666666666
2207,10/29/2022,31.528767123287672,W,1,34.233333333333334,8,10,0.8,4,6,0.667,3,3,1.0,0,3,3,4,2,3,4,4,23,21.4,6.0,Kelly Olynyk,4,4,1.0
2208,10/31/2022,31.534246575342465,W,1,21.216666666666665,2,7,0.286,0,3,0.0,3,4,0.75,1,2,3,1,4,1,2,6,7,4.8,5.0,Kelly Olynyk,2,4,0.5
2209,11/2/2022,31.53972602739726,L,1,22.733333333333334,3,5,0.6,0,1,0.0,0,0,,2,3,5,4,1,0,1,5,6,6.8,3.0,Kelly Olynyk,3,4,0.75
2210,11/4/2022,31.545205479452054,W,1,30.233333333333334,7,10,0.7,3,3,1.0,1,2,0.5,2,2,4,3,1,0,0,4,18,16.9,17.0,Kelly Olynyk,4,7,0.5714285714285714
2211,11/6/2022,31.55068493150685,W,1,29.45,2,4,0.5,1,2,0.5,4,4,1.0,0,4,4,4,1,0,3,5,9,7.0,10.0,Kelly Olynyk,1,2,0.5
2212,11/7/2022,31.553424657534247,W,1,22.766666666666666,3,4,0.75,0,0,,4,4,1.0,0,3,3,2,2,1,4,2,10,8.6,8.0,Kelly Olynyk,3,4,0.75
2213,11/9/2022,31.55890410958904,W,1,20.583333333333332,6,10,0.6,1,3,0.333,1,2,0.5,3,3,6,2,0,0,2,3,14,10.2,-11.0,Kelly Olynyk,5,7,0.7142857142857143
2214,11/12/2022,31.567123287671233,L,1,28.25,4,10,0.4,2,5,0.4,0,0,,0,5,5,4,0,0,2,4,10,5.3,-20.0,Kelly Olynyk,2,5,0.4
2215,11/13/2022,31.56986301369863,L,1,29.333333333333332,4,9,0.444,0,4,0.0,6,6,1.0,1,5,6,1,1,0,2,5,14,9.2,-16.0,Kelly Olynyk,4,5,0.8
2216,11/15/2022,31.575342465753426,L,1,28.616666666666667,7,13,0.538,2,5,0.4,11,13,0.846,2,9,11,2,1,0,3,5,27,21.4,-7.0,Kelly Olynyk,5,8,0.625
2217,11/18/2022,31.583561643835615,W,1,19.933333333333334,2,5,0.4,0,1,0.0,1,1,1.0,1,3,4,2,1,0,4,5,5,0.3,19.0,Kelly Olynyk,2,4,0.5
2218,11/19/2022,31.586301369863016,W,1,31.0,2,6,0.333,1,3,0.333,0,0,,2,4,6,4,0,3,1,3,5,6.9,7.0,Kelly Olynyk,1,3,0.3333333333333333
2219,11/21/2022,31.59178082191781,L,1,31.633333333333333,6,7,0.857,3,3,1.0,4,4,1.0,3,4,7,4,2,0,1,4,19,22.0,-4.0,Kelly Olynyk,3,4,0.75
2220,11/23/2022,31.5972602739726,L,1,35.13333333333333,4,7,0.571,0,2,0.0,0,0,,1,2,3,6,2,1,0,2,8,12.1,1.0,Kelly Olynyk,4,5,0.8
2221,11/25/2022,31.602739726027398,L,1,33.13333333333333,9,13,0.692,3,6,0.5,0,0,,2,2,4,1,1,2,1,3,21,18.4,-19.0,Kelly Olynyk,6,7,0.8571428571428571
2222,11/26/2022,31.605479452054794,L,1,33.416666666666664,3,7,0.429,1,4,0.25,3,4,0.75,1,5,6,3,2,1,0,3,10,11.7,6.0,Kelly Olynyk,2,3,0.6666666666666666
2223,10/19/2022,21.898630136986302,W,0,13.7,1,6,0.167,0,1,0.0,1,2,0.5,0,0,0,1,2,0,0,1,3,1.1,7.0,Talen Horton-Tucker,1,5,0.2
2224,10/21/2022,21.904109589041095,W,0,14.416666666666666,4,8,0.5,0,2,0.0,0,0,,1,1,2,2,1,0,0,2,8,6.6,-3.0,Talen Horton-Tucker,4,6,0.6666666666666666
2225,10/23/2022,21.90958904109589,W,0,9.2,3,5,0.6,1,2,0.5,0,0,,0,3,3,0,1,0,2,0,7,4.6,-8.0,Talen Horton-Tucker,2,3,0.6666666666666666
2226,10/24/2022,21.912328767123288,L,0,17.1,3,7,0.429,1,3,0.333,2,2,1.0,1,4,5,3,1,2,2,3,9,8.5,-7.0,Talen Horton-Tucker,2,4,0.5
2227,10/26/2022,21.91780821917808,W,0,28.2,5,11,0.455,2,7,0.286,2,3,0.667,0,7,7,4,2,0,0,3,14,13.6,8.0,Talen Horton-Tucker,3,4,0.75
2228,10/28/2022,21.923287671232877,L,0,21.083333333333332,3,11,0.273,0,5,0.0,0,0,,2,2,4,2,1,1,0,4,6,3.0,-15.0,Talen Horton-Tucker,3,6,0.5
2229,10/29/2022,21.926027397260274,W,0,10.35,0,2,0.0,0,1,0.0,1,2,0.5,1,0,1,0,0,0,2,2,1,-2.9,-7.0,Talen Horton-Tucker,0,1,0.0
2230,10/31/2022,21.931506849315067,W,0,19.7,5,11,0.455,1,6,0.167,2,2,1.0,1,4,5,2,0,0,3,1,13,7.2,-1.0,Talen Horton-Tucker,4,5,0.8
2231,11/2/2022,21.936986301369863,L,0,13.933333333333334,1,1,1.0,0,0,,0,0,,0,0,0,0,0,0,0,0,2,1.7,-10.0,Talen Horton-Tucker,1,1,1.0
2232,11/4/2022,21.942465753424656,W,0,15.566666666666666,3,7,0.429,1,2,0.5,0,0,,1,2,3,1,2,0,0,0,7,7.3,10.0,Talen Horton-Tucker,2,5,0.4
2233,11/6/2022,21.947945205479453,W,0,14.583333333333334,1,5,0.2,1,4,0.25,2,2,1.0,0,2,2,0,0,0,0,1,5,2.1,-1.0,Talen Horton-Tucker,0,1,0.0
2234,11/7/2022,21.95068493150685,W,0,20.1,6,11,0.545,1,3,0.333,2,3,0.667,1,2,3,3,3,0,1,1,15,14.3,19.0,Talen Horton-Tucker,5,8,0.625
2235,11/9/2022,21.956164383561642,W,0,19.283333333333335,3,8,0.375,2,4,0.5,0,0,,1,2,3,5,0,1,2,2,8,6.3,17.0,Talen Horton-Tucker,1,4,0.25
2236,11/12/2022,21.964383561643835,L,0,16.916666666666668,3,7,0.429,1,2,0.5,5,6,0.833,0,3,3,10,0,1,1,1,12,15.1,13.0,Talen Horton-Tucker,2,5,0.4
2237,11/13/2022,21.96712328767123,L,0,14.433333333333334,3,10,0.3,1,3,0.333,0,0,,0,1,1,5,0,0,0,0,7,5.0,10.0,Talen Horton-Tucker,2,7,0.2857142857142857
2238,11/15/2022,21.972602739726028,L,0,14.116666666666667,2,5,0.4,0,2,0.0,6,6,1.0,0,1,1,3,0,0,3,1,10,6.3,-11.0,Talen Horton-Tucker,2,3,0.6666666666666666
2239,11/18/2022,21.980821917808218,W,0,15.016666666666667,3,6,0.5,0,0,,1,3,0.333,0,1,1,3,1,0,2,2,7,3.8,4.0,Talen Horton-Tucker,3,6,0.5
2240,11/19/2022,21.983561643835618,W,0,31.533333333333335,4,11,0.364,0,2,0.0,0,0,,1,4,5,2,1,1,0,2,8,6.1,12.0,Talen Horton-Tucker,4,9,0.4444444444444444
2241,11/21/2022,21.98904109589041,L,0,20.0,5,9,0.556,2,4,0.5,2,3,0.667,1,1,2,2,2,2,4,5,14,9.1,2.0,Talen Horton-Tucker,3,5,0.6
2242,11/23/2022,21.994520547945207,L,0,12.9,1,4,0.25,1,2,0.5,0,0,,0,0,0,2,0,0,2,1,3,-0.4,2.0,Talen Horton-Tucker,0,2,0.0
2243,11/25/2022,22.0,L,0,12.183333333333334,0,5,0.0,0,4,0.0,0,0,,0,3,3,0,1,0,1,0,0,-2.6,-17.0,Talen Horton-Tucker,0,1,0.0
2244,11/26/2022,22.002739726027396,L,0,16.65,4,7,0.571,2,4,0.5,0,0,,0,1,1,0,0,1,3,0,10,4.7,0.0,Talen Horton-Tucker,2,3,0.6666666666666666
2245,10/19/2022,23.545205479452054,W,1,18.1,3,4,0.75,0,0,,1,2,0.5,5,7,12,1,1,0,2,6,7,7.9,10.0,Jarred Vanderbilt,3,4,0.75
2246,10/21/2022,23.55068493150685,W,1,24.866666666666667,2,5,0.4,0,0,,0,2,0.0,4,10,14,4,4,0,3,5,4,8.1,12.0,Jarred Vanderbilt,2,5,0.4
2247,10/23/2022,23.556164383561644,W,1,28.0,5,7,0.714,2,3,0.667,3,3,1.0,0,4,4,1,4,1,1,5,15,15.7,-4.0,Jarred Vanderbilt,3,4,0.75
2248,10/24/2022,23.55890410958904,L,1,32.016666666666666,6,10,0.6,0,1,0.0,1,2,0.5,4,7,11,2,1,1,2,4,13,12.4,-9.0,Jarred Vanderbilt,6,9,0.6666666666666666
2249,10/26/2022,23.564383561643837,W,1,19.083333333333332,3,7,0.429,0,1,0.0,0,0,,2,6,8,2,0,0,1,6,6,3.5,7.0,Jarred Vanderbilt,3,6,0.5
2250,10/28/2022,23.56986301369863,L,1,28.316666666666666,3,7,0.429,0,0,,1,2,0.5,0,7,7,2,0,1,1,2,7,5.3,-16.0,Jarred Vanderbilt,3,7,0.42857142857142855
2251,10/29/2022,23.572602739726026,W,1,22.716666666666665,2,4,0.5,1,2,0.5,2,2,1.0,0,7,7,7,2,0,4,3,7,8.8,-4.0,Jarred Vanderbilt,1,2,0.5
2252,10/31/2022,23.578082191780823,W,1,22.316666666666666,3,5,0.6,1,2,0.5,0,0,,2,5,7,5,1,1,2,4,7,9.2,-4.0,Jarred Vanderbilt,2,3,0.6666666666666666
2253,11/2/2022,23.583561643835615,L,1,33.0,6,10,0.6,1,1,1.0,2,2,1.0,3,3,6,3,1,1,2,0,15,15.2,-4.0,Jarred Vanderbilt,5,9,0.5555555555555556
2254,11/4/2022,23.589041095890412,W,1,25.183333333333334,4,7,0.571,1,1,1.0,0,0,,2,4,6,4,1,0,1,5,9,9.1,1.0,Jarred Vanderbilt,3,6,0.5
2255,11/9/2022,23.602739726027398,W,1,28.25,3,4,0.75,0,1,0.0,0,0,,1,6,7,0,1,0,0,3,6,6.7,-4.0,Jarred Vanderbilt,3,3,1.0
2256,11/12/2022,23.610958904109587,L,1,17.483333333333334,3,6,0.5,1,2,0.5,0,0,,4,4,8,1,1,0,1,2,7,7.9,-12.0,Jarred Vanderbilt,2,4,0.5
2257,11/13/2022,23.613698630136987,L,1,24.133333333333333,4,6,0.667,0,2,0.0,1,2,0.5,4,6,10,3,0,0,3,3,9,8.5,-17.0,Jarred Vanderbilt,4,4,1.0
2258,11/15/2022,23.61917808219178,L,1,24.333333333333332,1,1,1.0,0,0,,0,2,0.0,2,7,9,1,1,0,1,1,2,4.7,-4.0,Jarred Vanderbilt,1,1,1.0
2259,11/18/2022,23.627397260273973,W,1,26.616666666666667,3,6,0.5,0,1,0.0,0,0,,5,6,11,8,0,0,3,6,6,8.5,19.0,Jarred Vanderbilt,3,5,0.6
2260,11/19/2022,23.63013698630137,W,1,28.133333333333333,3,6,0.5,0,2,0.0,1,2,0.5,2,7,9,1,0,0,0,3,7,6.6,14.0,Jarred Vanderbilt,3,4,0.75
2261,11/21/2022,23.635616438356166,L,1,24.1,1,4,0.25,0,0,,4,4,1.0,3,7,10,5,1,0,3,1,6,8.9,-7.0,Jarred Vanderbilt,1,4,0.25
2262,11/23/2022,23.64109589041096,L,1,21.85,3,5,0.6,0,0,,1,1,1.0,1,2,3,2,1,1,1,1,7,7.7,0.0,Jarred Vanderbilt,3,5,0.6
2263,11/25/2022,23.646575342465752,L,1,27.266666666666666,5,8,0.625,0,1,0.0,3,4,0.75,2,8,10,2,1,0,2,2,13,12.4,-13.0,Jarred Vanderbilt,5,7,0.7142857142857143
2264,11/26/2022,23.649315068493152,L,1,22.916666666666668,3,4,0.75,0,0,,0,0,,1,6,7,1,1,0,0,2,6,7.8,-9.0,Jarred Vanderbilt,3,4,0.75
2265,10/19/2022,21.232876712328768,W,0,23.666666666666668,5,5,1.0,0,0,,2,6,0.333,2,8,10,1,1,0,1,2,12,12.6,12.0,Walker Kessler,5,5,1.0
2266,10/21/2022,21.23835616438356,W,0,17.7,2,3,0.667,0,0,,2,3,0.667,3,2,5,2,0,4,1,1,6,9.8,-3.0,Walker Kessler,2,3,0.6666666666666666
2267,10/23/2022,21.243835616438357,W,0,22.266666666666666,3,6,0.5,0,0,,1,2,0.5,6,3,9,2,0,2,0,2,7,10.7,9.0,Walker Kessler,3,6,0.5
2268,10/24/2022,21.246575342465754,L,0,8.466666666666667,0,1,0.0,0,0,,0,0,,0,1,1,0,1,1,2,4,0,-2.3,0.0,Walker Kessler,0,1,0.0
2269,10/26/2022,21.252054794520546,W,0,11.05,0,1,0.0,0,0,,4,4,1.0,0,1,1,1,0,1,1,2,4,3.2,-4.0,Walker Kessler,0,1,0.0
2270,11/2/2022,21.27123287671233,L,0,4.033333333333333,0,0,,0,0,,0,0,,0,0,0,0,0,0,0,1,0,-0.4,-2.0,Walker Kessler,0,0,
2271,11/4/2022,21.276712328767122,W,0,10.6,4,5,0.8,0,0,,0,0,,3,1,4,0,0,2,0,0,8,9.9,0.0,Walker Kessler,4,5,0.8
2272,11/6/2022,21.28219178082192,W,0,16.183333333333334,2,2,1.0,0,0,,0,0,,1,4,5,0,0,2,0,1,4,6.3,0.0,Walker Kessler,2,2,1.0
2273,11/7/2022,21.284931506849315,W,0,18.2,4,6,0.667,0,0,,0,0,,3,6,9,1,0,2,0,4,8,9.8,8.0,Walker Kessler,4,6,0.6666666666666666
2274,11/9/2022,21.29041095890411,W,0,16.333333333333332,6,6,1.0,0,0,,0,1,0.0,3,3,6,1,0,3,0,2,12,14.8,14.0,Walker Kessler,6,6,1.0
2275,11/12/2022,21.2986301369863,L,0,15.3,1,2,0.5,0,0,,0,0,,1,3,4,0,0,0,0,1,2,2.2,15.0,Walker Kessler,1,2,0.5
2276,11/13/2022,21.301369863013697,L,0,11.966666666666667,1,5,0.2,0,0,,0,2,0.0,5,4,9,0,0,3,2,1,2,2.5,13.0,Walker Kessler,1,5,0.2
2277,11/15/2022,21.306849315068494,L,0,17.933333333333334,4,4,1.0,0,0,,0,0,,3,4,7,1,1,1,2,2,8,9.7,-8.0,Walker Kessler,4,4,1.0
2278,11/18/2022,21.315068493150687,W,0,20.366666666666667,0,3,0.0,0,0,,1,2,0.5,2,1,3,2,1,0,0,3,1,1.4,-18.0,Walker Kessler,0,3,0.0
2279,11/19/2022,21.317808219178083,W,0,10.666666666666666,3,3,1.0,0,0,,0,0,,2,3,5,1,0,0,0,1,6,7.7,-6.0,Walker Kessler,3,3,1.0
2280,11/21/2022,21.323287671232876,L,0,11.883333333333333,2,2,1.0,0,0,,0,0,,1,1,2,1,0,0,1,2,4,3.3,-4.0,Walker Kessler,2,2,1.0
2281,11/23/2022,21.328767123287673,L,0,21.05,2,2,1.0,0,0,,1,2,0.5,2,5,7,0,0,5,2,5,5,6.4,-4.0,Walker Kessler,2,2,1.0
2282,11/25/2022,21.334246575342465,L,0,20.733333333333334,3,3,1.0,0,0,,2,2,1.0,2,2,4,0,0,3,0,0,8,11.2,2.0,Walker Kessler,3,3,1.0
2283,11/26/2022,21.336986301369862,L,0,16.8,1,1,1.0,0,0,,1,2,0.5,1,3,4,0,0,0,0,2,3,3.1,0.0,Walker Kessler,1,1,1.0
2284,10/19/2022,35.02191780821918,W,1,32.03333333333333,3,8,0.375,2,4,0.5,5,5,1.0,0,2,2,8,2,1,3,0,13,14.5,16.0,Mike Conley,1,4,0.25
2285,10/21/2022,35.02739726027397,W,1,36.21666666666667,4,15,0.267,3,9,0.333,1,2,0.5,1,2,3,11,2,0,1,5,12,10.7,13.0,Mike Conley,1,6,0.16666666666666666
2286,10/23/2022,35.032876712328765,W,1,36.3,3,12,0.25,1,6,0.167,0,0,,0,2,2,8,0,1,1,1,7,5.3,-13.0,Mike Conley,2,6,0.3333333333333333
2287,10/24/2022,35.035616438356165,L,1,27.3,3,6,0.5,0,3,0.0,1,3,0.333,0,2,2,7,3,2,2,0,7,11.1,1.0,Mike Conley,3,3,1.0
2288,10/26/2022,35.04109589041096,W,1,27.766666666666666,4,11,0.364,3,8,0.375,2,4,0.5,0,3,3,5,1,0,3,5,13,6.5,6.0,Mike Conley,1,3,0.3333333333333333
2289,10/28/2022,35.04657534246575,L,1,23.466666666666665,4,7,0.571,4,5,0.8,2,2,1.0,1,1,2,5,0,0,0,2,14,14.4,-4.0,Mike Conley,0,2,0.0
2290,10/31/2022,35.054794520547944,W,1,30.266666666666666,5,9,0.556,5,7,0.714,0,0,,0,2,2,5,1,0,0,2,15,15.0,15.0,Mike Conley,0,2,0.0
2291,11/2/2022,35.06027397260274,L,1,32.78333333333333,3,8,0.375,1,4,0.25,4,4,1.0,0,1,1,8,1,0,3,1,11,10.1,4.0,Mike Conley,2,4,0.5
2292,11/4/2022,35.06575342465754,W,1,31.333333333333332,6,11,0.545,2,5,0.4,1,1,1.0,2,0,2,10,1,0,2,0,15,17.1,9.0,Mike Conley,4,6,0.6666666666666666
2293,11/6/2022,35.07123287671233,W,1,32.983333333333334,7,13,0.538,2,6,0.333,1,1,1.0,1,6,7,4,2,0,1,0,17,17.0,11.0,Mike Conley,5,7,0.7142857142857143
2294,11/7/2022,35.07397260273972,W,1,23.766666666666666,5,7,0.714,3,4,0.75,1,2,0.5,0,1,1,12,0,0,0,2,14,18.6,12.0,Mike Conley,2,3,0.6666666666666666
2295,11/9/2022,35.07945205479452,W,1,28.716666666666665,2,6,0.333,0,2,0.0,3,4,0.75,0,1,1,13,0,0,1,2,7,10.8,-11.0,Mike Conley,2,4,0.5
2296,11/12/2022,35.087671232876716,L,1,29.683333333333334,1,8,0.125,0,5,0.0,1,1,1.0,0,3,3,10,1,0,2,1,3,4.3,-21.0,Mike Conley,1,3,0.3333333333333333
2297,11/13/2022,35.09041095890411,L,1,31.533333333333335,1,7,0.143,1,4,0.25,0,0,,0,1,1,8,0,0,3,2,3,0.6,-13.0,Mike Conley,0,3,0.0
2298,11/15/2022,35.0958904109589,L,1,33.88333333333333,3,10,0.3,1,6,0.167,3,3,1.0,1,3,4,7,4,0,1,5,10,11.7,4.0,Mike Conley,2,4,0.5
2299,11/18/2022,35.104109589041094,W,1,30.266666666666666,4,9,0.444,4,5,0.8,1,2,0.5,1,3,4,10,1,1,2,5,13,14.2,-2.0,Mike Conley,0,4,0.0
2300,11/19/2022,35.106849315068494,W,1,9.083333333333334,0,1,0.0,0,0,,0,0,,0,1,1,3,1,0,0,2,0,1.9,-12.0,Mike Conley,0,1,0.0
2301,10/19/2022,36.172602739726024,W,0,25.583333333333332,6,8,0.75,4,6,0.667,0,0,,0,0,0,2,1,0,1,2,16,13.4,24.0,Rudy Gay,2,2,1.0
2302,10/21/2022,36.178082191780824,W,0,13.933333333333334,1,4,0.25,0,2,0.0,0,2,0.0,0,3,3,1,0,1,1,1,2,-0.3,-3.0,Rudy Gay,1,2,0.5
2303,10/23/2022,36.18356164383562,W,0,15.983333333333333,2,5,0.4,1,3,0.333,0,0,,2,2,4,2,2,0,2,3,5,4.5,6.0,Rudy Gay,1,2,0.5
2304,10/24/2022,36.18630136986302,L,0,13.05,0,5,0.0,0,0,,0,0,,2,1,3,0,0,2,0,2,0,-1.2,-7.0,Rudy Gay,0,5,0.0
2305,10/26/2022,36.19178082191781,W,0,15.716666666666667,2,6,0.333,0,3,0.0,2,2,1.0,0,6,6,1,0,1,0,0,6,5.8,-3.0,Rudy Gay,2,3,0.6666666666666666
2306,11/2/2022,36.21095890410959,L,0,13.083333333333334,1,3,0.333,0,2,0.0,0,0,,0,5,5,1,0,0,1,2,2,0.7,-3.0,Rudy Gay,1,1,1.0
2307,11/4/2022,36.21643835616438,W,0,9.883333333333333,0,2,0.0,0,1,0.0,0,0,,0,1,1,2,0,0,1,1,0,-1.1,-1.0,Rudy Gay,0,1,0.0
2308,11/6/2022,36.221917808219175,W,0,16.05,1,4,0.25,0,3,0.0,0,0,,0,3,3,0,0,0,2,1,2,-1.9,1.0,Rudy Gay,1,1,1.0
2309,11/7/2022,36.224657534246575,W,0,16.433333333333334,3,7,0.429,1,5,0.2,1,2,0.5,1,4,5,0,0,1,1,0,8,5.5,16.0,Rudy Gay,2,2,1.0
2310,11/9/2022,36.23013698630137,W,0,18.133333333333333,1,7,0.143,0,4,0.0,0,0,,1,5,6,0,1,1,1,2,2,-0.4,18.0,Rudy Gay,1,3,0.3333333333333333
2311,11/12/2022,36.23835616438356,L,0,17.283333333333335,3,6,0.5,2,4,0.5,0,0,,0,3,3,1,1,0,0,1,8,7.2,8.0,Rudy Gay,1,2,0.5
2312,11/13/2022,36.24109589041096,L,0,13.583333333333334,1,1,1.0,1,1,1.0,0,0,,0,2,2,0,0,0,0,1,3,2.9,12.0,Rudy Gay,0,0,
2313,10/19/2022,24.12876712328767,W,0,0.9166666666666666,1,1,1.0,0,0,,0,0,,0,0,0,1,0,0,0,0,2,2.4,4.0,Nickeil Alexander-Walker,1,1,1.0
2314,10/24/2022,24.14246575342466,L,0,5.216666666666667,0,1,0.0,0,0,,0,0,,0,0,0,1,0,0,0,1,0,-0.4,-2.0,Nickeil Alexander-Walker,0,1,0.0
2315,10/28/2022,24.153424657534245,L,0,8.483333333333333,2,5,0.4,1,3,0.333,2,2,1.0,0,0,0,4,1,1,0,0,7,8.8,9.0,Nickeil Alexander-Walker,1,2,0.5
2316,10/29/2022,24.156164383561645,W,0,20.833333333333332,4,8,0.5,2,5,0.4,1,2,0.5,0,2,2,3,2,1,1,4,11,9.4,3.0,Nickeil Alexander-Walker,2,3,0.6666666666666666
2317,10/31/2022,24.161643835616438,W,0,3.283333333333333,0,1,0.0,0,1,0.0,0,0,,0,1,1,0,1,0,1,1,0,-0.8,-1.0,Nickeil Alexander-Walker,0,0,
2318,11/4/2022,24.172602739726027,W,0,7.783333333333333,2,4,0.5,1,2,0.5,1,1,1.0,0,1,1,0,0,0,1,1,6,2.9,10.0,Nickeil Alexander-Walker,1,2,0.5
2319,11/6/2022,24.17808219178082,W,0,8.733333333333333,0,2,0.0,0,1,0.0,0,0,,0,2,2,0,0,0,1,2,0,-2.6,2.0,Nickeil Alexander-Walker,0,1,0.0
2320,11/7/2022,24.18082191780822,W,0,12.0,0,5,0.0,0,1,0.0,0,0,,0,0,0,1,1,1,1,2,0,-2.9,-6.0,Nickeil Alexander-Walker,0,4,0.0
2321,11/12/2022,24.194520547945206,L,0,2.466666666666667,0,0,,0,0,,0,0,,0,0,0,0,0,0,0,0,0,0.0,3.0,Nickeil Alexander-Walker,0,0,
2322,11/21/2022,24.21917808219178,L,0,9.366666666666667,0,0,,0,0,,2,2,1.0,0,1,1,1,0,0,3,1,2,-0.4,-14.0,Nickeil Alexander-Walker,0,0,
2323,11/25/2022,24.23013698630137,L,0,30.183333333333334,3,11,0.273,0,6,0.0,2,2,1.0,3,2,5,6,3,1,1,3,8,9.9,2.0,Nickeil Alexander-Walker,3,5,0.6
2324,11/26/2022,24.232876712328768,L,0,16.033333333333335,4,5,0.8,4,4,1.0,0,0,,0,0,0,0,0,0,1,2,12,8.3,-12.0,Nickeil Alexander-Walker,0,1,0.0
2325,10/19/2022,26.86027397260274,W,0,0.9166666666666666,0,0,,0,0,,0,0,,0,0,0,0,0,0,0,0,0,0.0,4.0,Simone Fontecchio,0,0,
2326,10/23/2022,26.87123287671233,W,0,0.15,0,0,,0,0,,0,0,,0,0,0,0,0,0,0,0,0,0.0,0.0,Simone Fontecchio,0,0,
2327,10/24/2022,26.873972602739727,L,0,15.733333333333333,5,9,0.556,3,5,0.6,0,0,,2,1,3,0,0,0,2,4,13,6.8,-4.0,Simone Fontecchio,2,4,0.5
2328,10/26/2022,26.87945205479452,W,0,6.016666666666667,0,2,0.0,0,2,0.0,0,0,,0,1,1,0,0,0,0,0,0,-1.1,-6.0,Simone Fontecchio,0,0,
2329,11/4/2022,26.904109589041095,W,0,1.2833333333333332,0,1,0.0,0,1,0.0,0,0,,0,1,1,0,0,0,0,0,0,-0.4,2.0,Simone Fontecchio,0,0,
2330,11/7/2022,26.912328767123288,W,0,5.033333333333333,1,4,0.25,0,3,0.0,0,0,,0,1,1,0,1,0,1,1,2,-0.5,-2.0,Simone Fontecchio,1,1,1.0
2331,11/12/2022,26.926027397260274,L,0,2.466666666666667,0,0,,0,0,,0,0,,0,0,0,0,0,0,0,0,0,0.0,3.0,Simone Fontecchio,0,0,
2332,11/15/2022,26.934246575342467,L,0,16.783333333333335,3,6,0.5,3,5,0.6,0,0,,2,2,4,2,0,1,1,0,9,9.1,-19.0,Simone Fontecchio,0,1,0.0
2333,11/18/2022,26.942465753424656,W,0,9.533333333333333,1,1,1.0,1,1,1.0,1,2,0.5,0,1,1,0,0,1,0,1,4,3.9,-7.0,Simone Fontecchio,0,0,
2334,11/19/2022,26.945205479452056,W,0,12.133333333333333,1,5,0.2,1,4,0.25,0,0,,0,0,0,1,1,0,0,1,3,1.2,5.0,Simone Fontecchio,0,1,0.0
2335,11/21/2022,26.95068493150685,L,0,6.883333333333333,1,4,0.25,0,3,0.0,0,0,,0,1,1,0,0,1,0,0,2,0.6,-6.0,Simone Fontecchio,1,1,1.0
2336,11/23/2022,26.956164383561642,L,0,11.583333333333334,2,5,0.4,2,3,0.667,4,5,0.8,0,2,2,0,0,0,1,1,10,6.1,-6.0,Simone Fontecchio,0,2,0.0
2337,10/19/2022,22.4986301369863,W,0,0.9166666666666666,0,0,,0,0,,0,0,,0,0,0,0,0,0,0,0,0,0.0,4.0,Ochai Agbaji,0,0,
2338,10/28/2022,22.523287671232875,L,0,19.0,4,7,0.571,0,3,0.0,1,2,0.5,0,1,1,0,0,0,0,2,9,4.8,-6.0,Ochai Agbaji,4,4,1.0
2339,10/29/2022,22.526027397260275,W,0,17.75,2,6,0.333,0,2,0.0,3,5,0.6,3,1,4,1,0,0,0,0,7,5.9,-12.0,Ochai Agbaji,2,4,0.5
2340,10/31/2022,22.53150684931507,W,0,21.15,2,6,0.333,0,1,0.0,0,0,,1,2,3,0,0,0,0,3,4,0.7,6.0,Ochai Agbaji,2,5,0.4
2341,11/4/2022,22.542465753424658,W,0,1.2833333333333332,0,0,,0,0,,0,0,,0,0,0,0,0,0,0,0,0,0.0,2.0,Ochai Agbaji,0,0,
2342,11/7/2022,22.55068493150685,W,0,6.483333333333333,0,0,,0,0,,0,0,,0,2,2,0,0,0,0,1,0,0.2,0.0,Ochai Agbaji,0,0,
2343,10/28/2022,23.112328767123287,L,0,8.483333333333333,2,3,0.667,0,0,,0,0,,0,2,2,0,2,1,1,0,4,5.0,9.0,Udoka Azubuike,2,3,0.6666666666666666
2344,10/31/2022,23.12054794520548,W,0,3.283333333333333,0,0,,0,0,,0,0,,0,3,3,0,0,0,0,1,0,0.5,-1.0,Udoka Azubuike,0,0,
2345,11/4/2022,23.13150684931507,W,0,1.2833333333333332,0,0,,0,0,,0,0,,0,0,0,0,0,0,0,0,0,0.0,2.0,Udoka Azubuike,0,0,
2346,11/7/2022,23.13972602739726,W,0,4.283333333333333,2,2,1.0,0,0,,0,0,,2,1,3,1,0,1,0,0,4,6.5,2.0,Udoka Azubuike,2,2,1.0
2347,11/12/2022,23.153424657534245,L,0,2.466666666666667,1,1,1.0,0,0,,0,0,,0,1,1,0,0,0,1,0,2,1.0,3.0,Udoka Azubuike,1,1,1.0
2348,11/23/2022,23.183561643835617,L,0,1.2833333333333332,0,0,,0,0,,0,0,,1,0,1,0,0,0,0,0,0,0.7,-4.0,Udoka Azubuike,0,0,
2349,10/19/2022,22.104109589041094,W,0,0.9166666666666666,0,0,,0,0,,0,0,,0,0,0,0,0,0,0,0,0,0.0,4.0,Leandro Bolmaro,0,0,
2350,10/28/2022,22.12876712328767,L,0,15.3,1,3,0.333,0,1,0.0,0,0,,1,0,1,2,0,1,1,3,2,0.9,16.0,Leandro Bolmaro,1,2,0.5
2351,11/7/2022,22.156164383561645,W,0,5.033333333333333,1,4,0.25,0,1,0.0,0,0,,0,0,0,0,2,0,1,1,2,0.2,-2.0,Leandro Bolmaro,1,3,0.3333333333333333
2352,10/28/2022,24.561643835616437,L,0,8.483333333333333,2,2,1.0,0,0,,0,0,,1,2,3,1,0,0,0,1,4,5.0,9.0,Micah Potter,2,2,1.0
2353,10/31/2022,24.56986301369863,W,0,3.283333333333333,0,0,,0,0,,0,0,,0,0,0,0,0,0,0,1,0,-0.4,-1.0,Micah Potter,0,0,
2354,10/19/2022,26.17808219178082,L,0,21.316666666666666,3,7,0.429,0,2,0.0,2,2,1.0,0,1,1,1,0,0,2,2,8,2.5,-10.0,Bruce Brown,3,5,0.6
2355,10/21/2022,26.183561643835617,W,1,30.5,8,10,0.8,3,4,0.75,1,2,0.5,0,1,1,5,1,0,3,2,20,16.8,-8.0,Bruce Brown,5,6,0.8333333333333334
2356,10/22/2022,26.186301369863013,W,0,26.25,2,8,0.25,1,3,0.333,0,2,0.0,1,1,2,3,0,1,0,1,5,2.8,-5.0,Bruce Brown,1,5,0.2
2357,10/24/2022,26.19178082191781,L,0,24.416666666666668,3,6,0.5,0,1,0.0,0,0,,2,3,5,4,1,1,1,1,6,8.4,-16.0,Bruce Brown,3,5,0.6
2358,10/26/2022,26.197260273972603,W,1,33.016666666666666,7,12,0.583,4,6,0.667,0,0,,2,3,5,4,2,0,0,3,18,18.3,24.0,Bruce Brown,3,6,0.5
2359,10/28/2022,26.202739726027396,W,1,30.383333333333333,3,7,0.429,1,3,0.333,0,0,,1,4,5,3,0,0,1,2,7,5.5,-3.0,Bruce Brown,2,4,0.5
2360,10/30/2022,26.208219178082192,L,0,27.85,4,10,0.4,2,5,0.4,0,0,,2,0,2,4,0,0,3,0,10,5.8,-28.0,Bruce Brown,2,5,0.4
2361,11/3/2022,26.21917808219178,W,0,31.85,6,11,0.545,3,6,0.5,0,0,,1,4,5,9,1,1,0,4,15,18.0,8.0,Bruce Brown,3,5,0.6
2362,11/5/2022,26.224657534246575,W,0,19.966666666666665,3,9,0.333,0,3,0.0,3,3,1.0,1,2,3,3,1,0,0,2,9,7.5,17.0,Bruce Brown,3,6,0.5
2363,11/7/2022,26.23013698630137,W,0,24.716666666666665,1,5,0.2,0,1,0.0,0,0,,0,0,0,3,1,2,1,2,2,1.6,-6.0,Bruce Brown,1,4,0.25
2364,11/9/2022,26.235616438356164,W,0,21.583333333333332,1,5,0.2,0,1,0.0,0,0,,0,1,1,3,1,1,1,2,2,1.2,5.0,Bruce Brown,1,4,0.25
2365,11/11/2022,26.24109589041096,L,0,36.68333333333333,5,14,0.357,1,2,0.5,5,5,1.0,5,5,10,6,2,0,1,1,16,18.0,-8.0,Bruce Brown,4,12,0.3333333333333333
2366,11/13/2022,26.246575342465754,W,0,31.5,5,9,0.556,1,4,0.25,1,1,1.0,1,10,11,6,0,1,6,2,12,9.5,12.0,Bruce Brown,4,5,0.8
2367,11/16/2022,26.254794520547946,L,0,21.866666666666667,5,10,0.5,2,5,0.4,0,0,,1,5,6,3,1,2,4,1,12,9.3,0.0,Bruce Brown,3,5,0.6
2368,11/18/2022,26.26027397260274,L,1,29.733333333333334,7,12,0.583,2,3,0.667,2,2,1.0,0,4,4,7,1,0,1,3,18,17.3,-13.0,Bruce Brown,5,9,0.5555555555555556
2369,11/20/2022,26.265753424657536,W,1,35.78333333333333,5,13,0.385,0,3,0.0,2,2,1.0,1,3,4,8,1,1,2,3,12,10.6,-2.0,Bruce Brown,5,10,0.5
2370,11/22/2022,26.27123287671233,L,0,25.316666666666666,5,9,0.556,1,2,0.5,0,0,,1,3,4,5,1,0,2,1,11,10.4,-19.0,Bruce Brown,4,7,0.5714285714285714
2371,11/23/2022,26.273972602739725,W,1,44.96666666666667,7,14,0.5,3,6,0.5,0,0,,1,12,13,10,4,0,6,5,17,17.3,6.0,Bruce Brown,4,8,0.5
2372,11/25/2022,26.279452054794522,W,1,31.283333333333335,4,7,0.571,0,2,0.0,0,0,,0,4,4,4,1,0,1,5,8,6.7,12.0,Bruce Brown,4,5,0.8
2373,10/19/2022,29.665753424657535,L,1,35.0,0,3,0.0,0,2,0.0,2,2,1.0,0,4,4,6,2,1,1,2,2,6.2,3.0,Kentavious Caldwell-Pope,0,1,0.0
2374,10/21/2022,29.671232876712327,W,1,32.78333333333333,7,14,0.5,3,6,0.5,0,0,,2,2,4,1,2,0,2,3,17,11.5,-10.0,Kentavious Caldwell-Pope,4,8,0.5
2375,10/22/2022,29.673972602739727,W,1,31.916666666666668,7,13,0.538,6,10,0.6,1,1,1.0,0,5,5,2,0,0,2,5,21,13.6,16.0,Kentavious Caldwell-Pope,1,3,0.3333333333333333
2376,10/24/2022,29.67945205479452,L,1,30.416666666666668,2,6,0.333,1,3,0.333,1,1,1.0,1,1,2,5,1,0,1,2,6,6.3,-15.0,Kentavious Caldwell-Pope,1,3,0.3333333333333333
2377,10/26/2022,29.684931506849313,W,1,25.25,4,7,0.571,3,5,0.6,2,2,1.0,0,4,4,1,1,0,0,1,13,12.2,12.0,Kentavious Caldwell-Pope,1,2,0.5
2378,10/30/2022,29.695890410958903,L,1,33.483333333333334,3,8,0.375,3,4,0.75,0,0,,0,5,5,5,1,2,1,1,9,10.6,5.0,Kentavious Caldwell-Pope,0,4,0.0
2379,11/3/2022,29.706849315068492,W,1,35.1,4,9,0.444,3,6,0.5,0,0,,0,3,3,1,0,1,0,2,11,7.8,14.0,Kentavious Caldwell-Pope,1,3,0.3333333333333333
2380,11/5/2022,29.71232876712329,W,1,26.966666666666665,5,6,0.833,2,3,0.667,0,3,0.0,0,1,1,3,4,0,2,3,12,11.8,16.0,Kentavious Caldwell-Pope,3,3,1.0
2381,11/7/2022,29.71780821917808,W,1,31.6,5,8,0.625,1,3,0.333,0,0,,0,4,4,3,3,0,2,1,11,11.3,17.0,Kentavious Caldwell-Pope,4,5,0.8
2382,11/9/2022,29.723287671232878,W,1,31.416666666666668,5,7,0.714,3,4,0.75,2,2,1.0,1,7,8,2,2,0,3,0,15,15.3,9.0,Kentavious Caldwell-Pope,2,3,0.6666666666666666
2383,11/11/2022,29.72876712328767,L,1,33.56666666666667,5,11,0.455,5,7,0.714,0,0,,0,0,0,1,0,0,0,3,15,8.8,-6.0,Kentavious Caldwell-Pope,0,4,0.0
2384,11/13/2022,29.734246575342464,W,1,24.883333333333333,3,8,0.375,0,2,0.0,4,5,0.8,0,3,3,2,2,0,1,1,10,8.1,25.0,Kentavious Caldwell-Pope,3,6,0.5
2385,11/16/2022,29.742465753424657,L,1,31.016666666666666,5,9,0.556,2,5,0.4,1,1,1.0,1,0,1,2,0,0,1,4,13,8.2,-2.0,Kentavious Caldwell-Pope,3,4,0.75
2386,11/18/2022,29.747945205479454,L,1,33.55,7,13,0.538,3,5,0.6,1,1,1.0,2,2,4,1,0,0,1,1,18,13.0,-17.0,Kentavious Caldwell-Pope,4,8,0.5
2387,11/20/2022,29.753424657534246,W,1,38.05,2,11,0.182,1,5,0.2,4,4,1.0,0,4,4,3,1,0,4,0,9,2.4,8.0,Kentavious Caldwell-Pope,1,6,0.16666666666666666
2388,11/22/2022,29.75890410958904,L,1,29.9,4,10,0.4,2,5,0.4,0,0,,1,1,2,1,2,2,1,4,10,7.1,11.0,Kentavious Caldwell-Pope,2,5,0.4
2389,11/23/2022,29.76164383561644,W,1,41.1,4,10,0.4,3,8,0.375,4,6,0.667,2,5,7,1,0,1,2,4,15,9.5,12.0,Kentavious Caldwell-Pope,1,2,0.5
2390,11/25/2022,29.767123287671232,W,1,30.833333333333332,2,4,0.5,1,2,0.5,1,2,0.5,0,0,0,1,1,0,0,1,6,4.9,23.0,Kentavious Caldwell-Pope,1,2,0.5
2391,10/19/2022,21.506849315068493,L,0,1.7666666666666666,0,0,,0,0,,0,0,,0,0,0,0,0,0,0,1,0,-0.4,-6.0,Christian Braun,0,0,
2392,10/21/2022,21.512328767123286,W,0,22.766666666666666,2,5,0.4,0,1,0.0,0,0,,2,3,5,3,3,0,1,1,4,7.3,14.0,Christian Braun,2,4,0.5
2393,10/22/2022,21.515068493150686,W,0,16.483333333333334,3,5,0.6,3,4,0.75,0,0,,0,1,1,2,1,1,1,1,9,8.7,-14.0,Christian Braun,0,1,0.0
2394,10/24/2022,21.52054794520548,L,0,12.65,0,2,0.0,0,1,0.0,0,0,,1,2,3,0,0,0,0,1,0,-0.5,-6.0,Christian Braun,0,1,0.0
2395,10/26/2022,21.526027397260275,W,0,25.083333333333332,4,6,0.667,0,1,0.0,1,2,0.5,2,3,5,0,0,0,1,1,9,6.9,2.0,Christian Braun,4,5,0.8
2396,10/28/2022,21.53150684931507,W,0,32.416666666666664,4,7,0.571,1,3,0.333,1,2,0.5,2,4,6,1,0,1,1,1,10,8.9,16.0,Christian Braun,3,4,0.75
2397,10/30/2022,21.536986301369865,L,0,12.95,0,3,0.0,0,2,0.0,0,0,,0,0,0,2,0,0,0,1,0,-1.1,-20.0,Christian Braun,0,1,0.0
2398,11/3/2022,21.54794520547945,W,0,7.266666666666667,1,1,1.0,1,1,1.0,0,0,,0,0,0,1,0,0,0,2,3,2.6,2.0,Christian Braun,0,0,
2399,11/5/2022,21.553424657534247,W,0,14.45,1,4,0.25,0,1,0.0,0,0,,0,2,2,1,0,0,0,0,2,0.9,-10.0,Christian Braun,1,3,0.3333333333333333
2400,11/7/2022,21.55890410958904,W,0,2.5,0,0,,0,0,,0,0,,0,0,0,1,0,0,1,0,0,-0.3,3.0,Christian Braun,0,0,
2401,11/11/2022,21.56986301369863,L,0,13.3,1,1,1.0,0,0,,0,0,,0,2,2,2,0,0,0,0,2,3.7,-7.0,Christian Braun,1,1,1.0
2402,11/13/2022,21.575342465753426,W,0,26.216666666666665,3,6,0.5,1,2,0.5,2,2,1.0,0,2,2,1,2,0,0,2,9,8.5,4.0,Christian Braun,2,4,0.5
2403,11/16/2022,21.583561643835615,L,0,14.916666666666666,1,2,0.5,0,0,,0,0,,1,0,1,1,0,1,0,1,2,2.7,-3.0,Christian Braun,1,2,0.5
2404,11/18/2022,21.589041095890412,L,0,13.416666666666666,1,5,0.2,0,1,0.0,1,3,0.333,2,2,4,0,0,0,0,3,3,-0.1,-6.0,Christian Braun,1,4,0.25
2405,11/20/2022,21.594520547945205,W,0,16.233333333333334,2,5,0.4,1,1,1.0,0,0,,0,4,4,0,1,0,0,3,5,3.3,-3.0,Christian Braun,1,4,0.25
2406,11/22/2022,21.6,L,0,3.4333333333333336,0,0,,0,0,,0,0,,1,0,1,0,0,0,0,0,0,0.7,-7.0,Christian Braun,0,0,
2407,11/23/2022,21.602739726027398,W,0,13.55,0,3,0.0,0,1,0.0,2,2,1.0,2,4,6,0,0,0,1,1,2,1.1,-4.0,Christian Braun,0,2,0.0
2408,11/25/2022,21.60821917808219,W,0,6.6,0,0,,0,0,,0,2,0.0,0,0,0,0,1,0,0,0,0,0.2,-13.0,Christian Braun,0,0,
2409,10/19/2022,27.663013698630138,L,1,33.416666666666664,12,17,0.706,1,3,0.333,2,2,1.0,2,2,4,6,3,0,3,4,27,24.5,-5.0,Nikola Jokić,11,14,0.7857142857142857
2410,10/21/2022,27.66849315068493,W,1,34.4,7,13,0.538,1,2,0.5,11,11,1.0,3,9,12,10,0,0,5,4,26,24.9,-3.0,Nikola Jokić,6,11,0.5454545454545454
2411,10/22/2022,27.671232876712327,W,1,38.68333333333333,6,10,0.6,1,1,1.0,6,9,0.667,1,15,16,13,1,1,3,2,19,25.4,18.0,Nikola Jokić,5,9,0.5555555555555556
2412,10/24/2022,27.676712328767124,L,1,26.966666666666665,3,4,0.75,0,0,,3,3,1.0,1,8,9,9,0,0,1,5,9,13.8,-10.0,Nikola Jokić,3,4,0.75
2413,10/26/2022,27.682191780821917,W,1,34.8,12,17,0.706,0,4,0.0,7,7,1.0,1,12,13,9,4,0,3,3,31,34.3,28.0,Nikola Jokić,12,13,0.9230769230769231
2414,10/28/2022,27.687671232876713,W,1,25.466666666666665,3,10,0.3,0,4,0.0,6,8,0.75,3,7,10,6,1,1,1,1,12,14.1,8.0,Nikola Jokić,3,6,0.5
2415,10/30/2022,27.693150684931506,L,1,35.86666666666667,8,16,0.5,1,5,0.2,6,7,0.857,4,10,14,6,0,2,2,0,23,24.0,0.0,Nikola Jokić,7,11,0.6363636363636364
2416,11/3/2022,27.704109589041096,W,1,35.63333333333333,6,9,0.667,0,0,,3,3,1.0,0,13,13,14,1,0,10,3,15,14.6,15.0,Nikola Jokić,6,9,0.6666666666666666
2417,11/5/2022,27.70958904109589,W,1,26.566666666666666,9,10,0.9,1,1,1.0,2,2,1.0,0,6,6,10,2,0,4,2,21,23.6,20.0,Nikola Jokić,8,9,0.8888888888888888
2418,11/7/2022,27.715068493150685,W,1,33.95,11,20,0.55,0,1,0.0,4,5,0.8,1,7,8,10,2,3,4,2,26,25.1,15.0,Nikola Jokić,11,19,0.5789473684210527
2419,11/9/2022,27.720547945205478,W,1,20.7,10,20,0.5,1,3,0.333,3,3,1.0,1,3,4,6,2,1,1,5,24,19.5,11.0,Nikola Jokić,9,17,0.5294117647058824
2420,11/11/2022,27.726027397260275,L,1,29.733333333333334,12,20,0.6,2,4,0.5,3,4,0.75,3,5,8,3,0,0,2,4,29,21.5,-14.0,Nikola Jokić,10,16,0.625
2421,11/13/2022,27.731506849315068,W,1,27.6,4,4,1.0,0,0,,0,0,,0,6,6,14,3,0,2,0,8,19.4,29.0,Nikola Jokić,4,4,1.0
2422,11/22/2022,27.756164383561643,L,1,36.733333333333334,12,16,0.75,0,0,,7,11,0.636,2,7,9,10,1,1,5,3,31,29.0,13.0,Nikola Jokić,12,16,0.75
2423,11/23/2022,27.75890410958904,W,1,43.15,11,15,0.733,1,3,0.333,16,18,0.889,3,7,10,9,0,0,4,5,39,36.6,11.0,Nikola Jokić,10,12,0.8333333333333334
2424,11/25/2022,27.764383561643836,W,1,32.4,7,13,0.538,0,1,0.0,5,7,0.714,2,11,13,6,2,1,2,3,19,20.3,19.0,Nikola Jokić,7,12,0.5833333333333334
2425,10/19/2022,27.09041095890411,L,1,32.96666666666667,10,17,0.588,0,2,0.0,2,2,1.0,4,6,10,2,1,1,1,1,22,20.4,-7.0,Aaron Gordon,10,15,0.6666666666666666
2426,10/21/2022,27.095890410958905,W,1,28.783333333333335,5,12,0.417,0,6,0.0,0,0,,1,2,3,3,0,0,3,1,10,3.6,-10.0,Aaron Gordon,5,6,0.8333333333333334
2427,10/22/2022,27.0986301369863,W,1,28.366666666666667,3,9,0.333,1,3,0.333,4,8,0.5,5,5,10,2,0,2,2,0,11,10.1,19.0,Aaron Gordon,2,6,0.3333333333333333
2428,10/24/2022,27.104109589041094,L,1,27.616666666666667,12,16,0.75,0,2,0.0,2,2,1.0,2,4,6,1,0,0,1,4,26,20.3,-16.0,Aaron Gordon,12,14,0.8571428571428571
2429,10/26/2022,27.10958904109589,W,1,28.5,2,8,0.25,0,3,0.0,2,4,0.5,3,6,9,5,0,2,0,1,6,8.8,19.0,Aaron Gordon,2,5,0.4
2430,10/28/2022,27.115068493150684,W,1,21.316666666666666,1,4,0.25,1,3,0.333,0,2,0.0,0,1,1,0,0,2,2,0,3,-0.5,0.0,Aaron Gordon,0,1,0.0
2431,10/30/2022,27.12054794520548,L,1,30.683333333333334,7,11,0.636,3,4,0.75,1,2,0.5,1,5,6,0,0,2,1,3,18,14.1,17.0,Aaron Gordon,4,7,0.5714285714285714
2432,11/3/2022,27.13150684931507,W,1,35.53333333333333,10,13,0.769,3,4,0.75,4,5,0.8,2,3,5,3,1,0,0,0,27,26.9,-1.0,Aaron Gordon,7,9,0.7777777777777778
2433,11/5/2022,27.136986301369863,W,1,22.55,4,6,0.667,0,1,0.0,0,2,0.0,2,4,6,2,0,0,0,1,8,8.2,15.0,Aaron Gordon,4,5,0.8
2434,11/7/2022,27.14246575342466,W,1,29.7,3,5,0.6,0,1,0.0,3,5,0.6,2,3,5,5,4,1,0,1,9,16.0,10.0,Aaron Gordon,3,4,0.75
2435,11/9/2022,27.147945205479452,W,1,34.38333333333333,5,8,0.625,1,3,0.333,7,9,0.778,4,12,16,6,1,1,5,2,18,20.1,4.0,Aaron Gordon,4,5,0.8
2436,11/11/2022,27.153424657534245,L,1,30.4,6,10,0.6,1,2,0.5,4,6,0.667,3,4,7,2,0,0,0,3,17,15.1,-4.0,Aaron Gordon,5,8,0.625
2437,11/13/2022,27.15890410958904,W,1,25.983333333333334,4,6,0.667,1,1,1.0,4,6,0.667,0,5,5,2,0,0,1,2,13,10.7,24.0,Aaron Gordon,3,5,0.6
2438,11/22/2022,27.183561643835617,L,1,28.583333333333332,7,10,0.7,1,2,0.5,2,5,0.4,3,4,7,1,1,1,3,3,17,13.1,21.0,Aaron Gordon,6,8,0.75
2439,11/23/2022,27.186301369863013,W,1,37.71666666666667,10,16,0.625,4,5,0.8,7,11,0.636,5,3,8,4,0,2,1,1,31,29.4,5.0,Aaron Gordon,6,11,0.5454545454545454
2440,11/25/2022,27.19178082191781,W,1,27.983333333333334,12,16,0.75,2,4,0.5,3,4,0.75,5,2,7,3,2,2,1,4,29,29.2,13.0,Aaron Gordon,10,12,0.8333333333333334
2441,10/19/2022,24.306849315068494,L,1,35.36666666666667,5,10,0.5,2,4,0.5,3,4,0.75,2,5,7,1,1,0,4,4,15,8.6,1.0,Michael Porter Jr.,3,6,0.5
2442,10/21/2022,24.312328767123287,W,1,27.9,6,12,0.5,5,10,0.5,0,0,,0,6,6,1,1,1,0,5,17,13.2,-7.0,Michael Porter Jr.,1,2,0.5
2443,10/22/2022,24.315068493150687,W,1,27.65,8,15,0.533,5,10,0.5,1,1,1.0,2,4,6,1,1,1,3,4,22,15.1,20.0,Michael Porter Jr.,3,5,0.6
2444,10/24/2022,24.32054794520548,L,1,25.516666666666666,7,14,0.5,4,8,0.5,0,0,,1,3,4,2,0,0,1,5,18,11.0,-3.0,Michael Porter Jr.,3,6,0.5
2445,10/28/2022,24.33150684931507,W,1,30.05,7,15,0.467,4,5,0.8,4,5,0.8,4,9,13,1,0,0,0,2,22,19.3,22.0,Michael Porter Jr.,3,10,0.3
2446,10/30/2022,24.336986301369862,L,1,27.833333333333332,5,15,0.333,3,10,0.3,4,5,0.8,3,6,9,1,1,0,0,4,17,12.1,10.0,Michael Porter Jr.,2,5,0.4
2447,11/3/2022,24.34794520547945,W,1,28.6,4,10,0.4,3,6,0.5,0,0,,1,5,6,2,0,0,1,1,11,7.8,7.0,Michael Porter Jr.,1,4,0.25
2448,11/5/2022,24.353424657534248,W,1,29.8,6,10,0.6,3,6,0.5,0,0,,1,8,9,0,1,0,2,3,15,11.3,27.0,Michael Porter Jr.,3,4,0.75
2449,11/7/2022,24.35890410958904,W,1,30.316666666666666,9,16,0.563,4,8,0.5,2,2,1.0,0,6,6,2,1,0,0,2,24,19.8,3.0,Michael Porter Jr.,5,8,0.625
2450,11/9/2022,24.364383561643837,W,1,36.28333333333333,7,14,0.5,3,7,0.429,0,0,,2,4,6,2,0,1,1,0,17,13.7,-6.0,Michael Porter Jr.,4,7,0.5714285714285714
2451,11/11/2022,24.36986301369863,L,1,25.133333333333333,3,10,0.3,1,6,0.167,0,0,,0,4,4,0,0,0,0,2,7,1.6,-24.0,Michael Porter Jr.,2,4,0.5
2452,11/13/2022,24.375342465753423,W,1,24.183333333333334,11,16,0.688,6,9,0.667,3,3,1.0,0,1,1,2,2,0,0,3,31,26.7,23.0,Michael Porter Jr.,5,7,0.7142857142857143
2453,11/16/2022,24.383561643835616,L,1,27.666666666666668,1,8,0.125,1,6,0.167,2,2,1.0,0,3,3,2,0,0,2,2,5,-0.7,-8.0,Michael Porter Jr.,0,2,0.0
2454,11/18/2022,24.389041095890413,L,1,24.283333333333335,4,15,0.267,1,5,0.2,1,1,1.0,0,3,3,2,0,0,1,2,10,1.6,-21.0,Michael Porter Jr.,3,10,0.3
2455,11/20/2022,24.394520547945206,W,1,30.95,6,11,0.545,1,5,0.2,1,4,0.25,0,5,5,0,2,1,2,2,14,8.9,6.0,Michael Porter Jr.,5,6,0.8333333333333334
2456,11/22/2022,24.4,L,1,33.38333333333333,7,15,0.467,1,5,0.2,3,3,1.0,3,5,8,1,0,2,1,1,18,14.6,16.0,Michael Porter Jr.,6,10,0.6
2457,10/19/2022,36.14246575342466,L,0,14.616666666666667,2,5,0.4,0,1,0.0,2,2,1.0,1,3,4,0,1,0,2,3,6,2.7,-14.0,Jeff Green,2,4,0.5
2458,10/21/2022,36.14794520547945,W,0,19.066666666666666,3,5,0.6,2,2,1.0,2,2,1.0,1,2,3,1,0,0,0,1,10,9.3,14.0,Jeff Green,1,3,0.3333333333333333
2459,10/22/2022,36.15068493150685,W,0,19.633333333333333,5,5,1.0,2,2,1.0,2,4,0.5,0,1,1,2,0,0,0,2,14,12.6,-14.0,Jeff Green,3,3,1.0
2460,10/24/2022,36.156164383561645,L,0,19.733333333333334,3,8,0.375,0,1,0.0,1,2,0.5,1,1,2,1,1,0,0,2,7,4.1,-15.0,Jeff Green,3,7,0.42857142857142855
2461,10/26/2022,36.16164383561644,W,0,21.933333333333334,3,8,0.375,0,2,0.0,4,4,1.0,1,3,4,3,2,0,0,3,10,10.1,7.0,Jeff Green,3,6,0.5
2462,10/28/2022,36.16712328767123,W,0,24.683333333333334,3,5,0.6,0,1,0.0,4,5,0.8,2,4,6,2,0,0,0,2,10,10.5,19.0,Jeff Green,3,4,0.75
2463,10/30/2022,36.172602739726024,L,0,16.916666666666668,2,7,0.286,0,2,0.0,1,2,0.5,1,1,2,1,0,0,0,2,5,1.4,-26.0,Jeff Green,2,5,0.4
2464,11/3/2022,36.18356164383562,W,0,19.35,3,5,0.6,0,1,0.0,1,2,0.5,0,4,4,0,2,0,3,2,7,3.7,6.0,Jeff Green,3,4,0.75
2465,11/5/2022,36.18904109589041,W,0,25.45,4,8,0.5,1,2,0.5,0,0,,2,2,4,1,0,0,4,1,9,3.3,10.0,Jeff Green,3,6,0.5
2466,11/7/2022,36.1945205479452,W,0,18.116666666666667,3,5,0.6,0,2,0.0,0,1,0.0,1,1,2,1,0,1,1,1,6,4.3,-4.0,Jeff Green,3,3,1.0
2467,11/9/2022,36.2,W,0,18.483333333333334,2,3,0.667,0,1,0.0,0,0,,0,0,0,0,0,1,1,4,4,0.8,-2.0,Jeff Green,2,2,1.0
2468,11/11/2022,36.205479452054796,L,0,21.1,2,4,0.5,0,0,,3,3,1.0,0,2,2,2,0,0,0,1,7,6.6,-12.0,Jeff Green,2,4,0.5
2469,11/13/2022,36.21095890410959,W,0,19.266666666666666,3,5,0.6,0,1,0.0,0,0,,1,1,2,2,0,1,2,2,6,4.0,2.0,Jeff Green,3,4,0.75
2470,11/16/2022,36.21917808219178,L,1,27.966666666666665,2,5,0.4,0,1,0.0,6,6,1.0,1,1,2,0,0,0,1,5,10,5.3,-8.0,Jeff Green,2,4,0.5
2471,11/18/2022,36.224657534246575,L,1,27.45,6,10,0.6,0,1,0.0,0,1,0.0,0,2,2,3,0,0,2,1,12,7.3,-14.0,Jeff Green,6,9,0.6666666666666666
2472,11/20/2022,36.23013698630137,W,1,5.05,1,1,1.0,0,0,,2,2,1.0,0,1,1,0,0,0,0,1,4,3.6,4.0,Jeff Green,1,1,1.0
2473,10/19/2022,25.65205479452055,L,1,25.916666666666668,5,13,0.385,1,4,0.25,1,1,1.0,1,1,2,1,2,0,3,0,12,5.6,-19.0,Jamal Murray,4,9,0.4444444444444444
2474,10/22/2022,25.660273972602738,W,1,27.5,6,12,0.5,1,4,0.25,3,4,0.75,0,4,4,5,2,0,5,0,16,11.3,10.0,Jamal Murray,5,8,0.625
2475,10/24/2022,25.665753424657535,L,1,26.616666666666667,3,12,0.25,2,4,0.5,0,2,0.0,0,2,2,1,0,0,0,2,8,0.5,-15.0,Jamal Murray,1,8,0.125
2476,10/26/2022,25.671232876712327,W,1,27.716666666666665,6,15,0.4,1,7,0.143,0,0,,0,4,4,6,2,0,4,1,13,7.9,17.0,Jamal Murray,5,8,0.625
2477,10/28/2022,25.676712328767124,W,1,20.55,5,9,0.556,2,4,0.5,1,2,0.5,0,1,1,1,0,0,0,0,13,9.3,0.0,Jamal Murray,3,5,0.6
2478,10/30/2022,25.682191780821917,L,1,31.516666666666666,9,21,0.429,3,7,0.429,0,0,,0,4,4,5,0,0,1,1,21,13.2,13.0,Jamal Murray,6,14,0.42857142857142855
2479,11/3/2022,25.693150684931506,W,1,32.95,8,19,0.421,4,6,0.667,4,4,1.0,1,4,5,2,0,0,2,0,24,15.2,2.0,Jamal Murray,4,13,0.3076923076923077
2480,11/5/2022,25.698630136986303,W,1,23.033333333333335,6,10,0.6,1,3,0.333,0,0,,1,0,1,9,0,0,1,0,13,14.4,17.0,Jamal Murray,5,7,0.7142857142857143
2481,11/7/2022,25.704109589041096,W,1,31.633333333333333,9,17,0.529,0,3,0.0,1,3,0.333,1,4,5,6,1,0,4,1,19,12.6,10.0,Jamal Murray,9,14,0.6428571428571429
2482,11/9/2022,25.70958904109589,W,1,29.783333333333335,6,15,0.4,1,2,0.5,5,5,1.0,3,5,8,4,3,0,3,0,18,16.3,-3.0,Jamal Murray,5,13,0.38461538461538464
2483,11/11/2022,25.715068493150685,L,1,34.7,6,17,0.353,1,5,0.2,1,2,0.5,0,4,4,10,0,0,0,2,14,11.5,-12.0,Jamal Murray,5,12,0.4166666666666667
2484,11/13/2022,25.720547945205478,W,1,32.166666666666664,9,18,0.5,2,6,0.333,3,3,1.0,1,1,2,2,2,0,2,2,23,15.6,10.0,Jamal Murray,7,12,0.5833333333333334
2485,11/16/2022,25.72876712328767,L,1,32.516666666666666,7,20,0.35,3,7,0.429,4,4,1.0,0,9,9,6,1,1,3,1,21,15.0,-1.0,Jamal Murray,4,13,0.3076923076923077
2486,11/22/2022,25.745205479452054,L,1,34.38333333333333,3,12,0.25,0,2,0.0,4,5,0.8,0,1,1,8,2,1,2,3,10,7.8,13.0,Jamal Murray,3,10,0.3
2487,11/25/2022,25.753424657534246,W,1,33.6,9,21,0.429,3,9,0.333,0,0,,1,5,6,9,1,0,1,2,21,17.6,22.0,Jamal Murray,6,12,0.5
2488,10/19/2022,34.24657534246575,L,0,6.466666666666667,0,0,,0,0,,0,0,,0,2,2,1,0,0,0,1,0,0.9,-13.0,DeAndre Jordan,0,0,
2489,10/21/2022,34.25205479452055,W,0,13.6,4,4,1.0,0,0,,1,2,0.5,3,2,5,0,0,1,2,1,9,8.4,8.0,DeAndre Jordan,4,4,1.0
2490,10/24/2022,34.26027397260274,L,0,10.0,2,3,0.667,0,0,,0,2,0.0,0,2,2,1,0,0,0,1,4,2.8,-3.0,DeAndre Jordan,2,3,0.6666666666666666
2491,10/26/2022,34.26575342465753,W,0,10.433333333333334,1,1,1.0,0,0,,0,0,,0,5,5,0,0,1,1,1,2,2.5,-10.0,DeAndre Jordan,1,1,1.0
2492,10/28/2022,34.271232876712325,W,0,20.533333333333335,4,6,0.667,1,1,1.0,3,6,0.5,4,9,13,1,0,0,4,5,12,8.4,11.0,DeAndre Jordan,3,5,0.6
2493,10/30/2022,34.276712328767125,L,0,12.133333333333333,2,2,1.0,0,0,,1,2,0.5,2,4,6,0,1,2,0,2,5,8.2,-11.0,DeAndre Jordan,2,2,1.0
2494,11/5/2022,34.293150684931504,W,0,16.616666666666667,5,6,0.833,0,0,,0,0,,2,6,8,1,0,0,1,3,10,9.5,5.0,DeAndre Jordan,5,6,0.8333333333333334
2495,11/7/2022,34.298630136986304,W,0,14.05,1,2,0.5,0,0,,2,2,1.0,3,5,8,1,0,0,2,1,4,4.9,-9.0,DeAndre Jordan,1,2,0.5
2496,11/9/2022,34.3041095890411,W,0,17.6,3,3,1.0,0,0,,2,2,1.0,0,2,2,1,0,1,3,0,8,6.1,-1.0,DeAndre Jordan,3,3,1.0
2497,11/11/2022,34.30958904109589,L,0,9.183333333333334,1,2,0.5,0,0,,0,0,,0,0,0,0,0,1,0,0,2,1.7,-5.0,DeAndre Jordan,1,2,0.5
2498,11/13/2022,34.31506849315068,W,0,16.983333333333334,2,2,1.0,0,0,,0,1,0.0,1,2,3,2,0,1,2,1,4,4.0,-5.0,DeAndre Jordan,2,2,1.0
2499,11/16/2022,34.323287671232876,L,1,26.0,2,4,0.5,0,0,,0,2,0.0,2,6,8,2,0,1,1,2,4,4.7,10.0,DeAndre Jordan,2,4,0.5
2500,11/18/2022,34.32876712328767,L,1,20.35,3,3,1.0,0,0,,0,1,0.0,4,3,7,2,1,1,3,2,6,7.7,-6.0,DeAndre Jordan,3,3,1.0
2501,11/20/2022,34.33424657534247,W,1,33.81666666666667,4,5,0.8,0,0,,0,1,0.0,2,15,17,1,1,0,1,2,8,11.5,4.0,DeAndre Jordan,4,5,0.8
2502,11/22/2022,34.33972602739726,L,0,11.266666666666667,0,2,0.0,0,0,,1,2,0.5,1,3,4,2,0,1,1,3,1,0.7,-15.0,DeAndre Jordan,0,2,0.0
2503,10/19/2022,21.775342465753425,L,0,1.4666666666666668,0,0,,0,0,,0,0,,0,0,0,0,0,0,0,0,0,0.0,-4.0,Zeke Nnaji,0,0,
2504,10/22/2022,21.783561643835615,W,0,9.233333333333333,2,3,0.667,0,0,,0,0,,0,0,0,0,0,0,1,4,4,0.1,-10.0,Zeke Nnaji,2,3,0.6666666666666666
2505,10/24/2022,21.78904109589041,L,0,4.116666666666666,2,3,0.667,0,1,0.0,0,0,,0,0,0,0,1,0,0,3,4,2.5,-3.0,Zeke Nnaji,2,2,1.0
2506,10/26/2022,21.794520547945204,W,0,2.7666666666666666,0,0,,0,0,,0,0,,0,0,0,0,0,0,0,0,0,0.0,-7.0,Zeke Nnaji,0,0,
2507,10/28/2022,21.8,W,0,2.0,0,1,0.0,0,1,0.0,0,0,,0,0,0,0,0,0,0,1,0,-1.1,-3.0,Zeke Nnaji,0,0,
2508,11/3/2022,21.816438356164383,W,0,5.483333333333333,1,3,0.333,0,0,,2,2,1.0,3,2,5,0,0,0,0,0,4,5.0,4.0,Zeke Nnaji,1,3,0.3333333333333333
2509,11/11/2022,21.838356164383562,L,0,2.033333333333333,0,1,0.0,0,1,0.0,0,0,,0,1,1,0,1,0,1,0,0,-0.4,-1.0,Zeke Nnaji,0,0,
2510,11/13/2022,21.843835616438355,W,0,3.4166666666666665,2,2,1.0,0,0,,0,0,,1,0,1,0,0,0,0,1,4,3.7,-1.0,Zeke Nnaji,2,2,1.0
2511,11/16/2022,21.852054794520548,L,0,26.283333333333335,5,7,0.714,1,3,0.333,2,3,0.667,2,1,3,0,1,0,2,5,13,8.4,2.0,Zeke Nnaji,4,4,1.0
2512,11/18/2022,21.85753424657534,L,0,21.283333333333335,2,2,1.0,0,0,,0,0,,1,0,1,1,0,0,0,1,4,4.4,-18.0,Zeke Nnaji,2,2,1.0
2513,11/20/2022,21.863013698630137,W,0,15.75,2,4,0.5,1,1,1.0,0,0,,0,0,0,1,0,1,1,3,5,2.2,6.0,Zeke Nnaji,1,3,0.3333333333333333
2514,11/22/2022,21.86849315068493,L,0,19.45,4,6,0.667,0,0,,0,0,,3,1,4,0,0,0,1,1,8,6.4,-23.0,Zeke Nnaji,4,6,0.6666666666666666
2515,11/23/2022,21.87123287671233,W,0,15.35,3,5,0.6,0,0,,2,2,1.0,2,0,2,0,0,0,0,3,8,5.9,-1.0,Zeke Nnaji,3,5,0.6
2516,11/25/2022,21.876712328767123,W,0,15.6,2,5,0.4,0,2,0.0,2,2,1.0,1,1,2,0,0,0,0,1,6,3.9,-9.0,Zeke Nnaji,2,3,0.6666666666666666
2517,10/19/2022,27.356164383561644,L,0,7.85,0,0,,0,0,,0,0,,0,0,0,0,0,0,2,0,0,-2.0,-12.0,Davon Reed,0,0,
2518,10/21/2022,27.361643835616437,W,0,10.95,0,1,0.0,0,0,,1,2,0.5,0,2,2,1,3,0,1,1,1,2.8,14.0,Davon Reed,0,1,0.0
2519,10/24/2022,27.36986301369863,L,0,7.566666666666666,1,4,0.25,1,3,0.333,0,0,,0,0,0,0,0,0,1,1,3,-0.8,-3.0,Davon Reed,0,1,0.0
2520,10/26/2022,27.375342465753423,W,0,2.7,0,2,0.0,0,1,0.0,0,0,,0,1,1,0,0,0,0,2,0,-1.9,-8.0,Davon Reed,0,1,0.0
2521,10/30/2022,27.386301369863013,L,0,2.5833333333333335,0,0,,0,0,,0,0,,0,0,0,0,0,0,0,0,0,0.0,-11.0,Davon Reed,0,0,
2522,11/3/2022,27.397260273972602,W,0,8.233333333333333,2,4,0.5,1,1,1.0,0,0,,0,1,1,0,0,0,2,1,5,0.9,3.0,Davon Reed,1,3,0.3333333333333333
2523,11/5/2022,27.4027397260274,W,0,4.816666666666666,0,0,,0,0,,0,0,,0,0,0,0,0,0,1,0,0,-1.0,0.0,Davon Reed,0,0,
2524,11/11/2022,27.41917808219178,L,0,2.1333333333333333,1,1,1.0,1,1,1.0,0,0,,0,0,0,0,0,0,1,0,3,1.7,-1.0,Davon Reed,0,0,
2525,11/13/2022,27.424657534246574,W,0,5.05,1,3,0.333,1,1,1.0,0,0,,0,0,0,0,0,0,0,0,3,1.3,-5.0,Davon Reed,0,2,0.0
2526,11/18/2022,27.438356164383563,L,0,11.85,0,3,0.0,0,0,,3,4,0.75,1,5,6,0,0,0,0,2,3,1.9,-4.0,Davon Reed,0,3,0.0
2527,11/20/2022,27.443835616438356,W,0,18.216666666666665,2,4,0.5,1,3,0.333,0,0,,0,2,2,3,1,1,1,0,5,6.4,-7.0,Davon Reed,1,1,1.0
2528,11/22/2022,27.44931506849315,L,0,8.233333333333333,0,1,0.0,0,0,,0,0,,0,2,2,0,0,0,1,2,0,-1.9,-8.0,Davon Reed,0,1,0.0
2529,11/23/2022,27.45205479452055,W,1,24.566666666666666,0,7,0.0,0,5,0.0,0,0,,1,3,4,2,0,0,2,2,0,-4.7,-5.0,Davon Reed,0,2,0.0
2530,11/25/2022,27.457534246575342,W,0,19.583333333333332,2,7,0.286,1,3,0.333,2,2,1.0,1,3,4,0,0,0,0,3,7,3.3,3.0,Davon Reed,1,4,0.25
2531,10/19/2022,22.095890410958905,L,0,16.2,3,8,0.375,1,4,0.25,3,3,1.0,0,0,0,3,0,1,2,3,10,5.2,-9.0,Bones Hyland,2,4,0.5
2532,10/21/2022,22.101369863013698,W,0,19.25,4,10,0.4,1,3,0.333,5,6,0.833,0,0,0,5,0,0,3,3,14,7.5,13.0,Bones Hyland,3,7,0.42857142857142855
2533,10/22/2022,22.104109589041094,W,0,14.283333333333333,0,5,0.0,0,1,0.0,1,2,0.5,0,1,1,3,0,0,1,2,1,-2.3,-15.0,Bones Hyland,0,4,0.0
2534,10/24/2022,22.10958904109589,L,0,18.15,5,10,0.5,4,7,0.571,1,2,0.5,0,1,1,3,0,0,1,1,15,10.6,-18.0,Bones Hyland,1,3,0.3333333333333333
2535,10/26/2022,22.115068493150684,W,0,16.733333333333334,2,12,0.167,1,5,0.2,1,2,0.5,0,3,3,5,0,1,1,0,6,2.1,-1.0,Bones Hyland,1,7,0.14285714285714285
2536,10/28/2022,22.12054794520548,W,0,24.033333333333335,8,18,0.444,7,12,0.583,3,4,0.75,0,1,1,3,1,0,2,3,26,16.4,18.0,Bones Hyland,1,6,0.16666666666666666
2537,11/5/2022,22.14246575342466,W,0,24.966666666666665,9,17,0.529,6,8,0.75,0,0,,1,4,5,7,2,0,1,0,24,23.5,8.0,Bones Hyland,3,9,0.3333333333333333
2538,11/7/2022,22.147945205479452,W,0,23.4,5,10,0.5,3,5,0.6,1,2,0.5,0,2,2,1,2,0,5,3,14,5.7,-9.0,Bones Hyland,2,5,0.4
2539,11/9/2022,22.153424657534245,W,0,29.766666666666666,4,13,0.308,3,7,0.429,5,5,1.0,0,2,2,3,1,1,2,2,16,10.1,-2.0,Bones Hyland,1,6,0.16666666666666666
2540,11/16/2022,22.172602739726027,L,0,22.5,7,15,0.467,5,10,0.5,2,2,1.0,0,7,7,2,0,0,1,3,21,14.6,-6.0,Bones Hyland,2,5,0.4
2541,11/18/2022,22.17808219178082,L,0,26.8,5,16,0.313,3,11,0.273,4,4,1.0,1,1,2,6,1,0,3,2,17,10.2,-24.0,Bones Hyland,2,5,0.4
2542,11/20/2022,22.183561643835617,W,0,35.03333333333333,10,21,0.476,3,8,0.375,6,6,1.0,1,2,3,6,1,1,1,2,29,23.7,-12.0,Bones Hyland,7,13,0.5384615384615384
2543,11/22/2022,22.18904109589041,L,0,9.316666666666666,1,5,0.2,0,3,0.0,0,0,,0,0,0,0,0,0,0,0,2,-1.1,-12.0,Bones Hyland,1,2,0.5
2544,10/19/2022,25.526027397260275,L,0,1.4666666666666668,0,1,0.0,0,0,,0,0,,0,0,0,0,0,0,0,0,0,-0.7,-4.0,Vlatko Čančar,0,1,0.0
2545,10/26/2022,25.545205479452054,W,0,2.7666666666666666,0,0,,0,0,,0,0,,0,0,0,0,0,0,1,0,0,-1.0,-7.0,Vlatko Čančar,0,0,
2546,10/28/2022,25.55068493150685,W,0,2.0,0,0,,0,0,,0,0,,0,0,0,0,0,0,0,0,0,0.0,-3.0,Vlatko Čančar,0,0,
2547,11/5/2022,25.572602739726026,W,0,4.816666666666666,1,1,1.0,1,1,1.0,0,0,,0,2,2,0,0,0,0,0,3,3.3,0.0,Vlatko Čančar,0,0,
2548,11/11/2022,25.589041095890412,L,0,2.033333333333333,0,1,0.0,0,1,0.0,0,0,,0,0,0,0,0,0,0,0,0,-0.7,-1.0,Vlatko Čančar,0,0,
2549,11/13/2022,25.594520547945205,W,0,2.75,1,1,1.0,1,1,1.0,0,0,,0,0,0,0,0,0,0,1,3,2.3,-3.0,Vlatko Čančar,0,0,
2550,11/16/2022,25.602739726027398,L,0,9.266666666666667,1,2,0.5,0,1,0.0,0,0,,0,2,2,0,0,0,0,1,2,1.2,1.0,Vlatko Čančar,1,1,1.0
2551,11/18/2022,25.60821917808219,L,0,23.05,3,7,0.429,1,3,0.333,1,1,1.0,0,1,1,2,1,0,0,3,8,5.8,-19.0,Vlatko Čančar,2,4,0.5
2552,11/20/2022,25.613698630136987,W,0,11.116666666666667,3,3,1.0,1,1,1.0,0,0,,0,4,4,0,2,0,3,4,7,4.7,1.0,Vlatko Čančar,2,2,1.0
2553,11/23/2022,25.621917808219177,W,0,34.81666666666667,7,18,0.389,3,10,0.3,2,2,1.0,1,3,4,5,0,3,1,1,19,15.0,6.0,Vlatko Čančar,4,8,0.5
2554,11/25/2022,25.627397260273973,W,0,24.683333333333334,4,9,0.444,2,4,0.5,3,4,0.75,0,0,0,2,1,1,1,3,13,8.8,10.0,Vlatko Čančar,2,5,0.4
2555,10/19/2022,34.29041095890411,L,0,4.716666666666667,0,1,0.0,0,0,,0,0,,0,1,1,0,0,0,1,2,0,-2.2,-2.0,Ish Smith,0,1,0.0
2556,10/24/2022,34.3041095890411,L,0,3.5666666666666664,0,0,,0,0,,0,0,,0,0,0,1,0,0,1,0,0,-0.3,-3.0,Ish Smith,0,0,
2557,10/26/2022,34.30958904109589,W,0,2.7666666666666666,0,2,0.0,0,0,,0,0,,0,1,1,1,0,1,0,0,0,0.3,-7.0,Ish Smith,0,2,0.0
2558,10/28/2022,34.31506849315068,W,0,3.4166666666666665,1,2,0.5,0,0,,0,0,,0,0,0,0,0,0,1,1,2,-0.4,-2.0,Ish Smith,1,2,0.5
2559,10/30/2022,34.320547945205476,L,0,8.183333333333334,1,3,0.333,0,1,0.0,0,0,,0,0,0,0,0,0,1,1,2,-1.1,-4.0,Ish Smith,1,2,0.5
2560,11/25/2022,34.391780821917806,W,0,13.4,2,5,0.4,1,1,1.0,0,0,,0,1,1,2,0,1,0,1,5,4.3,-12.0,Ish Smith,1,4,0.25
2561,10/19/2022,20.104109589041094,L,0,1.4666666666666668,0,1,0.0,0,0,,0,0,,0,0,0,0,0,0,0,0,0,-0.7,-4.0,Peyton Watson,0,1,0.0
2562,10/24/2022,20.117808219178084,L,0,2.6666666666666665,2,3,0.667,0,0,,0,0,,1,1,2,0,0,0,0,0,4,3.7,1.0,Peyton Watson,2,3,0.6666666666666666
2563,10/26/2022,20.123287671232877,W,0,2.7666666666666666,1,2,0.5,0,0,,0,0,,0,0,0,0,0,0,0,1,2,0.6,-7.0,Peyton Watson,1,2,0.5
2564,10/28/2022,20.12876712328767,W,0,1.8166666666666667,0,1,0.0,0,0,,0,0,,1,0,1,0,0,0,0,0,0,0.0,-1.0,Peyton Watson,0,1,0.0
2565,11/18/2022,20.186301369863013,L,0,4.366666666666666,0,2,0.0,0,1,0.0,0,0,,0,0,0,0,0,0,0,0,0,-1.4,1.0,Peyton Watson,0,1,0.0
2566,11/25/2022,20.205479452054796,W,0,2.0166666666666666,0,0,,0,0,,0,0,,0,0,0,0,0,0,0,0,0,0.0,-9.0,Peyton Watson,0,0,
2567,10/26/2022,25.224657534246575,W,0,2.7666666666666666,0,0,,0,0,,0,0,,0,0,0,0,1,0,0,0,0,1.0,-7.0,Jack White,0,0,
2568,10/28/2022,25.23013698630137,W,0,1.3333333333333333,0,0,,0,0,,0,0,,0,1,1,0,0,0,0,0,0,0.3,-2.0,Jack White,0,0,
2569,11/18/2022,25.28767123287671,L,0,3.8666666666666667,0,2,0.0,0,0,,0,0,,2,0,2,0,0,0,0,0,0,0.0,1.0,Jack White,0,2,0.0
2570,11/23/2022,25.301369863013697,W,0,9.783333333333333,0,0,,0,0,,0,0,,0,1,1,0,0,2,0,2,0,0.9,-5.0,Jack White,0,0,
2571,11/25/2022,25.306849315068494,W,0,2.0166666666666666,0,2,0.0,0,2,0.0,0,0,,0,0,0,0,0,0,0,1,0,-1.8,-9.0,Jack White,0,0,
2572,10/19/2022,27.621917808219177,W,1,38.3,8,11,0.727,0,0,,3,3,1.0,0,7,7,5,1,0,2,3,19,17.9,-1.0,Josh Hart,8,11,0.7272727272727273
2573,10/21/2022,27.627397260273973,W,1,40.983333333333334,3,9,0.333,1,2,0.5,3,4,0.75,3,4,7,3,2,0,1,3,10,9.7,-3.0,Josh Hart,2,7,0.2857142857142857
2574,10/23/2022,27.632876712328766,W,1,36.43333333333333,3,5,0.6,1,1,1.0,2,2,1.0,2,14,16,5,2,0,3,2,9,14.0,-4.0,Josh Hart,2,4,0.5
2575,10/24/2022,27.635616438356166,W,1,34.5,3,7,0.429,0,2,0.0,0,1,0.0,4,7,11,1,0,0,1,1,6,6.1,20.0,Josh Hart,3,5,0.6
2576,10/26/2022,27.64109589041096,L,1,31.483333333333334,3,4,0.75,1,1,1.0,3,3,1.0,2,4,6,6,3,1,2,2,10,16.1,-15.0,Josh Hart,2,3,0.6666666666666666
2577,10/28/2022,27.646575342465752,W,1,33.78333333333333,3,8,0.375,0,2,0.0,3,3,1.0,2,6,8,4,0,0,1,1,9,9.2,10.0,Josh Hart,3,6,0.5
2578,11/2/2022,27.660273972602738,L,1,39.61666666666667,1,4,0.25,0,1,0.0,3,5,0.6,2,4,6,4,1,1,3,4,5,4.3,-8.0,Josh Hart,1,3,0.3333333333333333
2579,11/4/2022,27.665753424657535,W,1,38.28333333333333,3,7,0.429,1,2,0.5,0,0,,1,8,9,6,0,0,3,3,7,6.4,0.0,Josh Hart,2,5,0.4
2580,11/5/2022,27.66849315068493,L,1,32.11666666666667,1,6,0.167,1,1,1.0,1,2,0.5,1,6,7,8,1,0,0,3,4,7.7,-18.0,Josh Hart,0,5,0.0
2581,11/7/2022,27.673972602739727,W,1,36.85,3,5,0.6,1,3,0.333,5,7,0.714,0,9,9,8,2,0,5,3,12,13.0,13.0,Josh Hart,2,2,1.0
2582,11/9/2022,27.67945205479452,W,1,35.25,2,9,0.222,0,3,0.0,1,3,0.333,0,11,11,2,1,0,0,3,5,3.2,3.0,Josh Hart,2,6,0.3333333333333333
2583,11/10/2022,27.682191780821917,W,1,38.21666666666667,7,13,0.538,1,3,0.333,2,2,1.0,1,6,7,2,1,0,1,1,17,14.2,10.0,Josh Hart,6,10,0.6
2584,11/12/2022,27.687671232876713,L,1,36.28333333333333,0,9,0.0,0,2,0.0,2,6,0.333,4,5,9,3,1,0,1,3,2,-0.7,0.0,Josh Hart,0,7,0.0
2585,11/15/2022,27.695890410958903,W,1,34.25,3,4,0.75,0,0,,0,0,,1,6,7,5,3,0,2,2,6,10.6,17.0,Josh Hart,3,4,0.75
2586,11/17/2022,27.7013698630137,L,1,30.1,3,6,0.5,1,2,0.5,0,0,,1,5,6,2,2,1,0,3,7,9.1,1.0,Josh Hart,2,4,0.5
2587,11/19/2022,27.706849315068492,L,1,30.083333333333332,6,10,0.6,1,3,0.333,6,6,1.0,3,5,8,2,2,0,0,5,19,19.4,-7.0,Josh Hart,5,7,0.7142857142857143
2588,11/21/2022,27.71232876712329,L,1,39.95,7,9,0.778,2,2,1.0,1,1,1.0,3,6,9,2,2,0,4,2,17,16.0,-12.0,Josh Hart,5,7,0.7142857142857143
2589,11/23/2022,27.71780821917808,L,1,32.56666666666667,3,5,0.6,0,1,0.0,2,2,1.0,0,3,3,9,1,0,3,5,8,8.9,6.0,Josh Hart,3,4,0.75
2590,11/25/2022,27.723287671232878,W,1,41.55,4,8,0.5,0,2,0.0,2,4,0.5,6,13,19,4,2,0,3,6,10,12.7,13.0,Josh Hart,4,6,0.6666666666666666
2591,11/27/2022,27.72876712328767,L,1,35.81666666666667,4,8,0.5,1,4,0.25,0,0,,1,3,4,3,1,0,0,3,9,8.5,-15.0,Josh Hart,3,4,0.75
2592,10/19/2022,22.684931506849313,W,0,10.4,0,2,0.0,0,2,0.0,0,2,0.0,0,2,2,1,1,0,0,0,0,0.1,5.0,Nassir Little,0,0,
2593,10/21/2022,22.69041095890411,W,0,12.8,4,5,0.8,1,1,1.0,0,0,,1,0,1,0,1,0,0,1,9,8.4,4.0,Nassir Little,3,4,0.75
2594,10/23/2022,22.695890410958903,W,0,14.016666666666667,3,6,0.5,1,3,0.333,0,0,,0,3,3,1,0,0,0,0,7,5.6,0.0,Nassir Little,2,3,0.6666666666666666
2595,10/24/2022,22.698630136986303,W,0,18.233333333333334,4,6,0.667,2,3,0.667,1,3,0.333,0,4,4,0,0,0,0,0,11,8.8,7.0,Nassir Little,2,3,0.6666666666666666
2596,10/26/2022,22.704109589041096,L,0,17.633333333333333,1,3,0.333,0,2,0.0,0,0,,1,0,1,0,1,0,1,1,2,0.6,-5.0,Nassir Little,1,1,1.0
2597,10/28/2022,22.70958904109589,W,0,15.15,1,3,0.333,1,2,0.5,0,0,,0,3,3,3,0,0,1,1,3,2.9,-1.0,Nassir Little,0,1,0.0
2598,11/2/2022,22.723287671232878,L,0,12.233333333333333,1,5,0.2,1,3,0.333,0,0,,0,1,1,1,0,0,1,0,3,-0.1,-9.0,Nassir Little,0,2,0.0
2599,11/4/2022,22.72876712328767,W,0,23.4,4,7,0.571,2,4,0.5,2,2,1.0,0,4,4,3,0,1,2,3,12,9.5,10.0,Nassir Little,2,3,0.6666666666666666
2600,11/5/2022,22.731506849315068,L,0,14.75,3,5,0.6,1,1,1.0,2,2,1.0,0,1,1,2,0,0,1,1,9,7.0,-21.0,Nassir Little,2,4,0.5
2601,11/7/2022,22.736986301369864,W,0,6.766666666666667,2,3,0.667,2,3,0.667,0,0,,0,1,1,0,0,0,0,1,6,4.6,-7.0,Nassir Little,0,0,
2602,11/9/2022,22.742465753424657,W,0,15.183333333333334,2,2,1.0,1,1,1.0,0,0,,1,5,6,1,0,1,0,0,5,8.0,3.0,Nassir Little,1,1,1.0
2603,11/10/2022,22.745205479452054,W,0,23.65,6,11,0.545,1,3,0.333,2,3,0.667,1,3,4,0,0,0,1,1,15,9.5,-1.0,Nassir Little,5,8,0.625
2604,11/12/2022,22.75068493150685,L,0,14.516666666666667,2,3,0.667,0,0,,0,0,,0,1,1,0,1,0,0,0,4,4.0,-5.0,Nassir Little,2,3,0.6666666666666666
2605,11/15/2022,22.75890410958904,W,0,13.75,0,2,0.0,0,2,0.0,2,2,1.0,0,3,3,0,1,0,3,1,2,-0.9,-10.0,Nassir Little,0,0,
2606,11/17/2022,22.764383561643836,L,0,12.75,1,6,0.167,0,2,0.0,2,2,1.0,0,3,3,1,0,1,0,1,4,2.1,7.0,Nassir Little,1,4,0.25
2607,11/19/2022,22.76986301369863,L,0,9.65,3,3,1.0,2,2,1.0,0,0,,1,2,3,1,1,0,0,0,8,10.1,-2.0,Nassir Little,1,1,1.0
2608,11/21/2022,22.775342465753425,L,0,20.933333333333334,3,8,0.375,0,3,0.0,0,0,,0,2,2,2,1,0,2,1,6,2.2,9.0,Nassir Little,3,5,0.6
2609,11/23/2022,22.78082191780822,L,0,22.433333333333334,2,7,0.286,1,4,0.25,0,0,,1,1,2,1,0,0,1,3,5,0.4,-11.0,Nassir Little,1,3,0.3333333333333333
2610,11/25/2022,22.786301369863015,W,0,18.316666666666666,0,2,0.0,0,1,0.0,0,0,,0,2,2,1,0,0,0,1,0,-0.5,-12.0,Nassir Little,0,1,0.0
2611,11/27/2022,22.791780821917808,L,0,9.766666666666667,1,2,0.5,0,1,0.0,2,3,0.667,1,1,2,0,1,0,0,1,4,4.2,8.0,Nassir Little,1,1,1.0
2612,10/19/2022,28.605479452054794,W,1,35.333333333333336,5,11,0.455,3,3,1.0,10,13,0.769,2,6,8,1,2,0,1,4,23,19.4,7.0,Jerami Grant,2,8,0.25
2613,10/21/2022,28.610958904109587,W,1,40.1,3,7,0.429,1,2,0.5,1,4,0.25,0,4,4,2,0,2,1,1,8,5.7,-4.0,Jerami Grant,2,5,0.4
2614,10/23/2022,28.616438356164384,W,1,34.7,5,11,0.455,2,3,0.667,4,4,1.0,0,2,2,1,0,0,1,3,16,9.4,0.0,Jerami Grant,3,8,0.375
2615,10/24/2022,28.61917808219178,W,1,35.5,7,13,0.538,1,6,0.167,6,7,0.857,0,2,2,1,0,1,1,1,21,14.9,19.0,Jerami Grant,6,7,0.8571428571428571
2616,10/26/2022,28.624657534246577,L,1,28.183333333333334,4,10,0.4,1,5,0.2,2,5,0.4,0,3,3,4,0,0,3,0,11,5.1,-11.0,Jerami Grant,3,5,0.6
2617,10/28/2022,28.63013698630137,W,1,35.0,5,11,0.455,2,6,0.333,3,4,0.75,1,4,5,4,2,1,3,2,15,12.5,22.0,Jerami Grant,3,5,0.6
2618,11/2/2022,28.643835616438356,L,1,38.28333333333333,7,18,0.389,3,9,0.333,6,7,0.857,0,5,5,3,0,1,4,1,23,12.7,8.0,Jerami Grant,4,9,0.4444444444444444
2619,11/4/2022,28.649315068493152,W,1,38.7,10,17,0.588,1,3,0.333,9,11,0.818,0,2,2,5,0,1,3,3,30,21.9,-2.0,Jerami Grant,9,14,0.6428571428571429
2620,11/5/2022,28.65205479452055,L,1,25.983333333333334,4,10,0.4,1,1,1.0,5,6,0.833,2,3,5,3,0,1,3,1,14,9.9,-19.0,Jerami Grant,3,9,0.3333333333333333
2621,11/7/2022,28.65753424657534,W,1,34.983333333333334,9,15,0.6,5,8,0.625,0,0,,1,5,6,2,0,1,3,3,23,16.2,3.0,Jerami Grant,4,7,0.5714285714285714
2622,11/10/2022,28.665753424657535,W,1,41.916666666666664,10,20,0.5,4,8,0.5,3,5,0.6,3,5,8,4,4,1,2,3,27,24.1,20.0,Jerami Grant,6,12,0.5
2623,11/12/2022,28.671232876712327,L,1,39.0,13,22,0.591,5,9,0.556,6,6,1.0,2,4,6,2,0,2,2,2,37,29.4,-4.0,Jerami Grant,8,13,0.6153846153846154
2624,11/15/2022,28.67945205479452,W,1,37.333333333333336,9,15,0.6,6,8,0.75,5,8,0.625,2,6,8,1,1,0,2,1,29,23.4,18.0,Jerami Grant,3,7,0.42857142857142855
2625,11/17/2022,28.684931506849313,L,1,37.25,2,13,0.154,1,5,0.2,0,0,,0,5,5,3,1,1,1,4,5,-0.6,-8.0,Jerami Grant,1,8,0.125
2626,11/19/2022,28.69041095890411,L,1,37.46666666666667,5,11,0.455,4,7,0.571,0,0,,0,2,2,1,2,2,0,2,14,12.2,-3.0,Jerami Grant,1,4,0.25
2627,11/21/2022,28.695890410958903,L,1,35.1,6,16,0.375,0,2,0.0,6,8,0.75,1,3,4,2,0,2,2,2,18,10.0,-20.0,Jerami Grant,6,14,0.42857142857142855
2628,11/23/2022,28.7013698630137,L,1,36.15,6,12,0.5,5,8,0.625,4,4,1.0,0,3,3,3,3,0,4,1,21,16.6,-19.0,Jerami Grant,1,4,0.25
2629,11/25/2022,28.706849315068492,W,1,40.3,10,20,0.5,3,7,0.429,21,28,0.75,0,1,1,2,0,1,2,4,44,30.0,-1.0,Jerami Grant,7,13,0.5384615384615384
2630,11/27/2022,28.71232876712329,L,1,40.233333333333334,11,24,0.458,5,10,0.5,2,2,1.0,1,3,4,5,0,0,1,2,29,19.9,-5.0,Jerami Grant,6,14,0.42857142857142855
2631,10/19/2022,19.389041095890413,W,0,16.3,4,6,0.667,3,3,1.0,1,2,0.5,0,2,2,1,0,0,0,2,12,9.5,8.0,Shaedon Sharpe,1,3,0.3333333333333333
2632,10/21/2022,19.394520547945206,W,0,11.95,0,2,0.0,0,1,0.0,0,0,,0,2,2,0,0,0,1,4,0,-3.4,7.0,Shaedon Sharpe,0,1,0.0
2633,10/23/2022,19.4,W,0,16.266666666666666,2,6,0.333,0,1,0.0,0,0,,3,1,4,1,1,1,1,2,4,3.6,8.0,Shaedon Sharpe,2,5,0.4
2634,10/24/2022,19.4027397260274,W,0,16.116666666666667,4,6,0.667,1,2,0.5,2,2,1.0,1,0,1,0,0,0,1,2,11,7.3,7.0,Shaedon Sharpe,3,4,0.75
2635,10/26/2022,19.40821917808219,L,0,21.4,5,12,0.417,2,5,0.4,3,5,0.6,3,5,8,0,1,0,2,2,15,9.6,-9.0,Shaedon Sharpe,3,7,0.42857142857142855
2636,10/28/2022,19.413698630136988,W,1,29.433333333333334,7,12,0.583,0,2,0.0,0,0,,1,0,1,2,0,0,0,4,14,8.9,-1.0,Shaedon Sharpe,7,10,0.7
2637,11/2/2022,19.427397260273974,L,1,24.133333333333333,1,6,0.167,0,1,0.0,0,0,,0,2,2,0,2,1,0,1,2,1.1,-6.0,Shaedon Sharpe,1,5,0.2
2638,11/4/2022,19.432876712328767,W,1,27.566666666666666,4,8,0.5,2,3,0.667,0,0,,0,1,1,1,0,0,0,3,10,5.8,-10.0,Shaedon Sharpe,2,5,0.4
2639,11/5/2022,19.435616438356163,L,1,26.916666666666668,6,12,0.5,1,2,0.5,0,0,,0,4,4,0,0,1,2,2,13,6.1,-4.0,Shaedon Sharpe,5,10,0.5
2640,11/7/2022,19.44109589041096,W,0,11.983333333333333,2,2,1.0,1,1,1.0,0,0,,1,0,1,0,0,0,1,0,5,4.1,-4.0,Shaedon Sharpe,1,1,1.0
2641,11/9/2022,19.446575342465753,W,0,28.55,7,10,0.7,1,4,0.25,2,2,1.0,1,3,4,0,0,0,0,1,17,14.0,30.0,Shaedon Sharpe,6,6,1.0
2642,11/12/2022,19.454794520547946,L,0,19.266666666666666,2,3,0.667,1,2,0.5,0,0,,0,1,1,0,0,0,1,2,5,2.2,-13.0,Shaedon Sharpe,1,1,1.0
2643,11/15/2022,19.463013698630135,W,0,22.683333333333334,5,7,0.714,2,3,0.667,1,2,0.5,0,2,2,0,0,1,0,2,13,10.2,0.0,Shaedon Sharpe,3,4,0.75
2644,11/17/2022,19.46849315068493,L,0,21.466666666666665,7,9,0.778,4,5,0.8,2,2,1.0,1,1,2,0,0,0,2,1,20,15.1,0.0,Shaedon Sharpe,3,4,0.75
2645,11/19/2022,19.473972602739725,L,0,21.533333333333335,2,8,0.25,0,3,0.0,0,0,,0,3,3,1,0,0,0,0,4,0.8,-3.0,Shaedon Sharpe,2,5,0.4
2646,11/21/2022,19.47945205479452,L,1,26.866666666666667,1,9,0.111,0,4,0.0,0,0,,1,3,4,2,0,0,3,1,2,-4.3,-6.0,Shaedon Sharpe,1,5,0.2
2647,11/23/2022,19.484931506849314,L,0,15.05,0,2,0.0,0,2,0.0,0,0,,0,0,0,0,0,0,0,1,0,-1.8,-15.0,Shaedon Sharpe,0,0,
2648,11/25/2022,19.49041095890411,W,0,12.65,2,3,0.667,1,2,0.5,0,2,0.0,0,1,1,0,0,0,0,1,5,2.8,-12.0,Shaedon Sharpe,1,1,1.0
2649,11/27/2022,19.495890410958904,L,0,14.916666666666666,0,3,0.0,0,2,0.0,0,0,,0,2,2,1,0,1,0,0,0,-0.1,-5.0,Shaedon Sharpe,0,1,0.0
2650,10/19/2022,25.71232876712329,W,0,15.566666666666666,0,0,,0,0,,0,0,,1,2,3,1,0,2,0,2,0,2.6,4.0,Drew Eubanks,0,0,
2651,10/21/2022,25.71780821917808,W,0,15.5,2,3,0.667,0,0,,1,1,1.0,1,4,5,0,1,0,2,0,5,4.6,5.0,Drew Eubanks,2,3,0.6666666666666666
2652,10/23/2022,25.723287671232878,W,0,13.483333333333333,0,1,0.0,0,0,,4,6,0.667,2,1,3,0,0,1,0,0,4,4.9,-3.0,Drew Eubanks,0,1,0.0
2653,10/24/2022,25.726027397260275,W,0,12.066666666666666,1,1,1.0,0,0,,2,2,1.0,1,1,2,0,1,1,0,3,4,5.2,-2.0,Drew Eubanks,1,1,1.0
2654,10/26/2022,25.731506849315068,L,0,10.783333333333333,1,3,0.333,0,0,,0,0,,0,0,0,1,0,0,0,1,2,0.6,-11.0,Drew Eubanks,1,3,0.3333333333333333
2655,10/28/2022,25.736986301369864,W,0,13.633333333333333,4,4,1.0,0,0,,2,2,1.0,1,0,1,1,0,0,0,4,10,8.6,4.0,Drew Eubanks,4,4,1.0
2656,11/2/2022,25.75068493150685,L,0,10.183333333333334,3,6,0.5,0,0,,1,2,0.5,3,0,3,0,0,0,3,2,7,1.9,-13.0,Drew Eubanks,3,6,0.5
2657,11/4/2022,25.756164383561643,W,0,23.216666666666665,5,5,1.0,0,0,,0,0,,1,3,4,1,0,1,1,2,10,9.7,3.0,Drew Eubanks,5,5,1.0
2658,11/5/2022,25.75890410958904,L,0,16.3,2,4,0.5,0,0,,1,2,0.5,1,2,3,2,0,0,1,2,5,3.5,-27.0,Drew Eubanks,2,4,0.5
2659,11/7/2022,25.764383561643836,W,0,13.1,1,2,0.5,0,0,,0,0,,0,1,1,0,1,1,0,1,2,2.6,1.0,Drew Eubanks,1,2,0.5
2660,11/9/2022,25.76986301369863,W,1,22.3,6,7,0.857,0,0,,2,4,0.5,3,5,8,2,0,3,3,2,14,14.0,-6.0,Drew Eubanks,6,7,0.8571428571428571
2661,11/10/2022,25.77260273972603,W,1,27.266666666666666,3,4,0.75,0,0,,0,0,,1,7,8,3,0,0,0,3,6,8.1,18.0,Drew Eubanks,3,4,0.75
2662,11/12/2022,25.778082191780822,L,1,33.483333333333334,1,2,0.5,0,0,,0,0,,2,6,8,0,2,0,0,5,2,4.2,10.0,Drew Eubanks,1,2,0.5
2663,11/15/2022,25.786301369863015,W,0,33.0,4,5,0.8,0,0,,1,1,1.0,3,4,7,1,1,1,1,3,9,10.6,28.0,Drew Eubanks,4,5,0.8
2664,11/17/2022,25.791780821917808,L,0,17.766666666666666,1,3,0.333,0,0,,1,2,0.5,2,5,7,0,1,1,1,1,3,4.1,-4.0,Drew Eubanks,1,3,0.3333333333333333
2665,11/19/2022,25.797260273972604,L,0,20.866666666666667,6,6,1.0,0,0,,1,1,1.0,3,2,5,1,1,4,3,1,13,15.0,2.0,Drew Eubanks,6,6,1.0
2666,11/21/2022,25.802739726027397,L,0,15.0,1,1,1.0,0,0,,3,4,0.75,1,2,3,0,0,1,0,2,5,5.5,-9.0,Drew Eubanks,1,1,1.0
2667,11/23/2022,25.80821917808219,L,0,17.05,5,5,1.0,0,0,,0,0,,3,3,6,1,0,3,0,2,10,13.5,-6.0,Drew Eubanks,5,5,1.0
2668,11/27/2022,25.81917808219178,L,0,14.25,1,1,1.0,0,0,,1,3,0.333,3,2,5,1,1,0,2,0,3,4.3,-8.0,Drew Eubanks,1,1,1.0
2669,10/19/2022,23.364383561643837,W,1,35.85,9,22,0.409,3,10,0.3,1,2,0.5,0,3,3,2,2,0,0,2,22,13.3,-1.0,Anfernee Simons,6,12,0.5
2670,10/21/2022,23.36986301369863,W,1,42.0,5,17,0.294,2,8,0.25,4,4,1.0,2,1,3,3,1,0,4,2,16,6.1,2.0,Anfernee Simons,3,9,0.3333333333333333
2671,10/23/2022,23.375342465753423,W,1,35.78333333333333,5,17,0.294,0,6,0.0,2,2,1.0,0,1,1,2,1,0,5,5,12,-2.2,2.0,Anfernee Simons,5,11,0.45454545454545453
2672,10/24/2022,23.378082191780823,W,1,35.583333333333336,11,17,0.647,7,12,0.583,0,0,,0,3,3,5,1,1,1,0,29,26.6,14.0,Anfernee Simons,4,5,0.8
2673,10/26/2022,23.383561643835616,L,1,29.65,5,12,0.417,3,8,0.375,1,1,1.0,0,2,2,0,0,0,3,4,14,3.6,-15.0,Anfernee Simons,2,4,0.5
2674,10/28/2022,23.389041095890413,W,1,37.85,10,20,0.5,7,15,0.467,3,3,1.0,1,4,5,7,1,1,3,3,30,24.3,18.0,Anfernee Simons,3,5,0.6
2675,11/2/2022,23.4027397260274,L,1,39.88333333333333,10,21,0.476,4,11,0.364,7,8,0.875,0,3,3,8,0,0,4,3,31,21.2,5.0,Anfernee Simons,6,10,0.6
2676,11/7/2022,23.416438356164385,W,1,31.566666666666666,9,20,0.45,4,12,0.333,3,3,1.0,0,0,0,4,1,0,3,1,25,15.0,-1.0,Anfernee Simons,5,8,0.625
2677,11/9/2022,23.421917808219177,W,1,33.15,7,18,0.389,2,9,0.222,3,6,0.5,0,3,3,6,2,0,0,1,19,14.7,-7.0,Anfernee Simons,5,9,0.5555555555555556
2678,11/10/2022,23.424657534246574,W,1,36.86666666666667,5,18,0.278,5,13,0.385,8,8,1.0,1,2,3,6,0,0,1,0,23,16.9,13.0,Anfernee Simons,0,5,0.0
2679,11/12/2022,23.43013698630137,L,1,39.36666666666667,9,20,0.45,5,11,0.455,1,2,0.5,0,7,7,2,0,0,2,3,24,13.5,5.0,Anfernee Simons,4,9,0.4444444444444444
2680,11/15/2022,23.438356164383563,W,1,33.8,7,16,0.438,5,10,0.5,4,4,1.0,1,2,3,2,0,0,1,2,23,15.5,-1.0,Anfernee Simons,2,6,0.3333333333333333
2681,11/17/2022,23.443835616438356,L,1,29.383333333333333,8,20,0.4,4,9,0.444,4,4,1.0,0,1,1,2,2,0,0,2,24,16.1,-19.0,Anfernee Simons,4,11,0.36363636363636365
2682,11/19/2022,23.44931506849315,L,1,35.833333333333336,7,19,0.368,4,13,0.308,5,6,0.833,1,7,8,7,4,1,3,3,23,20.3,7.0,Anfernee Simons,3,6,0.5
2683,11/21/2022,23.454794520547946,L,1,37.03333333333333,12,23,0.522,3,11,0.273,2,2,1.0,0,4,4,5,1,0,1,2,29,21.6,-10.0,Anfernee Simons,9,12,0.75
2684,11/23/2022,23.46027397260274,L,1,38.06666666666667,6,18,0.333,4,9,0.444,4,4,1.0,0,2,2,6,0,0,5,3,20,8.4,1.0,Anfernee Simons,2,9,0.2222222222222222
2685,11/25/2022,23.465753424657535,W,1,46.96666666666667,13,25,0.52,4,13,0.308,8,8,1.0,0,4,4,5,1,0,1,1,38,30.0,16.0,Anfernee Simons,9,12,0.75
2686,11/27/2022,23.471232876712328,L,1,39.56666666666667,4,14,0.286,4,10,0.4,3,4,0.75,0,1,1,6,1,0,2,1,15,9.5,-16.0,Anfernee Simons,0,4,0.0
2687,10/19/2022,28.156164383561645,W,1,25.183333333333334,3,9,0.333,0,0,,2,2,1.0,2,5,7,1,2,0,4,1,8,4.1,-7.0,Jusuf Nurkić,3,9,0.3333333333333333
2688,10/21/2022,28.161643835616438,W,1,35.15,6,10,0.6,0,1,0.0,8,9,0.889,4,13,17,2,1,1,3,4,20,20.2,0.0,Jusuf Nurkić,6,9,0.6666666666666666
2689,10/23/2022,28.167123287671235,W,1,30.0,2,5,0.4,0,0,,2,2,1.0,3,10,13,4,0,1,2,3,6,8.7,3.0,Jusuf Nurkić,2,5,0.4
2690,10/24/2022,28.16986301369863,W,1,35.45,4,12,0.333,0,1,0.0,5,7,0.714,2,10,12,6,0,1,0,5,13,12.7,26.0,Jusuf Nurkić,4,11,0.36363636363636365
2691,10/26/2022,28.175342465753424,L,1,25.75,2,7,0.286,0,1,0.0,3,4,0.75,4,5,9,1,1,1,1,2,7,7.4,-8.0,Jusuf Nurkić,2,6,0.3333333333333333
2692,10/28/2022,28.18082191780822,W,1,32.18333333333333,12,17,0.706,1,1,1.0,2,2,1.0,3,12,15,1,1,3,4,3,27,24.2,10.0,Jusuf Nurkić,11,16,0.6875
2693,11/2/2022,28.194520547945206,L,1,34.733333333333334,8,14,0.571,3,3,1.0,4,4,1.0,6,7,13,4,1,0,3,5,23,21.5,12.0,Jusuf Nurkić,5,11,0.45454545454545453
2694,11/4/2022,28.2,W,1,24.7,6,13,0.462,2,2,1.0,0,0,,5,3,8,3,1,0,2,1,14,12.4,-3.0,Jusuf Nurkić,4,11,0.36363636363636365
2695,11/5/2022,28.202739726027396,L,1,22.75,4,8,0.5,0,1,0.0,0,0,,1,6,7,0,0,1,4,4,8,1.6,-1.0,Jusuf Nurkić,4,7,0.5714285714285714
2696,11/7/2022,28.208219178082192,W,1,28.65,1,2,0.5,0,1,0.0,2,2,1.0,1,10,11,3,2,0,2,3,4,7.6,-11.0,Jusuf Nurkić,1,1,1.0
2697,11/15/2022,28.23013698630137,W,1,15.0,4,9,0.444,0,0,,1,2,0.5,2,3,5,1,0,0,1,2,9,5.1,-21.0,Jusuf Nurkić,4,9,0.4444444444444444
2698,11/17/2022,28.235616438356164,L,1,25.2,5,9,0.556,0,1,0.0,7,11,0.636,2,6,8,0,0,1,2,3,17,11.8,5.0,Jusuf Nurkić,5,8,0.625
2699,11/19/2022,28.24109589041096,L,1,27.133333333333333,8,10,0.8,1,1,1.0,1,3,0.333,2,5,7,2,1,0,5,4,18,12.1,-7.0,Jusuf Nurkić,7,9,0.7777777777777778
2700,11/21/2022,28.246575342465754,L,1,31.616666666666667,7,15,0.467,1,4,0.25,1,2,0.5,4,6,10,3,0,0,0,3,16,13.4,-5.0,Jusuf Nurkić,6,11,0.5454545454545454
2701,11/23/2022,28.252054794520546,L,1,28.25,9,14,0.643,2,3,0.667,2,2,1.0,3,3,6,1,3,0,3,5,22,17.5,-9.0,Jusuf Nurkić,7,11,0.6363636363636364
2702,11/25/2022,28.257534246575343,W,1,37.766666666666666,7,12,0.583,2,5,0.4,4,5,0.8,2,6,8,7,0,2,5,5,20,16.5,16.0,Jusuf Nurkić,5,7,0.7142857142857143
2703,11/27/2022,28.263013698630136,L,1,33.75,6,12,0.5,0,2,0.0,5,8,0.625,4,10,14,4,0,1,4,4,17,13.5,-6.0,Jusuf Nurkić,6,10,0.6
2704,10/19/2022,26.567123287671233,W,0,26.316666666666666,5,9,0.556,1,2,0.5,0,0,,3,5,8,0,1,0,0,3,11,10.1,21.0,Justise Winslow,4,7,0.5714285714285714
2705,10/21/2022,26.572602739726026,W,0,23.9,1,4,0.25,0,2,0.0,2,2,1.0,1,1,2,1,2,1,2,2,4,3.2,1.0,Justise Winslow,1,2,0.5
2706,10/23/2022,26.578082191780823,W,0,25.1,2,8,0.25,0,0,,3,4,0.75,2,3,5,3,2,1,1,2,7,7.1,2.0,Justise Winslow,2,8,0.25
2707,10/26/2022,26.586301369863016,L,0,24.75,4,9,0.444,1,3,0.333,0,0,,0,1,1,3,1,1,0,4,9,6.8,-19.0,Justise Winslow,3,6,0.5
2708,10/28/2022,26.59178082191781,W,0,24.166666666666668,2,6,0.333,1,2,0.5,2,4,0.5,2,4,6,7,3,1,3,0,7,11.0,13.0,Justise Winslow,1,4,0.25
2709,11/2/2022,26.605479452054794,L,0,23.366666666666667,1,6,0.167,0,0,,0,0,,4,4,8,4,1,0,1,0,2,5.0,-11.0,Justise Winslow,1,6,0.16666666666666666
2710,11/4/2022,26.610958904109587,W,1,31.616666666666667,6,12,0.5,0,1,0.0,0,0,,2,7,9,9,2,0,3,4,12,13.2,6.0,Justise Winslow,6,11,0.5454545454545454
2711,11/5/2022,26.613698630136987,L,1,21.016666666666666,2,9,0.222,1,3,0.333,0,0,,1,1,2,2,1,1,1,4,5,1.0,-15.0,Justise Winslow,1,6,0.16666666666666666
2712,11/7/2022,26.61917808219178,W,0,28.55,6,8,0.75,0,1,0.0,0,0,,0,2,2,2,1,0,0,2,12,11.0,15.0,Justise Winslow,6,7,0.8571428571428571
2713,11/9/2022,26.624657534246577,W,1,26.233333333333334,3,6,0.5,0,2,0.0,0,0,,1,1,2,2,0,0,3,3,6,1.2,-12.0,Justise Winslow,3,4,0.75
2714,11/10/2022,26.627397260273973,W,1,38.38333333333333,3,12,0.25,1,4,0.25,5,8,0.625,3,5,8,6,0,1,0,4,12,10.5,2.0,Justise Winslow,2,8,0.25
2715,11/17/2022,26.646575342465752,L,0,28.416666666666668,1,3,0.333,0,0,,0,0,,1,3,4,3,2,0,1,5,2,3.0,10.0,Justise Winslow,1,3,0.3333333333333333
2716,11/19/2022,26.65205479452055,L,0,26.283333333333335,0,2,0.0,0,1,0.0,1,2,0.5,0,5,5,5,0,1,4,5,1,-1.1,4.0,Justise Winslow,0,1,0.0
2717,11/21/2022,26.65753424657534,L,0,17.833333333333332,4,8,0.5,0,1,0.0,0,0,,0,0,0,1,0,0,2,3,8,1.5,-11.0,Justise Winslow,4,7,0.5714285714285714
2718,11/23/2022,26.663013698630138,L,1,28.033333333333335,2,10,0.2,1,3,0.333,0,0,,2,2,4,6,2,1,0,3,5,6.5,-21.0,Justise Winslow,1,7,0.14285714285714285
2719,11/25/2022,26.66849315068493,W,1,46.38333333333333,3,10,0.3,0,1,0.0,1,2,0.5,4,7,11,4,0,0,0,5,7,6.5,2.0,Justise Winslow,3,9,0.3333333333333333
2720,11/27/2022,26.673972602739727,L,1,37.18333333333333,5,10,0.5,2,4,0.5,2,2,1.0,1,6,7,6,0,0,3,4,14,11.1,-10.0,Justise Winslow,3,6,0.5
2721,10/19/2022,32.26301369863014,W,1,36.75,5,18,0.278,1,8,0.125,9,9,1.0,3,1,4,8,2,0,4,0,20,15.4,-1.0,Damian Lillard,4,10,0.4
2722,10/21/2022,32.26849315068493,W,1,42.61666666666667,12,25,0.48,5,12,0.417,12,12,1.0,1,6,7,3,0,1,4,2,41,28.8,-2.0,Damian Lillard,7,13,0.5384615384615384
2723,10/23/2022,32.273972602739725,W,1,34.18333333333333,15,25,0.6,6,13,0.462,5,7,0.714,1,4,5,2,0,1,6,3,41,25.5,2.0,Damian Lillard,9,12,0.75
2724,10/24/2022,32.276712328767125,W,1,34.68333333333333,10,16,0.625,4,7,0.571,7,8,0.875,1,5,6,8,1,0,1,2,31,30.4,24.0,Damian Lillard,6,9,0.6666666666666666
2725,10/26/2022,32.28219178082192,L,1,26.483333333333334,6,13,0.462,4,11,0.364,6,6,1.0,0,2,2,2,1,0,4,0,22,14.3,-10.0,Damian Lillard,2,2,1.0
2726,11/7/2022,32.31506849315068,W,1,34.53333333333333,4,12,0.333,3,8,0.375,8,9,0.889,0,3,3,6,0,0,4,2,19,12.1,6.0,Damian Lillard,1,4,0.25
2727,11/9/2022,32.320547945205476,W,1,36.06666666666667,8,16,0.5,6,12,0.5,4,8,0.5,1,5,6,7,0,0,6,2,26,16.7,1.0,Damian Lillard,2,4,0.5
2728,11/12/2022,32.32876712328767,L,1,37.68333333333333,6,16,0.375,2,7,0.286,15,17,0.882,2,5,7,12,1,0,5,1,29,26.3,-2.0,Damian Lillard,4,9,0.4444444444444444
2729,11/15/2022,32.33698630136986,W,1,39.516666666666666,8,20,0.4,2,9,0.222,4,5,0.8,0,2,2,11,0,1,4,2,22,15.0,15.0,Damian Lillard,6,11,0.5454545454545454
2730,11/17/2022,32.342465753424655,L,1,37.63333333333333,8,24,0.333,3,12,0.25,6,6,1.0,1,2,3,11,1,0,2,2,25,18.6,-2.0,Damian Lillard,5,12,0.4166666666666667
2731,11/19/2022,32.347945205479455,L,1,26.633333333333333,2,14,0.143,1,12,0.083,8,9,0.889,0,2,2,7,0,0,2,2,13,6.3,-17.0,Damian Lillard,1,2,0.5
2732,11/5/2022,21.98904109589041,L,0,15.533333333333333,2,7,0.286,0,2,0.0,5,6,0.833,1,3,4,1,0,0,0,2,9,6.0,7.0,Trendon Watford,2,5,0.4
2733,11/7/2022,21.994520547945207,W,0,13.0,1,3,0.333,0,0,,0,0,,1,2,3,2,0,0,0,0,2,3.0,0.0,Trendon Watford,1,3,0.3333333333333333
2734,11/9/2022,22.0,W,0,25.7,3,4,0.75,0,1,0.0,2,2,1.0,0,2,2,6,2,0,4,4,8,7.6,16.0,Trendon Watford,3,3,1.0
2735,11/10/2022,22.002739726027396,W,0,25.516666666666666,1,3,0.333,0,1,0.0,0,0,,1,5,6,4,3,0,2,2,2,5.5,-2.0,Trendon Watford,1,2,0.5
2736,11/12/2022,22.008219178082193,L,0,12.383333333333333,2,3,0.667,0,0,,0,0,,0,1,1,0,1,0,1,5,4,1.0,-14.0,Trendon Watford,2,3,0.6666666666666666
2737,11/15/2022,22.016438356164382,W,0,10.666666666666666,1,1,1.0,0,0,,2,2,1.0,0,2,2,1,0,0,1,2,4,3.2,-11.0,Trendon Watford,1,1,1.0
2738,11/19/2022,22.027397260273972,L,0,4.516666666666667,0,0,,0,0,,0,0,,0,0,0,0,0,0,0,0,0,0.0,1.0,Trendon Watford,0,0,
2739,11/21/2022,22.03287671232877,L,0,12.9,3,4,0.75,2,2,1.0,2,2,1.0,2,2,4,1,1,0,1,1,10,10.7,12.0,Trendon Watford,1,2,0.5
2740,11/23/2022,22.03835616438356,L,0,17.0,2,3,0.667,0,0,,1,1,1.0,1,4,5,0,0,0,0,1,5,5.2,-10.0,Trendon Watford,2,3,0.6666666666666666
2741,11/25/2022,22.043835616438358,W,0,21.066666666666666,3,5,0.6,0,1,0.0,2,2,1.0,0,1,1,1,0,0,1,1,8,5.3,-7.0,Trendon Watford,3,4,0.75
2742,11/27/2022,22.04931506849315,L,0,14.516666666666667,3,5,0.6,0,0,,0,0,,0,3,3,1,0,0,1,1,6,3.9,-13.0,Trendon Watford,3,5,0.6
2743,10/24/2022,20.235616438356164,W,0,4.116666666666666,1,1,1.0,0,0,,0,0,,0,2,2,1,0,0,0,0,2,3.0,3.0,Jabari Walker,1,1,1.0
2744,10/26/2022,20.24109589041096,L,0,7.8,1,1,1.0,0,0,,0,0,,1,2,3,2,0,0,0,0,2,4.4,0.0,Jabari Walker,1,1,1.0
2745,10/28/2022,20.246575342465754,W,0,0.9666666666666667,0,1,0.0,0,1,0.0,0,0,,0,0,0,0,0,0,0,0,0,-0.7,0.0,Jabari Walker,0,0,
2746,11/4/2022,20.265753424657536,W,0,9.3,1,3,0.333,0,0,,0,0,,1,2,3,1,1,0,0,1,2,2.9,4.0,Jabari Walker,1,3,0.3333333333333333
2747,11/5/2022,20.268493150684932,L,0,15.883333333333333,1,2,0.5,0,0,,1,2,0.5,0,3,3,1,0,1,0,2,3,3.1,-2.0,Jabari Walker,1,2,0.5
2748,11/9/2022,20.279452054794522,W,0,17.566666666666666,2,3,0.667,1,2,0.5,0,0,,1,2,3,2,0,0,1,3,5,4.2,22.0,Jabari Walker,1,1,1.0
2749,11/10/2022,20.28219178082192,W,0,8.183333333333334,2,4,0.5,0,2,0.0,0,0,,0,2,2,0,0,0,1,0,4,1.6,-5.0,Jabari Walker,2,2,1.0
2750,11/12/2022,20.28767123287671,L,0,8.016666666666667,1,2,0.5,0,0,,3,4,0.75,2,2,4,1,0,0,0,0,5,6.3,-2.0,Jabari Walker,1,2,0.5
2751,11/21/2022,20.312328767123287,L,0,1.3833333333333333,0,0,,0,0,,0,0,,0,0,0,1,0,0,0,0,0,0.7,6.0,Jabari Walker,0,0,
2752,11/23/2022,20.317808219178083,L,0,2.7,0,1,0.0,0,0,,0,0,,0,0,0,0,0,0,0,0,0,-0.7,-3.0,Jabari Walker,0,1,0.0
2753,10/24/2022,20.624657534246577,W,0,9.633333333333333,1,2,0.5,1,2,0.5,0,0,,0,2,2,1,0,2,3,1,3,1.3,4.0,Keon Johnson,0,0,
2754,10/26/2022,20.63013698630137,L,0,8.283333333333333,1,2,0.5,0,1,0.0,0,0,,0,3,3,1,0,0,2,1,2,0.2,-2.0,Keon Johnson,1,1,1.0
2755,10/28/2022,20.635616438356166,W,0,16.8,3,7,0.429,1,4,0.25,1,2,0.5,0,1,1,1,2,0,0,1,8,6.5,-5.0,Keon Johnson,2,3,0.6666666666666666
2756,11/2/2022,20.649315068493152,L,0,17.566666666666666,4,9,0.444,2,5,0.4,0,0,,1,4,5,3,0,0,1,1,10,7.9,-3.0,Keon Johnson,2,4,0.5
2757,11/4/2022,20.654794520547945,W,0,23.216666666666665,4,13,0.308,2,8,0.25,1,2,0.5,1,1,2,1,2,0,3,4,11,2.2,2.0,Keon Johnson,2,5,0.4
2758,11/5/2022,20.65753424657534,L,0,30.85,3,12,0.25,2,3,0.667,0,2,0.0,1,1,2,3,1,0,4,2,8,-0.7,-16.0,Keon Johnson,1,9,0.1111111111111111
2759,10/24/2022,21.145205479452056,W,0,4.116666666666666,2,2,1.0,0,0,,0,1,0.0,0,0,0,0,0,0,0,0,4,3.0,3.0,Greg Brown III,2,2,1.0
2760,10/26/2022,21.15068493150685,L,0,7.8,1,2,0.5,0,0,,0,2,0.0,0,0,0,0,1,1,1,0,2,0.9,0.0,Greg Brown III,1,2,0.5
2761,10/28/2022,21.156164383561645,W,0,0.9666666666666667,1,1,1.0,0,0,,0,0,,0,0,0,0,0,0,0,0,2,1.7,0.0,Greg Brown III,1,1,1.0
2762,11/5/2022,21.17808219178082,L,0,8.95,1,2,0.5,0,0,,0,2,0.0,0,1,1,0,2,1,1,3,2,1.0,8.0,Greg Brown III,1,2,0.5
2763,11/5/2022,19.92054794520548,L,0,8.95,1,2,0.5,0,1,0.0,0,0,,0,1,1,0,0,1,0,0,2,2.0,8.0,John Butler,1,1,1.0
2764,11/21/2022,19.964383561643835,L,0,1.3833333333333333,0,0,,0,0,,0,0,,0,0,0,0,0,0,0,0,0,0.0,6.0,John Butler,0,0,
2765,11/23/2022,19.96986301369863,L,0,2.7,0,1,0.0,0,1,0.0,0,0,,1,0,1,1,0,0,0,0,0,0.7,-3.0,John Butler,0,0,
2766,10/19/2022,21.205479452054796,W,1,31.75,4,17,0.235,1,7,0.143,2,4,0.5,1,7,8,7,0,0,2,5,11,3.6,8.0,Anthony Edwards,3,10,0.3
2767,10/21/2022,21.21095890410959,L,1,41.266666666666666,12,23,0.522,3,9,0.333,3,5,0.6,1,4,5,2,0,1,5,0,30,16.9,-6.0,Anthony Edwards,9,14,0.6428571428571429
2768,10/23/2022,21.216438356164385,W,1,33.53333333333333,13,19,0.684,3,7,0.429,1,3,0.333,2,9,11,3,1,0,4,4,30,22.7,22.0,Anthony Edwards,10,12,0.8333333333333334
2769,10/24/2022,21.21917808219178,L,1,35.36666666666667,3,15,0.2,1,8,0.125,2,3,0.667,0,10,10,2,0,0,3,1,9,0.3,-14.0,Anthony Edwards,2,7,0.2857142857142857
2770,10/26/2022,21.224657534246575,W,1,38.43333333333333,12,21,0.571,7,12,0.583,3,4,0.75,0,3,3,9,2,0,5,3,34,26.7,16.0,Anthony Edwards,5,9,0.5555555555555556
2771,10/28/2022,21.23013698630137,W,1,38.18333333333333,11,22,0.5,3,8,0.375,4,6,0.667,0,4,4,2,1,0,2,4,29,17.2,4.0,Anthony Edwards,8,14,0.5714285714285714
2772,10/30/2022,21.235616438356164,L,1,36.3,7,18,0.389,1,4,0.25,3,3,1.0,0,2,2,6,2,1,1,4,18,13.1,-3.0,Anthony Edwards,6,14,0.42857142857142855
2773,11/1/2022,21.24109589041096,L,1,39.9,8,21,0.381,5,10,0.5,3,5,0.6,0,6,6,1,3,1,3,5,24,12.9,-12.0,Anthony Edwards,3,11,0.2727272727272727
2774,11/4/2022,21.24931506849315,L,1,37.0,10,19,0.526,3,9,0.333,1,2,0.5,1,2,3,3,1,0,3,4,24,14.1,-16.0,Anthony Edwards,7,10,0.7
2775,11/5/2022,21.252054794520546,W,1,32.733333333333334,7,13,0.538,2,5,0.4,3,3,1.0,0,2,2,3,2,0,4,2,19,12.6,20.0,Anthony Edwards,5,8,0.625
2776,11/7/2022,21.257534246575343,L,1,36.56666666666667,5,14,0.357,1,7,0.143,5,6,0.833,1,8,9,1,1,0,3,1,16,9.2,-6.0,Anthony Edwards,4,7,0.5714285714285714
2777,11/9/2022,21.263013698630136,L,1,34.916666666666664,4,12,0.333,0,4,0.0,3,6,0.5,0,3,3,6,2,0,3,5,11,5.1,-2.0,Anthony Edwards,4,8,0.5
2778,11/11/2022,21.268493150684932,L,1,37.7,10,16,0.625,3,4,0.75,5,7,0.714,1,5,6,6,0,0,1,1,28,25.0,2.0,Anthony Edwards,7,12,0.5833333333333334
2779,11/13/2022,21.273972602739725,W,1,31.116666666666667,5,13,0.385,0,3,0.0,0,0,,0,7,7,1,0,0,4,5,10,-0.3,-11.0,Anthony Edwards,5,10,0.5
2780,11/16/2022,21.28219178082192,W,1,38.71666666666667,12,20,0.6,7,13,0.538,4,7,0.571,0,8,8,6,2,1,1,1,35,32.5,29.0,Anthony Edwards,5,7,0.7142857142857143
2781,11/19/2022,21.29041095890411,W,1,35.7,7,21,0.333,2,10,0.2,9,9,1.0,0,5,5,5,1,1,5,2,25,14.0,2.0,Anthony Edwards,5,11,0.45454545454545453
2782,11/21/2022,21.295890410958904,W,1,38.5,9,21,0.429,4,12,0.333,0,1,0.0,1,6,7,4,4,1,4,3,22,15.3,0.0,Anthony Edwards,5,9,0.5555555555555556
2783,11/23/2022,21.301369863013697,W,1,35.78333333333333,7,14,0.5,3,5,0.6,2,2,1.0,0,7,7,2,1,0,4,2,19,11.7,10.0,Anthony Edwards,4,9,0.4444444444444444
2784,11/25/2022,21.306849315068494,L,1,36.68333333333333,10,21,0.476,3,10,0.3,2,2,1.0,1,4,5,4,1,0,2,3,25,16.8,7.0,Anthony Edwards,7,11,0.6363636363636364
2785,11/27/2022,21.312328767123287,L,1,35.6,7,17,0.412,2,6,0.333,10,11,0.909,1,3,4,4,1,0,1,1,26,20.5,-29.0,Anthony Edwards,5,11,0.45454545454545453
2786,10/19/2022,26.926027397260274,W,1,35.516666666666666,2,10,0.2,2,7,0.286,6,6,1.0,0,6,6,7,0,0,3,4,12,7.9,-4.0,Karl-Anthony Towns,0,3,0.0
2787,10/21/2022,26.931506849315067,L,1,33.333333333333336,9,25,0.36,2,6,0.333,7,8,0.875,4,4,8,2,0,0,5,5,27,11.1,-3.0,Karl-Anthony Towns,7,19,0.3684210526315789
2788,10/23/2022,26.936986301369863,W,1,30.333333333333332,5,9,0.556,1,3,0.333,4,4,1.0,1,7,8,5,1,0,3,2,15,14.2,14.0,Karl-Anthony Towns,4,6,0.6666666666666666
2789,10/24/2022,26.93972602739726,L,1,39.31666666666667,9,17,0.529,2,6,0.333,7,7,1.0,1,10,11,5,0,0,4,5,27,19.9,-4.0,Karl-Anthony Towns,7,11,0.6363636363636364
2790,10/26/2022,26.945205479452056,W,1,37.71666666666667,9,14,0.643,3,5,0.6,0,0,,0,4,4,7,2,1,3,3,21,19.4,5.0,Karl-Anthony Towns,6,9,0.6666666666666666
2791,10/28/2022,26.95068493150685,W,1,36.9,8,17,0.471,3,7,0.429,2,2,1.0,2,6,8,7,1,0,2,1,21,19.0,11.0,Karl-Anthony Towns,5,10,0.5
2792,10/30/2022,26.956164383561642,L,1,34.3,10,19,0.526,1,7,0.143,5,8,0.625,3,8,11,4,1,2,3,3,26,21.0,-22.0,Karl-Anthony Towns,9,12,0.75
2793,11/1/2022,26.96164383561644,L,1,36.88333333333333,9,18,0.5,3,7,0.429,3,3,1.0,5,5,10,7,0,1,4,4,24,20.0,-12.0,Karl-Anthony Towns,6,11,0.5454545454545454
2794,11/4/2022,26.96986301369863,L,1,37.1,9,19,0.474,3,9,0.333,1,1,1.0,2,9,11,5,0,0,2,6,22,15.5,-17.0,Karl-Anthony Towns,6,10,0.6
2795,11/5/2022,26.972602739726028,W,1,30.25,9,14,0.643,3,6,0.5,4,5,0.8,3,6,9,6,1,2,3,5,25,23.9,-1.0,Karl-Anthony Towns,6,8,0.75
2796,11/7/2022,26.97808219178082,L,1,38.1,9,12,0.75,1,3,0.333,6,6,1.0,0,13,13,7,2,1,3,1,25,28.3,-9.0,Karl-Anthony Towns,8,9,0.8888888888888888
2797,11/9/2022,26.983561643835618,L,1,27.666666666666668,3,7,0.429,1,3,0.333,4,4,1.0,0,8,8,4,0,1,3,4,11,8.6,4.0,Karl-Anthony Towns,2,4,0.5
2798,11/11/2022,26.98904109589041,L,1,26.183333333333334,4,9,0.444,1,4,0.25,4,4,1.0,4,6,10,4,0,0,1,6,13,12.3,-5.0,Karl-Anthony Towns,3,5,0.6
2799,11/13/2022,26.994520547945207,W,1,36.6,11,16,0.688,3,6,0.5,4,6,0.667,2,11,13,3,1,1,2,5,29,25.9,15.0,Karl-Anthony Towns,8,10,0.8
2800,11/16/2022,27.002739726027396,W,1,36.233333333333334,10,15,0.667,2,5,0.4,8,8,1.0,1,4,5,5,1,0,2,3,30,26.7,12.0,Karl-Anthony Towns,8,10,0.8
2801,11/19/2022,27.01095890410959,W,1,31.65,5,14,0.357,2,7,0.286,0,0,,0,8,8,3,1,0,3,4,12,5.1,2.0,Karl-Anthony Towns,3,7,0.42857142857142855
2802,11/21/2022,27.016438356164382,W,1,34.43333333333333,8,15,0.533,2,8,0.25,7,8,0.875,1,7,8,9,1,1,3,6,25,22.7,14.0,Karl-Anthony Towns,6,7,0.8571428571428571
2803,11/23/2022,27.02191780821918,W,1,36.81666666666667,8,11,0.727,1,1,1.0,6,7,0.857,3,8,11,8,2,2,5,3,23,25.4,19.0,Karl-Anthony Towns,7,10,0.7
2804,11/25/2022,27.027397260273972,L,1,36.93333333333333,6,22,0.273,1,11,0.091,6,7,0.857,2,2,4,5,0,2,2,5,19,8.5,-4.0,Karl-Anthony Towns,5,11,0.45454545454545453
2805,11/27/2022,27.03287671232877,L,1,30.85,8,14,0.571,1,5,0.2,4,4,1.0,0,4,4,4,2,0,6,4,21,12.8,-26.0,Karl-Anthony Towns,7,9,0.7777777777777778
2806,10/19/2022,26.65205479452055,W,1,34.583333333333336,7,16,0.438,2,6,0.333,4,5,0.8,0,5,5,2,1,1,4,5,20,9.8,-8.0,D'Angelo Russell,5,10,0.5
2807,10/21/2022,26.65753424657534,L,1,39.43333333333333,8,17,0.471,3,8,0.375,4,4,1.0,1,4,5,7,2,1,3,0,23,20.8,-7.0,D'Angelo Russell,5,9,0.5555555555555556
2808,10/23/2022,26.663013698630138,W,1,25.8,2,5,0.4,0,2,0.0,2,2,1.0,1,2,3,6,1,0,3,0,6,6.8,0.0,D'Angelo Russell,2,3,0.6666666666666666
2809,10/24/2022,26.665753424657535,L,1,31.383333333333333,8,16,0.5,3,6,0.5,6,6,1.0,2,3,5,7,2,1,3,2,25,23.1,-12.0,D'Angelo Russell,5,10,0.5
2810,10/26/2022,26.671232876712327,W,1,28.983333333333334,5,10,0.5,1,4,0.25,1,4,0.25,0,2,2,9,0,1,4,1,12,9.0,0.0,D'Angelo Russell,4,6,0.6666666666666666
2811,10/28/2022,26.676712328767124,W,1,30.8,4,15,0.267,2,7,0.286,1,2,0.5,0,4,4,7,7,1,2,1,11,13.1,12.0,D'Angelo Russell,2,8,0.25
2812,10/30/2022,26.682191780821917,L,1,27.833333333333332,5,17,0.294,0,7,0.0,0,0,,2,3,5,4,0,1,2,4,10,2.3,0.0,D'Angelo Russell,5,10,0.5
2813,11/1/2022,26.687671232876713,L,1,22.633333333333333,2,8,0.25,1,3,0.333,0,0,,0,4,4,4,0,0,4,3,5,-1.0,-20.0,D'Angelo Russell,1,5,0.2
2814,11/4/2022,26.695890410958903,L,1,27.166666666666668,3,15,0.2,2,8,0.25,1,2,0.5,1,2,3,4,0,0,3,0,9,0.4,-18.0,D'Angelo Russell,1,7,0.14285714285714285
2815,11/5/2022,26.698630136986303,W,1,26.633333333333333,5,9,0.556,1,3,0.333,2,3,0.667,3,3,6,4,2,0,3,4,13,11.5,2.0,D'Angelo Russell,4,6,0.6666666666666666
2816,11/7/2022,26.704109589041096,L,1,30.816666666666666,4,12,0.333,4,10,0.4,2,4,0.5,0,2,2,8,1,2,3,1,14,11.6,1.0,D'Angelo Russell,0,2,0.0
2817,11/9/2022,26.70958904109589,L,1,33.3,6,14,0.429,4,9,0.444,4,4,1.0,1,1,2,6,0,0,3,2,20,14.0,-5.0,D'Angelo Russell,2,5,0.4
2818,11/11/2022,26.715068493150685,L,1,26.55,2,8,0.25,0,4,0.0,0,0,,0,0,0,8,1,0,3,3,4,1.6,-8.0,D'Angelo Russell,2,4,0.5
2819,11/13/2022,26.720547945205478,W,1,35.15,11,13,0.846,4,5,0.8,4,6,0.667,0,2,2,11,1,0,2,2,30,31.0,19.0,D'Angelo Russell,7,8,0.875
2820,11/16/2022,26.72876712328767,W,1,32.28333333333333,5,12,0.417,1,6,0.167,0,0,,0,3,3,6,1,1,1,0,11,10.4,15.0,D'Angelo Russell,4,6,0.6666666666666666
2821,11/19/2022,26.736986301369864,W,1,33.55,7,13,0.538,3,6,0.5,2,2,1.0,0,2,2,7,1,0,3,1,19,15.8,-5.0,D'Angelo Russell,4,7,0.5714285714285714
2822,11/21/2022,26.742465753424657,W,1,27.983333333333334,1,5,0.2,0,4,0.0,1,1,1.0,0,3,3,5,1,1,0,2,3,5.2,-2.0,D'Angelo Russell,1,1,1.0
2823,11/23/2022,26.747945205479454,W,1,35.75,7,10,0.7,1,4,0.25,0,0,,0,3,3,12,3,1,5,2,15,18.0,21.0,D'Angelo Russell,6,6,1.0
2824,11/25/2022,26.753424657534246,L,1,35.75,8,15,0.533,4,10,0.4,0,0,,2,2,4,10,1,0,3,3,20,18.5,-1.0,D'Angelo Russell,4,5,0.8
2825,11/27/2022,26.75890410958904,L,1,31.416666666666668,5,14,0.357,3,6,0.5,2,2,1.0,1,1,2,6,1,1,0,2,15,13.3,-32.0,D'Angelo Russell,2,8,0.25
2826,10/19/2022,23.279452054794522,W,0,18.25,5,11,0.455,2,5,0.4,1,1,1.0,0,3,3,2,0,0,0,1,13,9.2,-1.0,Jaylen Nowell,3,6,0.5
2827,10/21/2022,23.284931506849315,L,0,19.633333333333333,8,14,0.571,2,5,0.4,0,1,0.0,1,1,2,3,1,0,0,4,18,13.5,7.0,Jaylen Nowell,6,9,0.6666666666666666
2828,10/23/2022,23.29041095890411,W,0,23.766666666666666,5,16,0.313,1,6,0.167,3,4,0.75,1,5,6,1,2,0,1,0,14,8.3,4.0,Jaylen Nowell,4,10,0.4
2829,10/24/2022,23.293150684931508,L,0,25.766666666666666,6,16,0.375,1,7,0.143,0,0,,3,6,9,2,1,0,0,2,13,9.7,8.0,Jaylen Nowell,5,9,0.5555555555555556
2830,10/26/2022,23.2986301369863,W,0,21.8,9,13,0.692,3,5,0.6,2,2,1.0,0,4,4,2,0,0,0,0,23,20.1,12.0,Jaylen Nowell,6,8,0.75
2831,10/28/2022,23.304109589041097,W,0,19.9,3,12,0.25,0,3,0.0,0,0,,3,2,5,5,1,1,0,2,6,5.9,-3.0,Jaylen Nowell,3,9,0.3333333333333333
2832,10/30/2022,23.30958904109589,L,0,10.316666666666666,1,8,0.125,0,3,0.0,0,0,,0,0,0,0,0,0,0,1,2,-3.6,-8.0,Jaylen Nowell,1,5,0.2
2833,11/1/2022,23.315068493150687,L,0,22.45,4,13,0.308,0,1,0.0,2,3,0.667,0,2,2,4,0,0,1,1,10,4.1,14.0,Jaylen Nowell,4,12,0.3333333333333333
2834,11/4/2022,23.323287671232876,L,0,17.166666666666668,4,10,0.4,2,5,0.4,3,4,0.75,0,3,3,3,0,0,1,3,13,8.0,13.0,Jaylen Nowell,2,5,0.4
2835,11/5/2022,23.326027397260273,W,0,15.783333333333333,3,5,0.6,1,2,0.5,0,0,,0,0,0,3,1,0,2,0,7,5.8,-8.0,Jaylen Nowell,2,3,0.6666666666666666
2836,11/7/2022,23.33150684931507,L,0,10.566666666666666,3,5,0.6,2,3,0.667,0,0,,0,2,2,1,0,1,0,1,8,7.3,-19.0,Jaylen Nowell,1,2,0.5
2837,11/9/2022,23.336986301369862,L,0,22.666666666666668,5,8,0.625,2,4,0.5,2,2,1.0,0,2,2,3,0,0,7,3,14,4.9,-11.0,Jaylen Nowell,3,4,0.75
2838,11/11/2022,23.34246575342466,L,0,11.3,1,7,0.143,0,3,0.0,0,0,,0,0,0,1,1,0,1,0,2,-1.8,-16.0,Jaylen Nowell,1,4,0.25
2839,11/13/2022,23.34794520547945,W,0,14.666666666666666,3,6,0.5,1,3,0.333,2,2,1.0,0,1,1,2,0,0,0,3,9,6.5,-3.0,Jaylen Nowell,2,3,0.6666666666666666
2840,11/16/2022,23.356164383561644,W,0,7.116666666666666,0,5,0.0,0,3,0.0,0,0,,0,1,1,0,1,0,0,0,0,-2.2,-10.0,Jaylen Nowell,0,2,0.0
2841,11/19/2022,23.364383561643837,W,0,14.0,5,7,0.714,2,4,0.5,1,2,0.5,1,1,2,2,0,0,1,3,13,9.9,1.0,Jaylen Nowell,3,3,1.0
2842,11/21/2022,23.36986301369863,W,0,9.166666666666666,2,7,0.286,0,4,0.0,1,1,1.0,0,1,1,2,0,0,2,0,5,0.6,4.0,Jaylen Nowell,2,3,0.6666666666666666
2843,11/23/2022,23.375342465753423,W,0,11.45,1,6,0.167,0,3,0.0,0,0,,0,2,2,1,1,0,1,2,2,-1.3,-5.0,Jaylen Nowell,1,3,0.3333333333333333
2844,11/25/2022,23.38082191780822,L,0,17.85,4,9,0.444,0,3,0.0,0,0,,0,3,3,0,1,0,2,1,8,2.8,-4.0,Jaylen Nowell,4,6,0.6666666666666666
2845,11/27/2022,23.386301369863013,L,0,24.2,5,11,0.455,4,7,0.571,2,3,0.667,0,3,3,3,1,0,0,2,16,13.1,6.0,Jaylen Nowell,1,4,0.25
2846,10/19/2022,22.054794520547944,W,1,35.583333333333336,5,10,0.5,0,3,0.0,9,10,0.9,4,2,6,3,3,2,1,1,19,22.1,14.0,Jaden McDaniels,5,7,0.7142857142857143
2847,10/21/2022,22.06027397260274,L,1,38.75,4,7,0.571,0,1,0.0,2,2,1.0,1,3,4,0,0,1,0,3,10,7.8,-19.0,Jaden McDaniels,4,6,0.6666666666666666
2848,10/23/2022,22.065753424657533,W,1,27.3,5,9,0.556,0,2,0.0,1,2,0.5,1,0,1,0,4,1,1,3,11,9.5,5.0,Jaden McDaniels,5,7,0.7142857142857143
2849,10/24/2022,22.068493150684933,L,1,23.983333333333334,1,4,0.25,0,1,0.0,2,2,1.0,2,1,3,1,0,0,1,3,4,1.8,-9.0,Jaden McDaniels,1,3,0.3333333333333333
2850,10/26/2022,22.073972602739726,W,1,34.81666666666667,8,9,0.889,4,5,0.8,0,0,,0,3,3,1,2,3,1,3,20,20.4,-2.0,Jaden McDaniels,4,4,1.0
2851,10/28/2022,22.07945205479452,W,1,29.083333333333332,2,7,0.286,2,6,0.333,0,0,,0,1,1,2,0,4,2,6,6,2.0,17.0,Jaden McDaniels,0,1,0.0
2852,10/30/2022,22.084931506849315,L,1,35.4,3,7,0.429,0,2,0.0,1,2,0.5,1,2,3,1,3,1,2,3,7,5.4,-8.0,Jaden McDaniels,3,5,0.6
2853,11/1/2022,22.09041095890411,L,1,17.033333333333335,2,5,0.4,0,1,0.0,0,0,,1,2,3,0,1,0,3,5,4,-1.4,-18.0,Jaden McDaniels,2,4,0.5
2854,11/4/2022,22.0986301369863,L,1,18.466666666666665,4,5,0.8,1,1,1.0,0,0,,1,1,2,1,0,1,4,2,9,4.7,-18.0,Jaden McDaniels,3,4,0.75
2855,11/5/2022,22.101369863013698,W,1,34.53333333333333,6,9,0.667,1,2,0.5,0,0,,1,4,5,3,0,1,2,4,13,10.2,9.0,Jaden McDaniels,5,7,0.7142857142857143
2856,11/7/2022,22.106849315068494,L,1,16.55,3,6,0.5,0,2,0.0,0,0,,1,1,2,1,0,0,2,6,6,0.3,-1.0,Jaden McDaniels,3,4,0.75
2857,11/9/2022,22.112328767123287,L,1,38.06666666666667,10,14,0.714,2,4,0.5,2,3,0.667,4,4,8,3,0,1,2,2,24,21.8,8.0,Jaden McDaniels,8,10,0.8
2858,11/11/2022,22.117808219178084,L,1,33.5,4,8,0.5,2,4,0.5,5,6,0.833,1,3,4,0,3,2,0,6,15,14.2,-1.0,Jaden McDaniels,2,4,0.5
2859,11/13/2022,22.123287671232877,W,1,30.933333333333334,4,9,0.444,1,2,0.5,0,2,0.0,2,0,2,0,1,1,0,6,9,4.2,-11.0,Jaden McDaniels,3,7,0.42857142857142855
2860,11/16/2022,22.13150684931507,W,1,35.03333333333333,4,12,0.333,1,5,0.2,1,2,0.5,4,4,8,2,1,1,1,4,10,7.3,19.0,Jaden McDaniels,3,7,0.42857142857142855
2861,11/19/2022,22.13972602739726,W,1,31.55,4,6,0.667,1,2,0.5,2,2,1.0,0,1,1,1,3,1,2,3,11,9.9,-4.0,Jaden McDaniels,3,4,0.75
2862,11/21/2022,22.145205479452056,W,1,32.11666666666667,7,14,0.5,3,6,0.5,1,1,1.0,2,2,4,3,0,0,2,2,18,12.3,18.0,Jaden McDaniels,4,8,0.5
2863,11/23/2022,22.15068493150685,W,1,30.716666666666665,8,11,0.727,2,4,0.5,0,0,,0,3,3,3,0,4,1,4,18,16.7,21.0,Jaden McDaniels,6,7,0.8571428571428571
2864,11/25/2022,22.156164383561645,L,1,24.266666666666666,1,7,0.143,0,3,0.0,0,0,,1,3,4,1,0,2,2,4,2,-2.4,0.0,Jaden McDaniels,1,4,0.25
2865,10/19/2022,30.315068493150687,W,1,34.36666666666667,10,15,0.667,0,0,,3,5,0.6,7,9,16,2,1,1,0,1,23,26.0,13.0,Rudy Gobert,10,15,0.6666666666666666
2866,10/21/2022,30.32054794520548,L,1,37.8,4,10,0.4,0,0,,1,3,0.333,10,13,23,0,1,2,4,3,9,10.9,-9.0,Rudy Gobert,4,10,0.4
2867,10/23/2022,30.326027397260273,W,1,24.616666666666667,7,9,0.778,0,1,0.0,1,3,0.333,2,13,15,1,0,1,1,2,15,15.6,-1.0,Rudy Gobert,7,8,0.875
2868,10/24/2022,30.328767123287673,L,1,31.483333333333334,4,4,1.0,0,0,,3,4,0.75,1,6,7,1,0,3,2,2,11,11.9,-9.0,Rudy Gobert,4,4,1.0
2869,10/26/2022,30.334246575342465,W,1,34.63333333333333,4,6,0.667,0,0,,2,4,0.5,0,9,9,1,1,1,2,4,10,8.1,9.0,Rudy Gobert,4,6,0.6666666666666666
2870,10/28/2022,30.339726027397262,W,1,37.166666666666664,7,11,0.636,0,0,,8,12,0.667,8,13,21,2,0,2,1,3,22,25.6,8.0,Rudy Gobert,7,11,0.6363636363636364
2871,10/30/2022,30.345205479452055,L,1,27.366666666666667,4,11,0.364,0,0,,1,3,0.333,6,6,12,0,1,2,1,2,9,8.7,-10.0,Rudy Gobert,4,11,0.36363636363636365
2872,11/1/2022,30.350684931506848,L,1,32.11666666666667,0,1,0.0,0,0,,7,7,1.0,4,5,9,3,0,1,1,2,7,11.6,-14.0,Rudy Gobert,0,1,0.0
2873,11/4/2022,30.35890410958904,L,1,30.483333333333334,3,6,0.5,0,1,0.0,1,2,0.5,4,9,13,0,1,1,0,4,7,9.2,-13.0,Rudy Gobert,3,5,0.6
2874,11/9/2022,30.372602739726027,L,1,29.9,8,11,0.727,0,0,,9,11,0.818,3,8,11,0,0,3,1,4,25,23.7,-6.0,Rudy Gobert,8,11,0.7272727272727273
2875,11/11/2022,30.378082191780823,L,1,35.0,5,5,1.0,0,0,,5,5,1.0,1,5,6,1,1,0,4,4,15,11.8,-9.0,Rudy Gobert,5,5,1.0
2876,11/13/2022,30.383561643835616,W,1,33.3,5,10,0.5,0,0,,5,8,0.625,4,9,13,1,1,2,3,3,15,13.2,-13.0,Rudy Gobert,5,10,0.5
2877,11/16/2022,30.39178082191781,W,1,32.083333333333336,5,7,0.714,0,0,,6,8,0.75,2,6,8,1,2,1,0,3,16,17.7,24.0,Rudy Gobert,5,7,0.7142857142857143
2878,11/19/2022,30.4,W,1,28.15,4,7,0.571,0,0,,0,0,,5,8,13,1,1,0,0,5,8,10.3,-8.0,Rudy Gobert,4,7,0.5714285714285714
2879,11/21/2022,30.405479452054795,W,1,31.366666666666667,0,0,,0,0,,4,4,1.0,2,7,9,0,1,2,1,4,4,7.3,3.0,Rudy Gobert,0,0,
2880,11/23/2022,30.410958904109588,W,1,32.35,9,11,0.818,0,0,,3,4,0.75,4,12,16,2,0,0,2,3,21,21.1,7.0,Rudy Gobert,9,11,0.8181818181818182
2881,11/25/2022,30.416438356164385,L,1,34.35,6,10,0.6,0,0,,5,5,1.0,4,13,17,1,2,2,2,4,17,19.6,6.0,Rudy Gobert,6,10,0.6
2882,11/27/2022,30.421917808219177,L,1,30.066666666666666,4,9,0.444,0,0,,1,2,0.5,4,6,10,0,0,1,2,2,9,6.4,-8.0,Rudy Gobert,4,9,0.4444444444444444
2883,10/19/2022,28.578082191780823,W,0,12.433333333333334,4,5,0.8,3,4,0.75,0,0,,0,3,3,1,0,0,1,3,11,8.5,-8.0,Taurean Prince,1,1,1.0
2884,10/21/2022,28.583561643835615,L,0,18.4,2,4,0.5,0,1,0.0,0,0,,2,4,6,1,0,0,0,3,4,4.1,5.0,Taurean Prince,2,3,0.6666666666666666
2885,10/23/2022,28.589041095890412,W,0,23.283333333333335,4,8,0.5,3,5,0.6,0,0,,1,2,3,3,0,0,1,1,11,9.0,18.0,Taurean Prince,1,3,0.3333333333333333
2886,10/24/2022,28.59178082191781,L,0,8.783333333333333,1,1,1.0,1,1,1.0,0,0,,0,0,0,0,0,0,1,1,3,1.3,-11.0,Taurean Prince,0,0,
2887,10/26/2022,28.5972602739726,W,0,19.383333333333333,2,2,1.0,2,2,1.0,0,0,,0,2,2,2,0,0,1,5,6,4.4,5.0,Taurean Prince,0,0,
2888,10/28/2022,28.602739726027398,W,0,25.933333333333334,5,10,0.5,2,6,0.333,1,2,0.5,0,5,5,0,3,0,1,2,13,10.3,-1.0,Taurean Prince,3,4,0.75
2889,10/30/2022,28.60821917808219,L,0,23.383333333333333,4,5,0.8,1,2,0.5,0,0,,0,2,2,1,1,0,1,3,9,7.2,6.0,Taurean Prince,3,3,1.0
2890,11/1/2022,28.613698630136987,L,0,17.483333333333334,2,6,0.333,2,6,0.333,2,2,1.0,0,2,2,2,0,1,0,4,8,5.7,6.0,Taurean Prince,0,0,
2891,11/4/2022,28.621917808219177,L,0,15.15,2,6,0.333,0,2,0.0,2,2,1.0,1,0,1,0,0,0,1,1,6,1.9,-6.0,Taurean Prince,2,4,0.5
2892,11/5/2022,28.624657534246577,W,0,31.55,6,12,0.5,3,8,0.375,1,1,1.0,1,5,6,2,0,1,3,2,16,10.5,16.0,Taurean Prince,3,4,0.75
2893,11/7/2022,28.63013698630137,L,0,21.5,1,6,0.167,0,2,0.0,0,0,,0,3,3,2,0,0,2,3,2,-2.7,-10.0,Taurean Prince,1,4,0.25
2894,11/9/2022,28.635616438356166,L,0,19.116666666666667,2,6,0.333,0,1,0.0,0,0,,0,1,1,0,0,0,0,1,4,0.5,-22.0,Taurean Prince,2,5,0.4
2895,11/11/2022,28.64109589041096,L,0,19.5,2,5,0.4,1,3,0.333,0,0,,0,0,0,0,0,1,0,4,5,1.4,-8.0,Taurean Prince,1,2,0.5
2896,11/13/2022,28.646575342465752,W,0,21.766666666666666,4,6,0.667,1,2,0.5,10,10,1.0,1,1,2,1,0,0,0,2,19,17.3,4.0,Taurean Prince,3,4,0.75
2897,11/16/2022,28.654794520547945,W,0,13.916666666666666,2,3,0.667,0,1,0.0,1,1,1.0,0,1,1,3,0,0,1,2,5,4.3,6.0,Taurean Prince,2,2,1.0
2898,11/19/2022,28.663013698630138,W,0,19.0,3,6,0.5,1,3,0.333,2,4,0.5,0,3,3,1,1,0,2,1,9,5.4,9.0,Taurean Prince,2,3,0.6666666666666666
2899,11/21/2022,28.66849315068493,W,0,30.216666666666665,3,7,0.429,1,4,0.25,0,0,,0,4,4,2,0,0,5,4,7,-0.7,2.0,Taurean Prince,2,3,0.6666666666666666
2900,11/23/2022,28.673972602739727,W,0,10.75,2,5,0.4,0,1,0.0,0,0,,0,1,1,0,1,1,1,1,4,1.9,-4.0,Taurean Prince,2,4,0.5
2901,10/19/2022,29.07945205479452,W,0,22.25,0,2,0.0,0,1,0.0,2,2,1.0,2,4,6,1,1,1,2,0,2,3.6,4.0,Kyle Anderson,0,1,0.0
2902,10/21/2022,29.084931506849315,L,0,0.6333333333333333,0,0,,0,0,,0,0,,0,0,0,0,0,0,0,0,0,0.0,3.0,Kyle Anderson,0,0,
2903,10/30/2022,29.10958904109589,L,0,12.5,0,0,,0,0,,2,2,1.0,1,3,4,4,0,0,0,3,2,5.2,-3.0,Kyle Anderson,0,0,
2904,11/1/2022,29.115068493150684,L,0,14.033333333333333,1,1,1.0,0,0,,1,2,0.5,0,1,1,0,0,0,0,0,3,2.6,-5.0,Kyle Anderson,1,1,1.0
2905,11/4/2022,29.123287671232877,L,0,20.533333333333335,1,3,0.333,0,1,0.0,2,2,1.0,0,3,3,3,0,1,1,2,4,4.2,11.0,Kyle Anderson,1,2,0.5
2906,11/5/2022,29.126027397260273,W,1,30.65,6,7,0.857,2,2,1.0,2,3,0.667,1,2,3,6,3,0,1,3,16,19.4,13.0,Kyle Anderson,4,5,0.8
2907,11/7/2022,29.13150684931507,L,1,24.766666666666666,4,6,0.667,1,1,1.0,0,0,,0,2,2,2,2,1,0,1,9,10.7,-8.0,Kyle Anderson,3,5,0.6
2908,11/9/2022,29.136986301369863,L,0,22.1,3,4,0.75,0,1,0.0,2,2,1.0,0,0,0,4,0,1,0,0,8,9.9,-17.0,Kyle Anderson,3,3,1.0
2909,11/11/2022,29.14246575342466,L,0,24.5,5,12,0.417,1,5,0.2,0,0,,0,7,7,4,1,1,4,0,11,7.2,-5.0,Kyle Anderson,4,7,0.5714285714285714
2910,11/13/2022,29.147945205479452,W,0,21.466666666666665,2,5,0.4,2,2,1.0,0,0,,0,3,3,5,1,0,0,3,6,7.5,17.0,Kyle Anderson,0,3,0.0
2911,11/16/2022,29.156164383561645,W,0,19.75,3,7,0.429,0,0,,2,2,1.0,1,3,4,1,3,2,3,1,8,7.6,3.0,Kyle Anderson,3,7,0.42857142857142855
2912,11/19/2022,29.164383561643834,W,0,21.566666666666666,2,5,0.4,0,1,0.0,2,3,0.667,1,4,5,3,1,0,0,1,6,7.5,7.0,Kyle Anderson,2,4,0.5
2913,11/23/2022,29.175342465753424,W,0,23.583333333333332,3,5,0.6,0,1,0.0,1,2,0.5,1,6,7,2,1,2,3,1,7,7.2,5.0,Kyle Anderson,3,4,0.75
2914,11/25/2022,29.18082191780822,L,0,23.083333333333332,2,5,0.4,0,1,0.0,2,2,1.0,1,4,5,2,1,3,1,2,6,7.9,-7.0,Kyle Anderson,2,4,0.5
2915,11/27/2022,29.186301369863013,L,0,19.016666666666666,2,3,0.667,0,0,,0,0,,0,3,3,1,1,0,3,3,4,1.1,1.0,Kyle Anderson,2,3,0.6666666666666666
2916,10/19/2022,26.528767123287672,W,0,10.933333333333334,2,6,0.333,0,3,0.0,0,0,,0,2,2,0,0,0,1,0,4,0.2,7.0,Jordan McLaughlin,2,3,0.6666666666666666
2917,10/21/2022,26.534246575342465,L,0,15.033333333333333,2,3,0.667,1,2,0.5,0,0,,0,4,4,4,0,0,1,1,5,6.3,4.0,Jordan McLaughlin,1,1,1.0
2918,10/23/2022,26.53972602739726,W,0,21.366666666666667,0,2,0.0,0,1,0.0,0,0,,2,1,3,4,0,0,0,0,0,3.1,23.0,Jordan McLaughlin,0,1,0.0
2919,10/24/2022,26.542465753424658,L,0,16.616666666666667,1,2,0.5,0,1,0.0,0,0,,0,1,1,4,3,0,2,2,2,4.3,3.0,Jordan McLaughlin,1,1,1.0
2920,10/26/2022,26.54794520547945,W,0,19.016666666666666,2,4,0.5,0,1,0.0,2,2,1.0,0,1,1,5,1,0,0,0,6,8.8,12.0,Jordan McLaughlin,2,3,0.6666666666666666
2921,11/1/2022,26.564383561643837,L,0,21.7,4,8,0.5,1,4,0.25,0,0,,0,2,2,3,0,0,0,0,9,7.7,6.0,Jordan McLaughlin,3,4,0.75
2922,11/4/2022,26.572602739726026,L,0,14.916666666666666,0,2,0.0,0,2,0.0,0,0,,0,3,3,3,0,0,0,0,0,1.6,-2.0,Jordan McLaughlin,0,0,
2923,11/5/2022,26.575342465753426,W,0,22.4,2,3,0.667,0,1,0.0,2,2,1.0,0,2,2,11,2,0,0,1,6,14.6,8.0,Jordan McLaughlin,2,2,1.0
2924,11/7/2022,26.58082191780822,L,0,15.833333333333334,1,4,0.25,0,3,0.0,2,2,1.0,0,1,1,4,0,1,2,2,4,2.6,-13.0,Jordan McLaughlin,1,1,1.0
2925,11/9/2022,26.586301369863016,L,0,6.966666666666667,0,1,0.0,0,0,,0,0,,0,1,1,0,0,0,0,0,0,-0.4,-6.0,Jordan McLaughlin,0,1,0.0
2926,11/11/2022,26.59178082191781,L,0,7.6,0,1,0.0,0,0,,0,0,,0,0,0,2,0,0,0,0,0,0.7,0.0,Jordan McLaughlin,0,1,0.0
2927,11/13/2022,26.5972602739726,W,0,14.516666666666667,1,4,0.25,0,1,0.0,0,0,,2,2,4,6,0,0,2,0,2,3.8,7.0,Jordan McLaughlin,1,3,0.3333333333333333
2928,11/16/2022,26.605479452054794,W,0,19.566666666666666,4,6,0.667,1,3,0.333,0,0,,0,0,0,3,4,0,0,0,9,12.5,7.0,Jordan McLaughlin,3,3,1.0
2929,11/19/2022,26.613698630136987,W,0,14.45,0,2,0.0,0,2,0.0,0,0,,0,0,0,4,0,0,1,0,0,0.4,8.0,Jordan McLaughlin,0,0,
2930,11/21/2022,26.61917808219178,W,0,15.833333333333334,4,5,0.8,4,5,0.8,0,0,,0,0,0,3,2,0,0,0,12,14.2,6.0,Jordan McLaughlin,0,0,
2931,10/21/2022,23.153424657534245,L,0,9.316666666666666,0,3,0.0,0,1,0.0,0,0,,1,1,2,1,1,2,1,2,0,0.2,-1.0,Naz Reid,0,2,0.0
2932,10/23/2022,23.15890410958904,W,0,13.066666666666666,5,7,0.714,2,4,0.5,2,4,0.5,1,1,2,1,0,1,0,4,14,11.1,2.0,Naz Reid,3,3,1.0
2933,10/24/2022,23.161643835616438,L,0,12.716666666666667,3,7,0.429,0,1,0.0,0,0,,1,2,3,0,0,1,0,0,6,4.3,-1.0,Naz Reid,3,6,0.5
2934,10/26/2022,23.167123287671235,W,0,5.216666666666667,1,1,1.0,0,0,,0,0,,0,2,2,1,1,0,0,0,2,4.0,3.0,Naz Reid,1,1,1.0
2935,10/30/2022,23.17808219178082,L,0,8.55,5,7,0.714,1,2,0.5,0,0,,1,1,2,0,1,0,0,0,11,10.1,12.0,Naz Reid,4,5,0.8
2936,11/1/2022,23.183561643835617,L,0,15.766666666666667,5,6,0.833,1,2,0.5,2,2,1.0,0,3,3,0,1,0,0,0,13,12.7,10.0,Naz Reid,4,4,1.0
2937,11/4/2022,23.19178082191781,L,0,22.016666666666666,3,7,0.429,0,3,0.0,2,2,1.0,0,5,5,0,0,1,1,3,8,4.3,1.0,Naz Reid,3,4,0.75
2938,11/5/2022,23.194520547945206,W,0,13.25,4,7,0.571,2,4,0.5,1,2,0.5,0,3,3,0,0,1,5,6,11,1.5,8.0,Naz Reid,2,3,0.6666666666666666
2939,11/7/2022,23.2,L,0,18.283333333333335,5,8,0.625,0,3,0.0,1,2,0.5,2,0,2,0,0,1,0,2,11,8.3,-14.0,Naz Reid,5,5,1.0
2940,11/16/2022,23.224657534246575,W,0,1.7666666666666666,0,0,,0,0,,0,0,,0,1,1,1,0,0,0,0,0,1.0,-5.0,Naz Reid,0,0,
2941,11/19/2022,23.232876712328768,W,0,10.383333333333333,3,4,0.75,1,1,1.0,2,2,1.0,1,3,4,1,0,0,0,5,9,7.7,3.0,Naz Reid,2,3,0.6666666666666666
2942,11/21/2022,23.23835616438356,W,0,16.183333333333334,3,9,0.333,0,2,0.0,3,4,0.75,0,4,4,2,0,1,1,3,9,4.6,-25.0,Naz Reid,3,7,0.42857142857142855
2943,11/25/2022,23.24931506849315,L,0,13.45,3,5,0.6,1,2,0.5,0,0,,0,0,0,0,0,0,1,3,7,2.5,-3.0,Naz Reid,2,3,0.6666666666666666
2944,11/27/2022,23.254794520547946,L,0,16.016666666666666,3,6,0.5,2,3,0.667,0,1,0.0,0,2,2,2,0,0,0,1,8,6.2,-4.0,Naz Reid,1,3,0.3333333333333333
2945,10/19/2022,29.24109589041096,W,0,3.5833333333333335,0,2,0.0,0,2,0.0,0,0,,0,0,0,0,0,0,0,1,0,-1.8,7.0,Bryn Forbes,0,0,
2946,10/21/2022,29.246575342465754,L,0,2.95,0,0,,0,0,,0,0,,0,0,0,0,0,0,1,1,0,-1.4,1.0,Bryn Forbes,0,0,
2947,10/23/2022,29.252054794520546,W,0,11.966666666666667,0,3,0.0,0,2,0.0,0,0,,0,0,0,0,0,0,0,0,0,-2.1,-13.0,Bryn Forbes,0,1,0.0
2948,10/24/2022,29.254794520547946,L,0,13.466666666666667,2,4,0.5,0,0,,2,2,1.0,0,1,1,2,1,0,0,0,6,6.7,2.0,Bryn Forbes,2,4,0.5
2949,10/28/2022,29.265753424657536,W,0,8.7,1,3,0.333,1,2,0.5,0,0,,1,0,1,1,0,0,0,2,3,1.9,2.0,Bryn Forbes,0,1,0.0
2950,10/30/2022,29.27123287671233,L,0,19.316666666666666,1,6,0.167,0,2,0.0,2,2,1.0,2,1,3,1,2,0,1,0,4,3.6,-6.0,Bryn Forbes,1,4,0.25
2951,11/7/2022,29.293150684931508,L,0,8.8,1,3,0.333,1,3,0.333,0,0,,0,0,0,1,1,0,1,0,3,2.0,0.0,Bryn Forbes,0,0,
2952,11/11/2022,29.304109589041097,L,0,18.133333333333333,4,8,0.5,2,3,0.667,0,0,,0,0,0,3,3,0,0,1,10,10.7,-5.0,Bryn Forbes,2,5,0.4
2953,11/21/2022,29.33150684931507,W,0,4.183333333333334,0,2,0.0,0,2,0.0,0,0,,0,0,0,0,0,0,0,1,0,-1.8,0.0,Bryn Forbes,0,0,
2954,11/27/2022,29.34794520547945,L,0,17.033333333333335,4,8,0.5,1,4,0.25,1,1,1.0,0,0,0,1,0,0,1,1,10,5.3,9.0,Bryn Forbes,3,4,0.75
2955,10/19/2022,30.216438356164385,W,0,0.75,0,0,,0,0,,0,0,,0,0,0,0,0,0,0,0,0,0.0,3.0,Austin Rivers,0,0,
2956,10/21/2022,30.221917808219178,L,0,8.45,0,1,0.0,0,0,,0,0,,0,1,1,0,0,0,0,0,0,-0.4,-5.0,Austin Rivers,0,1,0.0
2957,10/28/2022,30.24109589041096,W,0,13.333333333333334,0,2,0.0,0,1,0.0,0,0,,0,0,0,1,0,0,0,0,0,-0.7,-5.0,Austin Rivers,0,1,0.0
2958,10/30/2022,30.246575342465754,L,0,4.733333333333333,0,1,0.0,0,0,,0,0,,0,1,1,0,0,0,0,0,0,-0.4,-3.0,Austin Rivers,0,1,0.0
2959,11/5/2022,30.263013698630136,W,0,0.23333333333333334,0,0,,0,0,,0,0,,0,0,0,0,0,0,0,0,0,0.0,0.0,Austin Rivers,0,0,
2960,11/7/2022,30.268493150684932,L,0,15.716666666666667,2,5,0.4,1,4,0.25,4,4,1.0,0,2,2,1,0,1,1,0,9,7.3,11.0,Austin Rivers,1,1,1.0
2961,11/13/2022,30.284931506849315,W,0,0.43333333333333335,0,0,,0,0,,0,0,,0,0,0,0,0,0,0,1,0,-0.4,1.0,Austin Rivers,0,0,
2962,11/23/2022,30.312328767123287,W,0,19.95,2,4,0.5,1,3,0.333,1,2,0.5,0,0,0,1,0,0,0,0,6,4.3,2.0,Austin Rivers,1,1,1.0
2963,11/25/2022,30.317808219178083,L,0,17.633333333333333,1,2,0.5,0,1,0.0,2,2,1.0,0,3,3,1,1,0,1,2,4,3.8,-4.0,Austin Rivers,1,1,1.0
2964,11/27/2022,30.323287671232876,L,1,28.966666666666665,1,4,0.25,1,3,0.333,2,2,1.0,0,2,2,1,0,0,1,3,5,1.7,-24.0,Austin Rivers,0,1,0.0
2965,10/23/2022,25.09041095890411,W,0,2.4833333333333334,0,0,,0,0,,0,0,,0,2,2,0,0,0,0,1,0,0.2,-12.0,Nathan Knight,0,0,
2966,10/24/2022,25.09315068493151,L,0,1.1166666666666667,0,0,,0,0,,0,0,,0,0,0,0,0,0,0,0,0,0.0,2.0,Nathan Knight,0,0,
2967,11/5/2022,25.126027397260273,W,0,1.9833333333333334,1,1,1.0,0,0,,1,1,1.0,0,0,0,0,0,0,1,0,3,1.7,-7.0,Nathan Knight,1,1,1.0
2968,11/7/2022,25.13150684931507,L,0,2.5,0,0,,0,0,,0,0,,0,1,1,0,0,0,0,0,0,0.3,3.0,Nathan Knight,0,0,
2969,11/9/2022,25.136986301369863,L,0,5.3,0,1,0.0,0,1,0.0,0,0,,0,2,2,0,2,0,0,1,0,1.5,-3.0,Nathan Knight,0,0,
2970,11/16/2022,25.156164383561645,W,0,1.7666666666666666,0,0,,0,0,,0,0,,0,0,0,0,0,0,1,0,0,-1.0,-5.0,Nathan Knight,0,0,
2971,11/23/2022,25.175342465753424,W,0,0.95,0,0,,0,0,,0,0,,0,0,0,0,0,0,0,0,0,0.0,-2.0,Nathan Knight,0,0,
2972,11/27/2022,25.186301369863013,L,0,3.4166666666666665,0,1,0.0,0,0,,0,2,0.0,0,0,0,0,1,0,0,0,0,-0.5,-4.0,Nathan Knight,0,1,0.0
2973,10/23/2022,21.095890410958905,W,0,2.4833333333333334,0,1,0.0,0,1,0.0,0,0,,0,0,0,0,0,0,1,0,0,-1.7,-12.0,Wendell Moore Jr.,0,0,
2974,11/23/2022,21.18082191780822,W,0,0.95,0,0,,0,0,,0,0,,0,0,0,0,0,0,1,0,0,-1.0,-2.0,Wendell Moore Jr.,0,0,
2975,11/27/2022,21.19178082191781,L,0,3.4166666666666665,0,1,0.0,0,1,0.0,0,1,0.0,0,1,1,0,0,0,0,0,0,-0.8,-4.0,Wendell Moore Jr.,0,0,
2976,11/16/2022,22.339726027397262,W,0,1.7666666666666666,1,1,1.0,0,0,,0,0,,0,1,1,0,0,0,0,1,2,1.6,-5.0,A.J. Lawson,1,1,1.0
2977,11/23/2022,23.90684931506849,W,0,0.95,0,0,,0,0,,0,0,,0,0,0,0,0,0,0,0,0,0.0,-2.0,Luka Garza,0,0,
2978,10/19/2022,23.5013698630137,L,1,32.56666666666667,3,12,0.25,1,6,0.167,3,4,0.75,3,3,6,2,1,0,1,3,10,5.6,1.0,Luguentz Dort,2,6,0.3333333333333333
2979,10/22/2022,23.50958904109589,L,1,30.016666666666666,3,13,0.231,1,7,0.143,6,8,0.75,3,4,7,4,3,0,2,5,13,9.4,-6.0,Luguentz Dort,2,6,0.3333333333333333
2980,10/23/2022,23.512328767123286,L,1,29.9,6,15,0.4,2,7,0.286,6,6,1.0,1,2,3,2,2,0,2,1,20,14.2,-29.0,Luguentz Dort,4,8,0.5
2981,10/25/2022,23.517808219178082,W,1,25.916666666666668,1,11,0.091,0,6,0.0,2,2,1.0,0,2,2,0,0,0,0,2,4,-3.5,25.0,Luguentz Dort,1,5,0.2
2982,10/27/2022,23.523287671232875,W,1,34.18333333333333,9,15,0.6,1,5,0.2,2,2,1.0,1,2,3,4,2,0,1,4,21,17.6,18.0,Luguentz Dort,8,10,0.8
2983,10/29/2022,23.528767123287672,W,1,40.28333333333333,6,12,0.5,1,4,0.25,3,6,0.5,1,5,6,2,2,0,1,5,16,11.4,23.0,Luguentz Dort,5,8,0.625
2984,11/1/2022,23.536986301369865,W,1,31.616666666666667,5,16,0.313,3,8,0.375,1,2,0.5,0,0,0,2,1,1,0,4,14,5.9,-3.0,Luguentz Dort,2,8,0.25
2985,11/3/2022,23.542465753424658,L,1,30.6,8,15,0.533,1,6,0.167,2,3,0.667,0,3,3,1,1,1,0,2,19,13.8,-4.0,Luguentz Dort,7,9,0.7777777777777778
2986,11/5/2022,23.54794520547945,L,1,24.466666666666665,1,5,0.2,0,2,0.0,1,2,0.5,0,4,4,7,1,0,2,2,3,3.8,-16.0,Luguentz Dort,1,3,0.3333333333333333
2987,11/7/2022,23.553424657534247,L,1,25.933333333333334,3,12,0.25,1,6,0.167,0,0,,2,3,5,2,2,1,2,5,7,2.2,-18.0,Luguentz Dort,2,6,0.3333333333333333
2988,11/9/2022,23.55890410958904,L,1,40.03333333333333,5,14,0.357,2,6,0.333,0,0,,2,5,7,3,4,0,0,4,12,11.6,1.0,Luguentz Dort,3,8,0.375
2989,11/11/2022,23.564383561643837,W,1,22.966666666666665,4,7,0.571,3,4,0.75,2,3,0.667,5,2,7,2,0,0,0,3,13,13.6,16.0,Luguentz Dort,1,3,0.3333333333333333
2990,11/13/2022,23.56986301369863,W,1,24.45,8,11,0.727,2,5,0.4,6,6,1.0,0,3,3,0,0,1,1,5,24,18.1,-7.0,Luguentz Dort,6,6,1.0
2991,11/14/2022,23.572602739726026,L,1,35.4,7,18,0.389,3,7,0.429,4,5,0.8,2,3,5,1,0,0,3,3,21,9.6,5.0,Luguentz Dort,4,11,0.36363636363636365
2992,11/16/2022,23.578082191780823,W,1,33.583333333333336,6,12,0.5,3,6,0.5,1,3,0.333,1,1,2,3,1,1,2,2,16,11.2,-4.0,Luguentz Dort,3,6,0.5
2993,11/18/2022,23.583561643835615,L,1,26.733333333333334,2,8,0.25,0,2,0.0,0,0,,3,4,7,1,1,0,0,5,4,2.2,-11.0,Luguentz Dort,2,6,0.3333333333333333
2994,11/21/2022,23.59178082191781,L,1,31.716666666666665,9,14,0.643,3,4,0.75,3,4,0.75,4,4,8,3,1,1,1,4,24,22.6,-7.0,Luguentz Dort,6,10,0.6
2995,11/23/2022,23.5972602739726,L,1,36.983333333333334,7,16,0.438,3,7,0.429,1,2,0.5,1,6,7,1,0,0,1,3,18,10.2,1.0,Luguentz Dort,4,9,0.4444444444444444
2996,11/25/2022,23.602739726027398,W,1,34.21666666666667,2,8,0.25,1,4,0.25,7,8,0.875,1,4,5,0,2,0,3,5,12,5.7,2.0,Luguentz Dort,1,4,0.25
2997,11/26/2022,23.605479452054794,L,1,13.85,1,4,0.25,1,4,0.25,0,0,,1,2,3,2,1,0,0,1,3,3.9,-2.0,Luguentz Dort,0,0,
2998,10/19/2022,24.27123287671233,L,1,36.78333333333333,12,23,0.522,2,6,0.333,6,6,1.0,2,4,6,5,3,2,2,1,32,28.8,-1.0,Shai Gilgeous-Alexander,10,17,0.5882352941176471
2999,10/22/2022,24.279452054794522,L,1,33.93333333333333,11,24,0.458,1,5,0.2,5,5,1.0,0,3,3,7,1,0,5,4,28,15.8,-6.0,Shai Gilgeous-Alexander,10,19,0.5263157894736842
3000,10/25/2022,24.28767123287671,W,1,36.733333333333334,11,22,0.5,2,2,1.0,9,9,1.0,1,4,5,8,3,3,2,0,33,32.6,23.0,Shai Gilgeous-Alexander,9,20,0.45
3001,10/27/2022,24.293150684931508,W,1,34.016666666666666,10,23,0.435,2,4,0.5,2,2,1.0,1,4,5,6,3,0,3,4,24,16.4,12.0,Shai Gilgeous-Alexander,8,19,0.42105263157894735
3002,10/29/2022,24.2986301369863,W,1,41.333333333333336,15,27,0.556,0,2,0.0,8,8,1.0,2,4,6,9,2,1,3,2,38,32.9,20.0,Shai Gilgeous-Alexander,15,25,0.6
3003,11/1/2022,24.306849315068494,W,1,32.9,12,18,0.667,0,3,0.0,10,11,0.909,0,4,4,6,3,2,5,2,34,29.8,-2.0,Shai Gilgeous-Alexander,12,15,0.8
3004,11/3/2022,24.312328767123287,L,1,35.2,13,17,0.765,0,0,,11,11,1.0,1,3,4,3,2,0,4,3,37,30.8,-6.0,Shai Gilgeous-Alexander,13,17,0.7647058823529411
3005,11/5/2022,24.317808219178083,L,1,31.766666666666666,7,16,0.438,0,1,0.0,4,5,0.8,0,1,1,3,1,1,2,3,18,10.1,-19.0,Shai Gilgeous-Alexander,7,15,0.4666666666666667
3006,11/7/2022,24.323287671232876,L,1,38.0,13,23,0.565,0,0,,7,7,1.0,2,5,7,5,1,4,1,2,33,30.5,-8.0,Shai Gilgeous-Alexander,13,23,0.5652173913043478
3007,11/9/2022,24.328767123287673,L,1,46.083333333333336,13,25,0.52,2,5,0.4,11,13,0.846,1,3,4,4,0,2,4,5,39,25.7,3.0,Shai Gilgeous-Alexander,11,20,0.55
3008,11/11/2022,24.334246575342465,W,1,28.05,8,14,0.571,1,2,0.5,3,4,0.75,0,3,3,4,3,1,3,2,20,16.6,13.0,Shai Gilgeous-Alexander,7,12,0.5833333333333334
3009,11/13/2022,24.339726027397262,W,1,36.2,13,22,0.591,2,3,0.667,9,10,0.9,0,5,5,8,3,2,6,2,37,31.1,4.0,Shai Gilgeous-Alexander,11,19,0.5789473684210527
3010,11/14/2022,24.34246575342466,L,1,35.983333333333334,13,26,0.5,2,4,0.5,9,9,1.0,1,3,4,8,2,1,4,2,37,29.1,-3.0,Shai Gilgeous-Alexander,11,22,0.5
3011,11/16/2022,24.34794520547945,W,1,34.81666666666667,14,22,0.636,2,3,0.667,12,17,0.706,2,4,6,7,0,1,2,1,42,36.0,9.0,Shai Gilgeous-Alexander,12,19,0.631578947368421
3012,11/18/2022,24.353424657534248,L,1,33.86666666666667,6,18,0.333,2,4,0.5,1,1,1.0,1,5,6,6,0,1,2,4,15,8.3,-13.0,Shai Gilgeous-Alexander,4,14,0.2857142857142857
3013,11/21/2022,24.361643835616437,L,1,34.6,9,22,0.409,0,2,0.0,12,13,0.923,1,4,5,7,1,1,3,3,30,22.1,-7.0,Shai Gilgeous-Alexander,9,20,0.45
3014,11/23/2022,24.367123287671234,L,1,42.516666666666666,8,20,0.4,1,4,0.25,14,14,1.0,1,6,7,11,2,1,1,3,31,30.9,2.0,Shai Gilgeous-Alexander,7,16,0.4375
3015,11/25/2022,24.372602739726027,W,1,40.38333333333333,8,21,0.381,0,3,0.0,14,15,0.933,1,7,8,7,0,1,1,2,30,24.7,9.0,Shai Gilgeous-Alexander,8,18,0.4444444444444444
3016,11/26/2022,24.375342465753423,L,1,27.516666666666666,12,21,0.571,1,3,0.333,7,7,1.0,1,2,3,3,2,0,3,1,32,24.1,-9.0,Shai Gilgeous-Alexander,11,18,0.6111111111111112
3017,10/19/2022,21.958904109589042,L,0,12.4,2,3,0.667,2,3,0.667,0,0,,1,4,5,0,1,0,0,5,6,5.6,-9.0,Jeremiah Robinson-Earl,0,0,
3018,10/22/2022,21.96712328767123,L,1,18.35,4,6,0.667,2,4,0.5,0,0,,0,2,2,0,1,0,2,0,10,7.0,-17.0,Jeremiah Robinson-Earl,2,2,1.0
3019,10/23/2022,21.96986301369863,L,1,25.566666666666666,5,6,0.833,3,4,0.75,2,2,1.0,0,2,2,3,1,0,0,2,15,15.7,-9.0,Jeremiah Robinson-Earl,2,2,1.0
3020,10/25/2022,21.975342465753425,W,1,22.766666666666666,0,7,0.0,0,3,0.0,2,2,1.0,3,6,9,0,3,1,0,1,2,4.3,8.0,Jeremiah Robinson-Earl,0,4,0.0
3021,10/27/2022,21.980821917808218,W,1,14.516666666666667,2,4,0.5,1,2,0.5,0,0,,1,1,2,2,0,0,0,2,5,4.6,7.0,Jeremiah Robinson-Earl,1,2,0.5
3022,10/29/2022,21.986301369863014,W,0,5.016666666666667,0,1,0.0,0,1,0.0,0,0,,0,0,0,0,0,0,0,0,0,-0.7,-7.0,Jeremiah Robinson-Earl,0,0,
3023,11/1/2022,21.994520547945207,W,1,21.833333333333332,5,8,0.625,0,2,0.0,1,1,1.0,0,5,5,2,3,1,0,3,11,12.8,22.0,Jeremiah Robinson-Earl,5,6,0.8333333333333334
3024,11/3/2022,22.0,L,1,22.783333333333335,4,10,0.4,2,5,0.4,0,2,0.0,1,6,7,1,2,0,0,1,10,8.6,-22.0,Jeremiah Robinson-Earl,2,5,0.4
3025,11/5/2022,22.005479452054793,L,1,17.55,5,7,0.714,2,4,0.5,0,0,,2,1,3,1,0,1,1,1,12,10.8,-15.0,Jeremiah Robinson-Earl,3,3,1.0
3026,11/7/2022,22.01095890410959,L,1,15.466666666666667,2,7,0.286,1,4,0.25,2,4,0.5,2,2,4,0,0,1,0,1,7,4.4,-15.0,Jeremiah Robinson-Earl,1,3,0.3333333333333333
3027,11/9/2022,22.016438356164382,L,1,12.533333333333333,2,6,0.333,1,3,0.333,0,0,,0,1,1,0,0,0,2,2,5,-0.9,-8.0,Jeremiah Robinson-Earl,1,3,0.3333333333333333
3028,11/13/2022,22.027397260273972,W,1,30.733333333333334,7,9,0.778,3,4,0.75,0,0,,3,4,7,0,0,0,1,5,17,13.8,11.0,Jeremiah Robinson-Earl,4,5,0.8
3029,11/14/2022,22.03013698630137,L,0,13.8,2,4,0.5,0,0,,0,0,,2,3,5,0,0,0,0,4,4,2.7,-13.0,Jeremiah Robinson-Earl,2,4,0.5
3030,11/16/2022,22.035616438356165,W,0,13.416666666666666,2,3,0.667,1,2,0.5,3,4,0.75,1,3,4,1,0,0,1,0,8,7.6,0.0,Jeremiah Robinson-Earl,1,1,1.0
3031,11/18/2022,22.041095890410958,L,0,27.5,6,9,0.667,0,2,0.0,2,2,1.0,1,6,7,1,0,3,2,1,14,13.0,13.0,Jeremiah Robinson-Earl,6,7,0.8571428571428571
3032,11/21/2022,22.04931506849315,L,1,21.7,3,5,0.6,2,3,0.667,0,0,,1,1,2,2,0,0,1,2,8,6.3,-8.0,Jeremiah Robinson-Earl,1,2,0.5
3033,11/23/2022,22.054794520547944,L,1,34.516666666666666,3,11,0.273,2,5,0.4,0,0,,5,6,11,3,2,1,0,5,8,9.6,6.0,Jeremiah Robinson-Earl,1,6,0.16666666666666666
3034,11/25/2022,22.06027397260274,W,0,19.666666666666668,5,9,0.556,0,2,0.0,0,0,,1,2,3,0,2,0,0,1,10,8.6,16.0,Jeremiah Robinson-Earl,5,7,0.7142857142857143
3035,11/26/2022,22.063013698630137,L,0,23.65,3,7,0.429,1,4,0.25,2,3,0.667,4,1,5,2,0,1,0,0,9,10.1,13.0,Jeremiah Robinson-Earl,2,3,0.6666666666666666
3036,10/19/2022,27.87945205479452,L,1,22.016666666666666,2,7,0.286,1,3,0.333,0,0,,2,4,6,1,0,0,0,3,5,3.0,-13.0,Kenrich Williams,1,4,0.25
3037,10/22/2022,27.887671232876713,L,0,16.066666666666666,1,2,0.5,0,0,,1,1,1.0,2,1,3,3,0,0,0,3,3,4.6,2.0,Kenrich Williams,1,2,0.5
3038,10/23/2022,27.89041095890411,L,1,18.383333333333333,3,8,0.375,0,2,0.0,0,2,0.0,0,2,2,1,1,0,1,0,6,2.1,-9.0,Kenrich Williams,3,6,0.5
3039,10/25/2022,27.895890410958906,W,0,25.416666666666668,5,8,0.625,0,2,0.0,0,0,,4,3,7,2,0,1,0,2,10,11.4,-9.0,Kenrich Williams,5,6,0.8333333333333334
3040,10/27/2022,27.9013698630137,W,0,25.95,5,8,0.625,2,4,0.5,0,0,,1,0,1,3,2,0,0,1,12,12.8,-9.0,Kenrich Williams,3,4,0.75
3041,10/29/2022,27.90684931506849,W,0,17.533333333333335,1,2,0.5,1,1,1.0,0,0,,2,4,6,0,0,1,2,2,3,2.5,-25.0,Kenrich Williams,0,1,0.0
3042,11/3/2022,27.92054794520548,L,0,22.133333333333333,2,5,0.4,1,2,0.5,0,0,,3,3,6,1,1,0,0,2,5,6.2,-4.0,Kenrich Williams,1,3,0.3333333333333333
3043,11/5/2022,27.926027397260274,L,0,16.883333333333333,1,3,0.333,0,2,0.0,1,2,0.5,1,2,3,1,1,0,0,3,3,2.7,4.0,Kenrich Williams,1,1,1.0
3044,11/7/2022,27.931506849315067,L,0,26.416666666666668,5,8,0.625,1,3,0.333,0,2,0.0,6,2,8,4,1,0,0,3,11,14.0,11.0,Kenrich Williams,4,5,0.8
3045,11/9/2022,27.936986301369863,L,0,17.016666666666666,1,2,0.5,0,1,0.0,0,0,,1,0,1,1,0,0,1,3,2,0.2,-12.0,Kenrich Williams,1,1,1.0
3046,11/11/2022,27.942465753424656,W,0,19.366666666666667,3,6,0.5,0,1,0.0,0,0,,2,4,6,0,0,0,0,1,6,5.2,10.0,Kenrich Williams,3,5,0.6
3047,11/13/2022,27.947945205479453,W,0,20.283333333333335,1,3,0.333,0,0,,1,2,0.5,0,3,3,3,2,0,0,1,3,5.5,13.0,Kenrich Williams,1,3,0.3333333333333333
3048,11/14/2022,27.95068493150685,L,0,18.983333333333334,3,6,0.5,1,2,0.5,0,0,,0,1,1,2,1,0,0,0,7,6.7,-7.0,Kenrich Williams,2,4,0.5
3049,11/16/2022,27.956164383561642,W,0,25.783333333333335,4,6,0.667,1,2,0.5,0,0,,1,4,5,1,1,1,2,3,9,7.5,16.0,Kenrich Williams,3,4,0.75
3050,11/18/2022,27.96164383561644,L,0,11.2,2,5,0.4,1,1,1.0,0,0,,0,1,1,0,0,0,0,1,5,2.2,-6.0,Kenrich Williams,1,4,0.25
3051,11/21/2022,27.96986301369863,L,1,17.05,2,4,0.5,0,1,0.0,0,0,,1,0,1,1,0,0,1,3,4,1.2,-4.0,Kenrich Williams,2,3,0.6666666666666666
3052,11/25/2022,27.980821917808218,W,0,33.0,4,7,0.571,0,2,0.0,0,0,,3,2,5,2,2,0,0,2,8,10.0,12.0,Kenrich Williams,4,5,0.8
3053,11/26/2022,27.983561643835618,L,0,16.166666666666668,3,4,0.75,2,3,0.667,1,1,1.0,1,3,4,0,1,1,0,2,9,9.9,-2.0,Kenrich Williams,1,1,1.0
3054,10/19/2022,20.024657534246575,L,1,33.85,6,14,0.429,2,7,0.286,0,0,,1,10,11,4,0,2,4,4,14,8.9,3.0,Josh Giddey,4,7,0.5714285714285714
3055,10/22/2022,20.03287671232877,L,1,32.733333333333334,8,17,0.471,2,4,0.5,1,2,0.5,4,8,12,6,1,1,1,2,19,19.2,-17.0,Josh Giddey,6,13,0.46153846153846156
3056,10/23/2022,20.035616438356165,L,1,21.7,5,11,0.455,0,2,0.0,0,0,,0,2,2,5,0,0,4,2,10,3.6,-15.0,Josh Giddey,5,9,0.5555555555555556
3057,11/1/2022,20.06027397260274,W,1,25.05,3,12,0.25,0,3,0.0,1,1,1.0,0,1,1,10,1,1,2,2,7,6.0,-1.0,Josh Giddey,3,9,0.3333333333333333
3058,11/3/2022,20.065753424657533,L,1,31.9,7,14,0.5,2,4,0.5,0,0,,0,1,1,5,1,0,4,3,16,8.6,-10.0,Josh Giddey,5,10,0.5
3059,11/5/2022,20.07123287671233,L,1,26.033333333333335,6,14,0.429,2,3,0.667,1,1,1.0,1,5,6,2,0,0,4,1,15,6.8,-12.0,Josh Giddey,4,11,0.36363636363636365
3060,11/7/2022,20.076712328767123,L,1,24.866666666666667,4,12,0.333,0,1,0.0,1,2,0.5,1,5,6,2,0,1,3,2,9,2.3,-12.0,Josh Giddey,4,11,0.36363636363636365
3061,11/9/2022,20.08219178082192,L,1,44.166666666666664,9,19,0.474,0,4,0.0,0,2,0.0,5,10,15,6,0,0,1,1,18,16.8,-8.0,Josh Giddey,9,15,0.6
3062,11/11/2022,20.087671232876712,W,1,22.616666666666667,6,9,0.667,1,1,1.0,2,2,1.0,3,6,9,5,2,0,7,3,15,12.3,8.0,Josh Giddey,5,8,0.625
3063,11/13/2022,20.09315068493151,W,1,36.68333333333333,10,14,0.714,2,3,0.667,2,2,1.0,1,9,10,12,0,0,3,1,24,26.6,15.0,Josh Giddey,8,11,0.7272727272727273
3064,11/14/2022,20.095890410958905,L,1,33.483333333333334,6,17,0.353,1,6,0.167,3,3,1.0,0,7,7,4,0,1,7,3,16,3.9,6.0,Josh Giddey,5,11,0.45454545454545453
3065,11/16/2022,20.101369863013698,W,1,20.466666666666665,5,11,0.455,1,3,0.333,0,0,,0,6,6,2,0,0,2,4,11,4.9,-23.0,Josh Giddey,4,8,0.5
3066,11/18/2022,20.106849315068494,L,1,36.833333333333336,10,20,0.5,0,4,0.0,0,1,0.0,1,5,6,11,0,1,3,4,20,15.6,-13.0,Josh Giddey,10,16,0.625
3067,11/21/2022,20.115068493150684,L,1,33.75,8,15,0.533,0,2,0.0,2,2,1.0,3,6,9,7,1,0,3,1,18,17.1,-2.0,Josh Giddey,8,13,0.6153846153846154
3068,11/23/2022,20.12054794520548,L,1,28.633333333333333,5,12,0.417,1,4,0.25,1,2,0.5,2,2,4,6,0,0,3,1,12,8.0,-12.0,Josh Giddey,4,8,0.5
3069,11/25/2022,20.126027397260273,W,1,37.5,5,13,0.385,0,1,0.0,0,0,,2,11,13,9,0,1,5,0,10,9.6,-2.0,Josh Giddey,5,12,0.4166666666666667
3070,11/26/2022,20.12876712328767,L,1,28.05,7,14,0.5,0,1,0.0,4,7,0.571,3,2,5,2,1,0,4,4,18,9.3,-26.0,Josh Giddey,7,13,0.5384615384615384
3071,10/19/2022,20.813698630136987,L,1,24.8,3,10,0.3,2,5,0.4,3,4,0.75,3,4,7,3,0,1,2,1,11,8.5,5.0,Aleksej Pokusevski,1,5,0.2
3072,10/22/2022,20.82191780821918,L,1,12.1,0,1,0.0,0,0,,0,0,,0,1,1,0,2,1,0,1,0,1.9,-12.0,Aleksej Pokusevski,0,1,0.0
3073,10/23/2022,20.824657534246576,L,0,13.183333333333334,1,6,0.167,0,2,0.0,0,0,,1,1,2,0,0,0,1,0,2,-1.8,-22.0,Aleksej Pokusevski,1,4,0.25
3074,10/25/2022,20.83013698630137,W,0,16.616666666666667,2,7,0.286,0,3,0.0,2,6,0.333,0,4,4,2,1,0,0,2,6,3.1,-7.0,Aleksej Pokusevski,2,4,0.5
3075,10/27/2022,20.835616438356166,W,0,26.4,6,11,0.545,3,5,0.6,0,0,,4,2,6,3,0,1,4,3,15,10.7,2.0,Aleksej Pokusevski,3,6,0.5
3076,10/29/2022,20.84109589041096,W,1,24.233333333333334,2,6,0.333,0,2,0.0,0,0,,0,4,4,3,0,2,2,4,4,1.7,-21.0,Aleksej Pokusevski,2,4,0.5
3077,11/1/2022,20.84931506849315,W,0,31.266666666666666,7,13,0.538,2,5,0.4,0,0,,4,5,9,1,2,3,2,0,16,16.8,22.0,Aleksej Pokusevski,5,8,0.625
3078,11/3/2022,20.854794520547944,L,1,27.65,3,9,0.333,0,4,0.0,0,0,,1,6,7,1,1,2,0,2,6,5.7,-11.0,Aleksej Pokusevski,3,5,0.6
3079,11/9/2022,20.87123287671233,L,1,39.083333333333336,6,11,0.545,4,7,0.571,1,2,0.5,4,6,10,2,2,2,2,1,17,18.3,-11.0,Aleksej Pokusevski,2,4,0.5
3080,11/11/2022,20.876712328767123,W,1,22.616666666666667,6,10,0.6,1,2,0.5,1,1,1.0,2,3,5,0,0,4,3,2,14,10.7,10.0,Aleksej Pokusevski,5,8,0.625
3081,11/13/2022,20.882191780821916,W,1,18.216666666666665,5,8,0.625,2,4,0.5,0,0,,0,2,2,3,1,1,2,1,12,10.4,11.0,Aleksej Pokusevski,3,4,0.75
3082,11/14/2022,20.884931506849316,L,1,37.083333333333336,7,12,0.583,2,4,0.5,0,0,,2,12,14,3,1,3,2,4,16,17.0,5.0,Aleksej Pokusevski,5,8,0.625
3083,11/16/2022,20.89041095890411,W,1,13.983333333333333,3,4,0.75,2,3,0.667,0,0,,0,1,1,1,0,3,1,2,8,7.7,-21.0,Aleksej Pokusevski,1,1,1.0
3084,11/18/2022,20.895890410958906,L,1,14.183333333333334,4,4,1.0,2,2,1.0,0,0,,0,1,1,1,0,3,0,1,10,11.5,-6.0,Aleksej Pokusevski,2,2,1.0
3085,11/23/2022,20.90958904109589,L,1,29.116666666666667,5,8,0.625,2,4,0.5,1,2,0.5,0,1,1,3,1,3,1,4,13,11.9,-4.0,Aleksej Pokusevski,3,4,0.75
3086,11/25/2022,20.915068493150685,W,1,31.7,6,13,0.462,1,3,0.333,2,2,1.0,2,4,6,2,1,1,1,3,15,11.8,-13.0,Aleksej Pokusevski,5,10,0.5
3087,11/26/2022,20.91780821917808,L,1,8.55,0,2,0.0,0,1,0.0,0,0,,1,2,3,0,0,0,0,1,0,-0.5,-17.0,Aleksej Pokusevski,0,1,0.0
3088,10/19/2022,21.706849315068492,L,0,23.483333333333334,4,11,0.364,2,6,0.333,2,2,1.0,0,2,2,2,1,0,0,1,12,8.5,-5.0,Tre Mann,2,5,0.4
3089,10/22/2022,21.715068493150685,L,0,28.433333333333334,5,11,0.455,2,5,0.4,1,3,0.333,1,3,4,4,0,0,1,4,13,8.3,13.0,Tre Mann,3,6,0.5
3090,10/23/2022,21.71780821917808,L,1,27.533333333333335,5,12,0.417,0,6,0.0,0,1,0.0,2,1,3,3,1,0,2,3,10,4.8,-3.0,Tre Mann,5,6,0.8333333333333334
3091,10/25/2022,21.723287671232878,W,1,36.35,10,24,0.417,2,8,0.25,3,3,1.0,2,2,4,4,2,0,1,0,25,18.0,14.0,Tre Mann,8,16,0.5
3092,10/27/2022,21.72876712328767,W,1,22.2,5,12,0.417,4,7,0.571,0,0,,1,2,3,3,2,0,1,2,14,11.2,14.0,Tre Mann,1,5,0.2
3093,10/29/2022,21.734246575342464,W,1,26.183333333333334,2,9,0.222,0,4,0.0,0,0,,0,3,3,3,1,0,0,4,4,0.9,-14.0,Tre Mann,2,5,0.4
3094,11/1/2022,21.742465753424657,W,0,26.216666666666665,4,8,0.5,2,5,0.4,3,4,0.75,1,4,5,3,0,0,0,2,13,11.8,21.0,Tre Mann,2,3,0.6666666666666666
3095,11/3/2022,21.747945205479454,L,0,17.4,2,5,0.4,0,2,0.0,0,1,0.0,0,2,2,2,0,1,0,0,4,3.6,-8.0,Tre Mann,2,3,0.6666666666666666
3096,11/5/2022,21.753424657534246,L,0,13.983333333333333,1,3,0.333,0,2,0.0,1,2,0.5,0,0,0,0,0,0,2,1,3,-1.5,-11.0,Tre Mann,1,1,1.0
3097,11/7/2022,21.75890410958904,L,0,24.116666666666667,3,10,0.3,3,6,0.5,0,0,,1,4,5,3,1,0,3,1,9,4.8,4.0,Tre Mann,0,4,0.0
3098,11/9/2022,21.764383561643836,L,0,35.85,8,16,0.5,5,9,0.556,0,0,,1,5,6,1,2,0,2,5,21,13.9,4.0,Tre Mann,3,7,0.42857142857142855
3099,11/11/2022,21.76986301369863,W,0,27.85,5,13,0.385,3,10,0.3,0,0,,1,2,3,1,2,0,1,0,13,8.9,9.0,Tre Mann,2,3,0.6666666666666666
3100,11/13/2022,21.775342465753425,W,0,3.3333333333333335,1,3,0.333,1,2,0.5,0,0,,0,0,0,0,0,0,0,0,3,1.3,-4.0,Tre Mann,0,1,0.0
3101,11/21/2022,21.797260273972604,L,0,12.0,1,5,0.2,1,3,0.333,0,0,,0,1,1,2,0,0,1,0,3,0.6,-9.0,Tre Mann,0,2,0.0
3102,11/23/2022,21.802739726027397,L,0,17.733333333333334,2,4,0.5,0,2,0.0,0,0,,0,2,2,0,0,0,0,0,4,2.6,-8.0,Tre Mann,2,2,1.0
3103,11/25/2022,21.80821917808219,W,0,13.466666666666667,2,5,0.4,1,3,0.333,0,0,,0,3,3,3,0,0,2,2,5,2.5,-1.0,Tre Mann,1,2,0.5
3104,11/26/2022,21.81095890410959,L,0,24.983333333333334,1,11,0.091,0,9,0.0,0,0,,0,5,5,0,2,0,2,3,2,-5.0,10.0,Tre Mann,1,2,0.5
3105,10/19/2022,21.515068493150686,L,0,5.9,2,2,1.0,1,1,1.0,0,0,,0,0,0,1,0,0,2,3,5,1.9,-6.0,Jalen Williams,1,1,1.0
3106,10/29/2022,21.542465753424658,W,0,26.816666666666666,5,8,0.625,0,2,0.0,3,3,1.0,0,3,3,3,4,1,3,3,13,12.9,-9.0,Jalen Williams,5,6,0.8333333333333334
3107,11/1/2022,21.55068493150685,W,1,21.766666666666666,3,7,0.429,0,1,0.0,0,0,,0,1,1,0,2,0,2,1,6,2.2,-9.0,Jalen Williams,3,6,0.5
3108,11/3/2022,21.556164383561644,L,0,14.316666666666666,4,7,0.571,0,1,0.0,0,0,,0,0,0,2,0,0,0,0,8,6.1,-11.0,Jalen Williams,4,6,0.6666666666666666
3109,11/5/2022,21.561643835616437,L,0,19.916666666666668,2,6,0.333,1,3,0.333,0,0,,0,5,5,1,0,0,0,2,5,3.0,-16.0,Jalen Williams,1,3,0.3333333333333333
3110,11/7/2022,21.567123287671233,L,1,30.566666666666666,3,6,0.5,0,0,,0,0,,1,1,2,2,1,1,1,4,6,4.5,-22.0,Jalen Williams,3,6,0.5
3111,11/9/2022,21.572602739726026,L,0,22.566666666666666,3,6,0.5,1,2,0.5,2,2,1.0,1,4,5,2,1,1,0,2,9,10.2,-4.0,Jalen Williams,2,4,0.5
3112,11/11/2022,21.578082191780823,W,0,30.483333333333334,5,10,0.5,0,5,0.0,0,0,,1,2,3,11,1,0,2,5,10,11.0,15.0,Jalen Williams,5,5,1.0
3113,11/13/2022,21.583561643835615,W,0,19.816666666666666,4,6,0.667,0,1,0.0,0,0,,0,0,0,0,0,0,2,3,8,2.2,-3.0,Jalen Williams,4,5,0.8
3114,11/14/2022,21.586301369863016,L,1,36.0,6,9,0.667,2,5,0.4,0,1,0.0,0,6,6,2,0,1,1,3,14,11.4,-3.0,Jalen Williams,4,4,1.0
3115,11/16/2022,21.59178082191781,W,0,27.65,4,11,0.364,2,4,0.5,0,0,,2,2,4,6,0,0,3,2,10,6.3,0.0,Jalen Williams,2,7,0.2857142857142857
3116,11/18/2022,21.5972602739726,L,1,33.55,6,12,0.5,2,5,0.4,2,2,1.0,0,6,6,7,2,0,1,4,16,16.1,-15.0,Jalen Williams,4,7,0.5714285714285714
3117,11/21/2022,21.605479452054794,L,0,26.2,5,11,0.455,0,3,0.0,3,4,0.75,0,4,4,0,1,0,2,1,13,6.7,-14.0,Jalen Williams,5,8,0.625
3118,11/23/2022,21.610958904109587,L,0,29.7,4,9,0.444,2,3,0.667,6,6,1.0,0,0,0,1,0,1,2,6,16,8.3,-2.0,Jalen Williams,2,6,0.3333333333333333
3119,11/25/2022,21.616438356164384,W,1,19.883333333333333,3,4,0.75,0,1,0.0,2,3,0.667,0,2,2,1,0,0,0,3,8,6.1,-8.0,Jalen Williams,3,3,1.0
3120,11/26/2022,21.61917808219178,L,1,29.15,4,12,0.333,0,2,0.0,3,3,1.0,3,2,5,4,0,0,3,1,11,6.3,-16.0,Jalen Williams,4,10,0.4
3121,10/22/2022,23.802739726027397,L,0,15.766666666666667,1,3,0.333,1,2,0.5,2,2,1.0,0,6,6,1,0,0,0,1,5,5.4,7.0,Aaron Wiggins,0,1,0.0
3122,10/23/2022,23.805479452054794,L,0,25.333333333333332,1,3,0.333,0,2,0.0,3,4,0.75,0,2,2,1,0,1,0,0,5,4.9,-7.0,Aaron Wiggins,1,1,1.0
3123,10/25/2022,23.81095890410959,W,1,28.35,5,14,0.357,0,1,0.0,1,1,1.0,3,7,10,0,3,1,1,2,11,9.3,18.0,Aaron Wiggins,5,13,0.38461538461538464
3124,10/27/2022,23.816438356164383,W,1,34.833333333333336,4,7,0.571,3,6,0.5,0,0,,1,5,6,3,1,0,1,3,11,10.8,16.0,Aaron Wiggins,1,1,1.0
3125,10/29/2022,23.82191780821918,W,1,27.666666666666668,2,5,0.4,0,1,0.0,1,2,0.5,2,3,5,4,0,0,0,0,5,7.0,18.0,Aaron Wiggins,2,4,0.5
3126,11/1/2022,23.83013698630137,W,0,12.666666666666666,1,3,0.333,1,3,0.333,0,0,,0,3,3,0,0,0,2,1,3,-0.2,-14.0,Aaron Wiggins,0,0,
3127,11/5/2022,23.84109589041096,L,0,8.683333333333334,0,0,,0,0,,0,0,,0,0,0,0,0,0,3,3,0,-4.2,1.0,Aaron Wiggins,0,0,
3128,11/9/2022,23.852054794520548,L,0,6.533333333333333,0,1,0.0,0,0,,0,0,,0,1,1,2,0,1,0,0,0,1.7,7.0,Aaron Wiggins,0,1,0.0
3129,11/11/2022,23.85753424657534,W,1,33.61666666666667,6,12,0.5,1,4,0.25,4,5,0.8,1,4,5,7,1,1,1,4,17,16.5,13.0,Aaron Wiggins,5,8,0.625
3130,11/13/2022,23.863013698630137,W,0,20.966666666666665,1,3,0.333,1,1,1.0,0,0,,0,3,3,2,1,0,0,5,3,2.6,2.0,Aaron Wiggins,0,2,0.0
3131,11/14/2022,23.865753424657534,L,0,13.783333333333333,2,3,0.667,0,0,,0,0,,2,1,3,1,0,0,1,0,4,4.1,-8.0,Aaron Wiggins,2,3,0.6666666666666666
3132,11/16/2022,23.87123287671233,W,1,27.0,3,4,0.75,1,1,1.0,0,0,,1,2,3,0,0,0,0,2,7,5.9,-5.0,Aaron Wiggins,2,3,0.6666666666666666
3133,11/18/2022,23.876712328767123,L,0,20.85,4,7,0.571,2,4,0.5,0,0,,2,3,5,5,0,0,1,3,10,10.3,-1.0,Aaron Wiggins,2,3,0.6666666666666666
3134,11/21/2022,23.884931506849316,L,0,11.3,1,1,1.0,0,0,,2,2,1.0,0,3,3,0,0,0,1,0,4,3.6,-4.0,Aaron Wiggins,1,1,1.0
3135,11/26/2022,23.898630136986302,L,0,22.666666666666668,5,10,0.5,3,6,0.5,2,2,1.0,1,1,2,0,3,0,0,1,15,13.6,-2.0,Aaron Wiggins,2,4,0.5
3136,10/19/2022,22.353424657534248,L,0,16.866666666666667,2,5,0.4,1,1,1.0,2,4,0.5,1,5,6,3,0,1,0,0,7,8.5,-5.0,Darius Bazley,1,4,0.25
3137,10/22/2022,22.361643835616437,L,0,21.033333333333335,2,4,0.5,2,4,0.5,0,0,,0,2,2,3,2,3,1,2,6,9.0,0.0,Darius Bazley,0,0,
3138,10/23/2022,22.364383561643837,L,0,4.45,0,1,0.0,0,0,,0,0,,0,0,0,0,0,0,0,0,0,-0.7,-12.0,Darius Bazley,0,1,0.0
3139,10/25/2022,22.36986301369863,W,0,19.5,3,8,0.375,0,2,0.0,1,2,0.5,3,5,8,0,0,1,1,2,7,4.7,-1.0,Darius Bazley,3,6,0.5
3140,10/27/2022,22.375342465753423,W,0,22.35,4,9,0.444,1,2,0.5,0,0,,3,6,9,1,0,3,1,0,9,10.0,-2.0,Darius Bazley,3,7,0.42857142857142855
3141,10/29/2022,22.38082191780822,W,0,26.083333333333332,7,11,0.636,0,2,0.0,1,2,0.5,1,7,8,0,0,1,1,3,15,11.0,19.0,Darius Bazley,7,9,0.7777777777777778
3142,11/1/2022,22.389041095890413,W,0,17.716666666666665,2,5,0.4,0,0,,0,1,0.0,3,1,4,2,1,1,1,1,4,5.0,-1.0,Darius Bazley,2,5,0.4
3143,11/3/2022,22.394520547945206,L,0,13.1,1,5,0.2,0,1,0.0,0,0,,3,2,5,2,1,1,1,2,2,2.9,9.0,Darius Bazley,1,4,0.25
3144,11/5/2022,22.4,L,0,19.45,3,7,0.429,2,4,0.5,0,0,,3,2,5,2,2,1,0,1,8,10.7,0.0,Darius Bazley,1,3,0.3333333333333333
3145,11/7/2022,22.405479452054795,L,0,19.566666666666666,3,9,0.333,1,2,0.5,1,2,0.5,1,3,4,3,3,2,0,5,8,8.6,-2.0,Darius Bazley,2,7,0.2857142857142857
3146,11/9/2022,22.410958904109588,L,0,3.966666666666667,0,0,,0,0,,0,0,,0,1,1,1,0,0,0,0,0,1.0,5.0,Darius Bazley,0,0,
3147,11/21/2022,22.443835616438356,L,0,18.433333333333334,2,5,0.4,0,2,0.0,3,7,0.429,1,2,3,0,0,3,0,0,7,6.1,-5.0,Darius Bazley,2,3,0.6666666666666666
3148,11/23/2022,22.44931506849315,L,0,12.9,0,2,0.0,0,0,,1,2,0.5,0,3,3,0,0,1,0,1,1,0.4,-12.0,Darius Bazley,0,2,0.0
3149,11/25/2022,22.454794520547946,W,0,19.783333333333335,7,9,0.778,2,4,0.5,1,2,0.5,0,3,3,0,0,2,1,2,17,13.6,-1.0,Darius Bazley,5,5,1.0
3150,11/26/2022,22.457534246575342,L,0,10.566666666666666,0,0,,0,0,,0,0,,0,0,0,1,0,1,2,1,0,-1.0,-10.0,Darius Bazley,0,0,
3151,10/19/2022,23.2986301369863,L,0,0.18333333333333332,0,0,,0,0,,0,0,,0,0,0,0,0,0,0,0,0,0.0,-2.0,Isaiah Joe,0,0,
3152,10/23/2022,23.30958904109589,L,0,6.033333333333333,1,3,0.333,0,2,0.0,0,0,,0,1,1,3,1,0,0,0,2,3.7,10.0,Isaiah Joe,1,1,1.0
3153,10/25/2022,23.315068493150687,W,0,0.05,0,0,,0,0,,0,0,,0,0,0,0,0,0,0,0,0,0.0,0.0,Isaiah Joe,0,0,
3154,10/27/2022,23.32054794520548,W,0,1.1666666666666667,0,0,,0,0,,0,0,,0,0,0,0,0,0,0,1,0,-0.4,-2.0,Isaiah Joe,0,0,
3155,10/29/2022,23.326027397260273,W,0,9.066666666666666,4,4,1.0,3,3,1.0,4,4,1.0,0,2,2,1,0,0,0,1,15,14.7,24.0,Isaiah Joe,1,1,1.0
3156,11/1/2022,23.334246575342465,W,0,1.7166666666666668,0,1,0.0,0,1,0.0,0,0,,0,0,0,0,0,0,0,0,0,-0.7,-7.0,Isaiah Joe,0,0,
3157,11/5/2022,23.345205479452055,L,0,14.683333333333334,3,6,0.5,2,4,0.5,0,0,,0,1,1,0,0,0,0,0,8,5.3,8.0,Isaiah Joe,1,2,0.5
3158,11/9/2022,23.356164383561644,L,0,4.95,1,2,0.5,1,2,0.5,0,0,,0,2,2,1,0,1,0,0,3,4.0,1.0,Isaiah Joe,0,0,
3159,11/11/2022,23.361643835616437,W,0,5.433333333333334,1,2,0.5,0,1,0.0,0,0,,0,0,0,0,0,0,0,2,2,0.2,-11.0,Isaiah Joe,1,1,1.0
3160,11/13/2022,23.367123287671234,W,0,16.883333333333333,3,6,0.5,2,5,0.4,0,0,,0,3,3,1,2,0,3,3,8,4.4,11.0,Isaiah Joe,1,1,1.0
3161,11/14/2022,23.36986301369863,L,0,7.3,0,1,0.0,0,1,0.0,1,3,0.333,0,3,3,0,0,0,1,1,1,-1.0,-2.0,Isaiah Joe,0,0,
3162,11/21/2022,23.389041095890413,L,0,3.3833333333333333,0,0,,0,0,,0,0,,0,1,1,2,0,0,0,0,0,1.7,4.0,Isaiah Joe,0,0,
3163,11/23/2022,23.394520547945206,L,0,20.866666666666667,7,11,0.636,7,10,0.7,0,0,,2,0,2,1,0,0,1,2,21,16.4,17.0,Isaiah Joe,0,1,0.0
3164,11/25/2022,23.4,W,0,15.4,2,6,0.333,2,6,0.333,2,2,1.0,0,2,2,0,0,0,0,1,8,4.8,6.0,Isaiah Joe,0,0,
3165,11/26/2022,23.4027397260274,L,0,13.7,2,8,0.25,2,7,0.286,0,0,,0,3,3,3,2,0,0,0,6,6.2,2.0,Isaiah Joe,0,1,0.0
3166,10/19/2022,31.301369863013697,L,0,7.5,1,4,0.25,0,3,0.0,0,0,,0,3,3,1,0,0,1,0,2,0.2,-2.0,Mike Muscala,1,1,1.0
3167,10/22/2022,31.30958904109589,L,0,18.8,6,10,0.6,4,7,0.571,2,2,1.0,0,6,6,1,0,0,0,3,18,14.7,7.0,Mike Muscala,2,3,0.6666666666666666
3168,10/23/2022,31.312328767123287,L,0,11.266666666666667,4,6,0.667,1,3,0.333,2,2,1.0,1,8,9,0,0,1,0,1,11,11.8,10.0,Mike Muscala,3,3,1.0
3169,10/25/2022,31.317808219178083,W,0,17.983333333333334,4,5,0.8,0,0,,0,0,,5,5,10,2,0,1,0,2,8,12.4,8.0,Mike Muscala,4,5,0.8
3170,10/27/2022,31.323287671232876,W,0,11.666666666666666,1,3,0.333,0,1,0.0,3,4,0.75,0,1,1,1,0,0,0,0,5,3.9,-6.0,Mike Muscala,1,2,0.5
3171,10/29/2022,31.328767123287673,W,0,11.55,0,3,0.0,0,2,0.0,2,2,1.0,0,2,2,0,0,0,2,2,2,-2.3,10.0,Mike Muscala,0,1,0.0
3172,11/3/2022,31.34246575342466,L,0,12.85,0,3,0.0,0,2,0.0,0,0,,0,2,2,0,0,0,0,3,0,-2.7,7.0,Mike Muscala,0,1,0.0
3173,11/5/2022,31.34794520547945,L,1,16.533333333333335,3,8,0.375,1,6,0.167,2,4,0.5,0,5,5,0,0,0,1,1,9,3.9,-5.0,Mike Muscala,2,2,1.0
3174,11/7/2022,31.353424657534248,L,0,14.533333333333333,4,8,0.5,3,7,0.429,0,0,,0,4,4,0,0,1,0,3,11,7.7,9.0,Mike Muscala,1,1,1.0
3175,11/9/2022,31.35890410958904,L,0,17.133333333333333,2,9,0.222,2,6,0.333,0,0,,1,1,2,1,0,2,1,3,6,1.4,2.0,Mike Muscala,0,3,0.0
3176,11/13/2022,31.36986301369863,W,0,12.433333333333334,2,3,0.667,2,3,0.667,0,0,,0,2,2,2,0,1,1,1,6,6.0,-3.0,Mike Muscala,0,0,
3177,11/16/2022,31.378082191780823,W,0,10.583333333333334,0,0,,0,0,,1,2,0.5,0,2,2,0,0,1,1,3,1,-0.3,3.0,Mike Muscala,0,0,
3178,11/18/2022,31.383561643835616,L,0,8.666666666666666,1,3,0.333,0,2,0.0,0,0,,0,0,0,2,1,1,0,1,2,3.0,-3.0,Mike Muscala,1,1,1.0
3179,11/21/2022,31.39178082191781,L,0,7.733333333333333,1,2,0.5,1,2,0.5,0,0,,0,1,1,1,0,0,0,1,3,2.6,1.0,Mike Muscala,0,0,
3180,10/19/2022,19.413698630136988,L,0,9.083333333333334,0,3,0.0,0,2,0.0,0,0,,0,1,1,0,0,0,0,0,0,-1.8,-14.0,Ousmane Dieng,0,1,0.0
3181,10/22/2022,19.421917808219177,L,0,7.05,0,2,0.0,0,0,,0,0,,0,0,0,0,0,0,0,0,0,-1.4,1.0,Ousmane Dieng,0,2,0.0
3182,10/23/2022,19.424657534246574,L,0,23.45,2,6,0.333,1,3,0.333,0,0,,1,5,6,3,1,2,1,2,5,6.5,15.0,Ousmane Dieng,1,3,0.3333333333333333
3183,10/25/2022,19.43013698630137,W,0,10.316666666666666,1,4,0.25,0,3,0.0,0,0,,0,1,1,1,0,0,0,0,2,0.6,-9.0,Ousmane Dieng,1,1,1.0
3184,10/27/2022,19.435616438356163,W,0,12.716666666666667,1,3,0.333,0,2,0.0,0,0,,0,0,0,1,0,0,0,1,2,0.6,-10.0,Ousmane Dieng,1,1,1.0
3185,11/1/2022,19.44931506849315,W,0,17.25,3,4,0.75,2,3,0.667,0,0,,0,4,4,2,0,0,1,1,8,7.6,12.0,Ousmane Dieng,1,1,1.0
3186,11/3/2022,19.454794520547946,L,0,12.066666666666666,1,3,0.333,0,2,0.0,1,2,0.5,1,2,3,1,0,0,1,1,3,1.5,0.0,Ousmane Dieng,1,1,1.0
3187,11/5/2022,19.46027397260274,L,0,22.316666666666666,3,4,0.75,2,3,0.667,0,0,,1,3,4,5,0,0,0,0,8,11.5,11.0,Ousmane Dieng,1,1,1.0
3188,11/7/2022,19.465753424657535,L,0,20.483333333333334,1,7,0.143,0,4,0.0,0,0,,0,1,1,2,0,0,0,0,2,-0.8,8.0,Ousmane Dieng,1,3,0.3333333333333333
3189,11/26/2022,19.517808219178082,L,0,21.15,0,4,0.0,0,4,0.0,0,0,,1,2,3,2,0,0,1,0,0,-1.1,-6.0,Ousmane Dieng,0,0,
3190,10/19/2022,25.676712328767124,L,0,14.566666666666666,1,5,0.2,0,2,0.0,2,2,1.0,3,1,4,0,0,0,1,5,4,0.3,13.0,Eugene Omoruyi,1,3,0.3333333333333333
3191,10/22/2022,25.684931506849313,L,0,3.4,1,1,1.0,0,0,,0,0,,0,0,0,0,0,0,0,2,2,0.9,4.0,Eugene Omoruyi,1,1,1.0
3192,10/23/2022,25.687671232876713,L,0,11.883333333333333,5,7,0.714,1,2,0.5,2,3,0.667,1,2,3,1,0,0,0,2,13,10.9,5.0,Eugene Omoruyi,4,5,0.8
3193,10/29/2022,25.704109589041096,W,0,9.233333333333333,0,1,0.0,0,1,0.0,2,4,0.5,1,1,2,0,0,0,1,3,2,-0.7,-8.0,Eugene Omoruyi,0,0,
3194,11/5/2022,25.723287671232878,L,0,2.5,0,2,0.0,0,0,,0,0,,0,0,0,0,0,0,0,0,0,-1.4,-5.0,Eugene Omoruyi,0,2,0.0
3195,11/11/2022,25.73972602739726,W,0,27.0,8,10,0.8,5,6,0.833,1,2,0.5,0,3,3,1,1,0,2,5,22,16.4,12.0,Eugene Omoruyi,3,4,0.75
3196,11/21/2022,25.767123287671232,L,0,14.5,1,3,0.333,0,1,0.0,0,0,,0,0,0,0,1,0,1,2,2,-0.5,6.0,Eugene Omoruyi,1,2,0.5
3197,11/23/2022,25.77260273972603,L,0,12.033333333333333,1,4,0.25,0,1,0.0,0,0,,1,1,2,0,1,0,0,2,2,0.8,-13.0,Eugene Omoruyi,1,3,0.3333333333333333
3198,10/23/2022,20.317808219178083,L,0,7.616666666666667,2,4,0.5,0,0,,0,1,0.0,3,3,6,2,0,0,0,2,4,5.2,13.0,Jaylin Williams,2,4,0.5
3199,11/5/2022,20.353424657534248,L,0,5.133333333333334,1,3,0.333,0,1,0.0,0,0,,1,0,1,0,1,0,0,0,2,2.0,5.0,Jaylin Williams,1,2,0.5
3200,11/14/2022,20.378082191780823,L,0,8.183333333333334,1,2,0.5,0,1,0.0,0,0,,1,2,3,0,0,0,0,1,2,1.9,0.0,Jaylin Williams,1,1,1.0
3201,11/16/2022,20.383561643835616,W,0,6.0,0,1,0.0,0,0,,0,0,,0,0,0,1,0,0,1,1,0,-1.4,-2.0,Jaylin Williams,0,1,0.0
3202,11/18/2022,20.389041095890413,L,0,8.0,1,1,1.0,0,0,,4,5,0.8,0,0,0,0,0,0,1,2,6,3.5,-5.0,Jaylin Williams,1,1,1.0
3203,10/19/2022,25.96986301369863,W,1,40.61666666666667,10,20,0.5,1,1,1.0,7,7,1.0,1,3,4,9,0,1,2,3,28,23.4,20.0,Devin Booker,9,19,0.47368421052631576
3204,10/21/2022,25.975342465753425,L,1,43.916666666666664,11,23,0.478,3,7,0.429,8,9,0.889,0,5,5,3,1,0,2,1,33,23.1,-2.0,Devin Booker,8,16,0.5
3205,10/23/2022,25.980821917808218,W,1,34.81666666666667,13,21,0.619,5,9,0.556,4,4,1.0,1,0,1,4,1,0,3,1,35,26.6,13.0,Devin Booker,8,12,0.6666666666666666
3206,10/25/2022,25.986301369863014,W,1,35.31666666666667,10,19,0.526,3,8,0.375,11,14,0.786,1,1,2,7,3,0,3,3,34,28.2,32.0,Devin Booker,7,11,0.6363636363636364
3207,10/28/2022,25.994520547945207,W,1,32.6,6,14,0.429,0,4,0.0,4,4,1.0,0,5,5,4,0,0,5,1,16,7.5,4.0,Devin Booker,6,10,0.6
3208,10/30/2022,26.0,W,1,35.4,14,24,0.583,1,7,0.143,1,3,0.333,1,2,3,6,1,0,1,2,30,22.7,11.0,Devin Booker,13,17,0.7647058823529411
3209,11/1/2022,26.005479452054793,W,1,30.433333333333334,6,18,0.333,2,7,0.286,4,5,0.8,1,6,7,5,0,1,2,5,18,10.1,11.0,Devin Booker,4,11,0.36363636363636365
3210,11/4/2022,26.013698630136986,L,1,38.36666666666667,8,21,0.381,3,7,0.429,6,6,1.0,0,5,5,5,1,1,5,3,25,14.0,3.0,Devin Booker,5,14,0.35714285714285715
3211,11/5/2022,26.016438356164382,W,1,29.166666666666668,9,20,0.45,2,7,0.286,4,4,1.0,1,2,3,3,1,2,1,2,24,17.6,19.0,Devin Booker,7,13,0.5384615384615384
3212,11/7/2022,26.02191780821918,L,1,43.4,8,16,0.5,1,1,1.0,11,14,0.786,2,5,7,5,1,0,6,2,28,19.4,-9.0,Devin Booker,7,15,0.4666666666666667
3213,11/9/2022,26.027397260273972,W,1,38.166666666666664,12,23,0.522,5,7,0.714,3,3,1.0,0,4,4,10,2,0,1,2,32,29.1,26.0,Devin Booker,7,16,0.4375
3214,11/11/2022,26.03287671232877,L,1,34.46666666666667,6,19,0.316,2,8,0.25,3,3,1.0,3,5,8,6,1,0,2,2,17,12.1,-27.0,Devin Booker,4,11,0.36363636363636365
3215,11/14/2022,26.041095890410958,L,1,41.56666666666667,11,22,0.5,2,7,0.286,1,2,0.5,2,6,8,5,3,1,2,5,25,20.0,-7.0,Devin Booker,9,15,0.6
3216,11/16/2022,26.046575342465754,W,1,36.63333333333333,8,17,0.471,2,5,0.4,9,9,1.0,0,2,2,9,0,3,3,2,27,23.5,6.0,Devin Booker,6,12,0.5
3217,11/18/2022,26.052054794520547,L,1,41.28333333333333,16,31,0.516,2,9,0.222,15,15,1.0,1,7,8,10,1,0,1,3,49,42.3,-4.0,Devin Booker,14,22,0.6363636363636364
3218,11/20/2022,26.057534246575344,W,1,29.516666666666666,7,17,0.412,5,8,0.625,1,1,1.0,1,4,5,3,0,0,0,0,20,14.9,13.0,Devin Booker,2,9,0.2222222222222222
3219,11/22/2022,26.063013698630137,W,1,35.45,10,24,0.417,2,6,0.333,3,3,1.0,1,3,4,5,0,0,4,6,25,10.9,4.0,Devin Booker,8,18,0.4444444444444444
3220,11/25/2022,26.07123287671233,W,1,35.7,8,17,0.471,2,7,0.286,3,7,0.429,0,7,7,5,1,1,2,2,21,15.2,10.0,Devin Booker,6,10,0.6
3221,11/26/2022,26.073972602739726,W,1,39.35,8,27,0.296,1,7,0.143,10,11,0.909,4,7,11,7,0,0,2,3,27,17.5,-4.0,Devin Booker,7,20,0.35
3222,10/19/2022,26.136986301369863,W,1,41.083333333333336,5,10,0.5,0,2,0.0,3,4,0.75,3,8,11,1,0,1,2,4,13,9.9,15.0,Mikal Bridges,5,8,0.625
3223,10/21/2022,26.14246575342466,L,1,37.68333333333333,6,10,0.6,0,0,,1,2,0.5,2,5,7,6,1,0,3,4,13,11.5,6.0,Mikal Bridges,6,10,0.6
3224,10/23/2022,26.147945205479452,W,1,36.483333333333334,3,9,0.333,1,3,0.333,0,0,,1,3,4,4,0,1,1,3,7,4.8,9.0,Mikal Bridges,2,6,0.3333333333333333
3225,10/25/2022,26.153424657534245,W,1,32.9,7,8,0.875,0,0,,3,3,1.0,3,3,6,2,1,2,1,3,17,18.8,21.0,Mikal Bridges,7,8,0.875
3226,10/28/2022,26.161643835616438,W,1,31.133333333333333,10,13,0.769,3,5,0.6,4,4,1.0,0,2,2,4,1,3,1,1,27,27.0,-1.0,Mikal Bridges,7,8,0.875
3227,10/30/2022,26.167123287671235,W,1,32.8,5,7,0.714,2,3,0.667,3,4,0.75,1,4,5,1,0,1,1,3,15,12.8,12.0,Mikal Bridges,3,4,0.75
3228,11/1/2022,26.172602739726027,W,1,38.2,7,10,0.7,1,2,0.5,4,4,1.0,2,1,3,4,1,1,1,1,19,19.6,20.0,Mikal Bridges,6,8,0.75
3229,11/4/2022,26.18082191780822,L,1,37.71666666666667,4,9,0.444,2,3,0.667,2,2,1.0,0,5,5,2,2,0,1,2,12,10.4,7.0,Mikal Bridges,2,6,0.3333333333333333
3230,11/5/2022,26.183561643835617,W,1,27.0,3,7,0.429,1,2,0.5,4,5,0.8,0,1,1,2,2,1,0,0,11,11.3,18.0,Mikal Bridges,2,5,0.4
3231,11/7/2022,26.18904109589041,L,1,43.516666666666666,6,12,0.5,1,2,0.5,2,2,1.0,0,5,5,1,0,1,0,1,15,11.5,-14.0,Mikal Bridges,5,10,0.5
3232,11/9/2022,26.194520547945206,W,1,42.31666666666667,12,20,0.6,2,6,0.333,5,5,1.0,2,7,9,5,4,1,2,1,31,31.1,12.0,Mikal Bridges,10,14,0.7142857142857143
3233,11/11/2022,26.2,L,1,37.63333333333333,3,13,0.231,2,6,0.333,0,0,,1,3,4,6,0,0,1,2,8,4.1,-16.0,Mikal Bridges,1,7,0.14285714285714285
3234,11/14/2022,26.208219178082192,L,1,40.86666666666667,7,14,0.5,1,3,0.333,0,0,,1,4,5,2,1,1,1,1,15,11.6,-1.0,Mikal Bridges,6,11,0.5454545454545454
3235,11/16/2022,26.213698630136985,W,1,41.78333333333333,6,11,0.545,5,8,0.625,6,6,1.0,2,7,9,9,1,0,2,3,23,25.3,23.0,Mikal Bridges,1,3,0.3333333333333333
3236,11/18/2022,26.21917808219178,L,1,34.78333333333333,6,12,0.5,0,2,0.0,1,2,0.5,0,6,6,2,2,3,2,3,13,10.7,0.0,Mikal Bridges,6,10,0.6
3237,11/20/2022,26.224657534246575,W,1,32.63333333333333,6,11,0.545,1,3,0.333,0,0,,1,5,6,5,2,1,1,1,13,14.7,16.0,Mikal Bridges,5,8,0.625
3238,11/22/2022,26.23013698630137,W,1,41.4,10,17,0.588,5,7,0.714,0,0,,0,6,6,3,1,1,0,3,25,21.5,6.0,Mikal Bridges,5,10,0.5
3239,11/25/2022,26.23835616438356,W,1,34.666666666666664,6,17,0.353,3,6,0.5,0,0,,1,1,2,2,2,0,1,4,15,7.3,3.0,Mikal Bridges,3,11,0.2727272727272727
3240,11/26/2022,26.24109589041096,W,1,40.88333333333333,7,10,0.7,0,1,0.0,2,2,1.0,0,3,3,2,1,0,0,2,16,14.3,3.0,Mikal Bridges,7,9,0.7777777777777778
3241,10/19/2022,29.994520547945207,W,0,19.766666666666666,4,8,0.5,3,5,0.6,0,0,,0,2,2,2,0,0,0,2,11,8.2,-7.0,Damion Lee,1,3,0.3333333333333333
3242,10/21/2022,30.0,L,0,30.833333333333332,2,6,0.333,2,4,0.5,2,3,0.667,2,4,6,3,2,0,0,5,8,8.9,3.0,Damion Lee,0,2,0.0
3243,10/23/2022,30.005479452054793,W,0,12.216666666666667,1,3,0.333,0,2,0.0,0,0,,0,1,1,1,0,0,0,1,2,0.9,6.0,Damion Lee,1,1,1.0
3244,10/25/2022,30.01095890410959,W,0,15.333333333333334,2,5,0.4,1,2,0.5,0,0,,0,1,1,1,0,0,0,0,5,3.3,-5.0,Damion Lee,1,3,0.3333333333333333
3245,10/28/2022,30.019178082191782,W,0,15.516666666666667,1,5,0.2,1,4,0.25,0,0,,0,3,3,0,1,0,1,1,3,0.4,20.0,Damion Lee,0,1,0.0
3246,10/30/2022,30.024657534246575,W,0,11.583333333333334,0,1,0.0,0,1,0.0,5,5,1.0,1,2,3,0,0,0,0,1,5,5.2,4.0,Damion Lee,0,0,
3247,11/1/2022,30.03013698630137,W,0,10.283333333333333,0,2,0.0,0,1,0.0,0,0,,0,0,0,1,0,0,1,0,0,-1.7,-1.0,Damion Lee,0,1,0.0
3248,11/4/2022,30.03835616438356,L,0,20.416666666666668,4,8,0.5,3,5,0.6,2,2,1.0,1,1,2,0,1,0,1,2,13,9.2,-6.0,Damion Lee,1,3,0.3333333333333333
3249,11/5/2022,30.041095890410958,W,0,27.916666666666668,3,5,0.6,2,2,1.0,1,2,0.5,1,3,4,1,0,0,0,1,9,8.2,-1.0,Damion Lee,1,3,0.3333333333333333
3250,11/7/2022,30.046575342465754,L,0,25.5,3,6,0.5,2,4,0.5,2,2,1.0,0,5,5,2,2,0,1,4,10,9.3,-7.0,Damion Lee,1,2,0.5
3251,11/9/2022,30.052054794520547,W,0,15.516666666666667,1,5,0.2,1,4,0.25,0,0,,0,0,0,1,0,0,1,1,3,-0.8,-14.0,Damion Lee,0,1,0.0
3252,11/11/2022,30.057534246575344,L,0,22.466666666666665,3,6,0.5,2,5,0.4,0,0,,0,2,2,1,1,0,1,1,8,5.9,6.0,Damion Lee,1,1,1.0
3253,11/14/2022,30.065753424657533,L,0,20.533333333333335,5,9,0.556,4,7,0.571,0,0,,0,3,3,1,1,0,1,1,14,10.9,7.0,Damion Lee,1,2,0.5
3254,11/16/2022,30.07123287671233,W,0,27.35,3,4,0.75,3,3,1.0,0,0,,0,8,8,0,0,0,1,2,9,8.0,11.0,Damion Lee,0,1,0.0
3255,11/18/2022,30.076712328767123,L,0,26.666666666666668,2,6,0.333,2,5,0.4,0,0,,2,2,4,1,0,0,1,1,6,3.9,8.0,Damion Lee,0,1,0.0
3256,11/20/2022,30.08219178082192,W,0,22.95,4,8,0.5,4,6,0.667,3,3,1.0,1,3,4,4,0,1,0,1,15,15.7,14.0,Damion Lee,0,2,0.0
3257,11/22/2022,30.087671232876712,W,0,20.5,3,6,0.5,3,5,0.6,0,0,,1,6,7,2,0,0,1,0,9,8.9,7.0,Damion Lee,0,1,0.0
3258,11/25/2022,30.095890410958905,W,0,25.4,3,9,0.333,1,5,0.2,2,2,1.0,4,1,5,3,1,0,2,1,9,7.7,3.0,Damion Lee,2,4,0.5
3259,11/26/2022,30.0986301369863,W,0,18.35,3,5,0.6,2,3,0.667,0,0,,0,3,3,1,0,0,0,1,8,6.9,9.0,Damion Lee,1,2,0.5
3260,10/19/2022,31.832876712328765,W,0,8.633333333333333,1,1,1.0,0,0,,0,0,,1,0,1,0,0,0,0,1,2,2.0,-7.0,Torrey Craig,1,1,1.0
3261,10/21/2022,31.838356164383562,L,0,10.5,1,3,0.333,1,3,0.333,0,0,,0,1,1,1,1,0,1,0,3,2.3,-3.0,Torrey Craig,0,0,
3262,10/23/2022,31.843835616438355,W,0,24.833333333333332,3,7,0.429,2,5,0.4,0,0,,3,6,9,2,0,0,0,1,8,9.2,1.0,Torrey Craig,1,2,0.5
3263,10/25/2022,31.84931506849315,W,0,10.483333333333333,3,4,0.75,2,3,0.667,0,0,,0,2,2,0,1,0,0,0,8,8.0,0.0,Torrey Craig,1,1,1.0
3264,10/28/2022,31.85753424657534,W,0,17.3,6,6,1.0,1,1,1.0,0,0,,4,2,6,2,0,0,1,1,13,14.6,7.0,Torrey Craig,5,5,1.0
3265,10/30/2022,31.863013698630137,W,0,18.316666666666666,0,1,0.0,0,1,0.0,0,0,,2,0,2,1,0,1,1,3,0,-0.1,-1.0,Torrey Craig,0,0,
3266,11/1/2022,31.86849315068493,W,0,11.683333333333334,1,2,0.5,1,2,0.5,1,2,0.5,1,3,4,1,0,0,0,3,4,3.7,-12.0,Torrey Craig,0,0,
3267,11/4/2022,31.876712328767123,L,0,23.066666666666666,3,7,0.429,1,4,0.25,1,2,0.5,2,4,6,2,0,0,0,3,8,6.7,-4.0,Torrey Craig,2,3,0.6666666666666666
3268,11/5/2022,31.87945205479452,W,1,21.633333333333333,2,5,0.4,1,3,0.333,0,0,,0,5,5,4,1,3,1,4,5,7.1,22.0,Torrey Craig,1,2,0.5
3269,11/7/2022,31.884931506849316,L,1,22.5,1,6,0.167,1,4,0.25,0,0,,0,1,1,1,1,1,1,1,3,0.5,-5.0,Torrey Craig,0,2,0.0
3270,11/9/2022,31.89041095890411,W,1,26.05,2,5,0.4,2,3,0.667,0,0,,2,3,5,1,1,0,2,4,6,3.7,-6.0,Torrey Craig,0,2,0.0
3271,11/11/2022,31.895890410958906,L,1,34.96666666666667,3,8,0.375,1,4,0.25,2,2,1.0,2,2,4,1,1,1,1,2,9,7.2,-19.0,Torrey Craig,2,4,0.5
3272,11/14/2022,31.904109589041095,L,1,32.68333333333333,4,10,0.4,1,3,0.333,1,2,0.5,7,2,9,2,1,1,1,4,10,10.2,-7.0,Torrey Craig,3,7,0.42857142857142855
3273,11/16/2022,31.90958904109589,W,1,29.6,5,8,0.625,3,6,0.5,0,0,,1,9,10,2,2,1,1,1,13,15.5,10.0,Torrey Craig,2,2,1.0
3274,11/18/2022,31.915068493150685,L,1,27.533333333333335,6,10,0.6,3,5,0.6,1,1,1.0,2,4,6,2,1,0,1,5,16,13.4,-8.0,Torrey Craig,3,5,0.6
3275,11/20/2022,31.92054794520548,W,1,25.15,5,9,0.556,2,4,0.5,2,2,1.0,1,3,4,3,0,2,1,4,14,12.2,0.0,Torrey Craig,3,5,0.6
3276,11/22/2022,31.926027397260274,W,1,29.583333333333332,3,7,0.429,2,4,0.5,0,0,,1,4,5,0,3,2,0,2,8,9.8,0.0,Torrey Craig,1,3,0.3333333333333333
3277,11/25/2022,31.934246575342467,W,1,33.13333333333333,1,7,0.143,0,4,0.0,0,0,,2,5,7,1,0,2,1,3,2,0.3,6.0,Torrey Craig,1,3,0.3333333333333333
3278,11/26/2022,31.936986301369863,W,1,26.85,4,8,0.5,0,2,0.0,2,2,1.0,3,4,7,1,0,2,1,4,10,8.8,2.0,Torrey Craig,4,6,0.6666666666666666
3279,10/19/2022,24.24109589041096,W,1,30.416666666666668,8,11,0.727,0,0,,2,3,0.667,1,9,10,2,1,0,1,4,18,16.3,15.0,Deandre Ayton,8,11,0.7272727272727273
3280,10/21/2022,24.246575342465754,L,1,38.483333333333334,12,22,0.545,1,1,1.0,1,3,0.333,1,5,6,3,1,1,4,5,26,14.6,1.0,Deandre Ayton,11,21,0.5238095238095238
3281,10/23/2022,24.252054794520546,W,1,28.75,6,11,0.545,0,1,0.0,1,1,1.0,2,6,8,1,0,1,4,5,13,6.3,7.0,Deandre Ayton,6,10,0.6
3282,10/25/2022,24.257534246575343,W,1,25.066666666666666,6,14,0.429,0,1,0.0,4,4,1.0,5,9,14,4,1,0,4,5,16,12.6,2.0,Deandre Ayton,6,13,0.46153846153846156
3283,10/28/2022,24.265753424657536,W,1,7.7,2,4,0.5,0,0,,0,0,,1,2,3,0,0,0,0,0,4,3.3,-5.0,Deandre Ayton,2,4,0.5
3284,11/4/2022,24.284931506849315,L,1,29.5,10,14,0.714,2,2,1.0,2,2,1.0,4,4,8,1,0,0,4,5,24,16.9,3.0,Deandre Ayton,8,12,0.6666666666666666
3285,11/5/2022,24.28767123287671,W,1,15.883333333333333,3,6,0.5,0,1,0.0,1,2,0.5,2,4,6,1,0,2,1,3,7,6.1,1.0,Deandre Ayton,3,5,0.6
3286,11/7/2022,24.293150684931508,L,1,30.6,6,11,0.545,0,0,,2,2,1.0,3,4,7,0,1,1,0,4,14,12.1,-13.0,Deandre Ayton,6,11,0.5454545454545454
3287,11/9/2022,24.2986301369863,W,1,32.96666666666667,4,10,0.4,0,0,,1,2,0.5,2,4,6,2,0,0,2,1,9,4.8,16.0,Deandre Ayton,4,10,0.4
3288,11/11/2022,24.304109589041097,L,1,26.383333333333333,7,12,0.583,0,1,0.0,0,0,,1,4,5,1,2,1,1,0,14,12.7,-23.0,Deandre Ayton,7,11,0.6363636363636364
3289,11/14/2022,24.312328767123287,L,1,34.36666666666667,8,10,0.8,0,1,0.0,0,0,,8,4,12,2,1,0,3,5,16,16.4,-8.0,Deandre Ayton,8,9,0.8888888888888888
3290,11/16/2022,24.317808219178083,W,1,31.516666666666666,7,14,0.5,0,0,,0,0,,2,5,7,2,0,0,4,3,14,6.1,16.0,Deandre Ayton,7,14,0.5
3291,11/18/2022,24.323287671232876,L,1,36.63333333333333,7,12,0.583,0,1,0.0,3,3,1.0,5,5,10,8,0,3,2,3,17,20.9,0.0,Deandre Ayton,7,11,0.6363636363636364
3292,11/20/2022,24.328767123287673,W,1,26.8,6,9,0.667,0,1,0.0,1,5,0.2,4,7,11,4,1,0,0,3,13,15.0,6.0,Deandre Ayton,6,8,0.75
3293,11/22/2022,24.334246575342465,W,1,31.55,7,11,0.636,0,1,0.0,0,0,,1,14,15,2,1,0,0,4,14,14.8,9.0,Deandre Ayton,7,10,0.7
3294,11/25/2022,24.34246575342466,W,1,29.966666666666665,11,13,0.846,0,0,,6,7,0.857,2,10,12,1,0,2,0,0,28,29.4,13.0,Deandre Ayton,11,13,0.8461538461538461
3295,11/26/2022,24.345205479452055,W,1,34.13333333333333,11,19,0.579,0,0,,7,9,0.778,9,12,21,3,1,2,2,1,29,31.3,-4.0,Deandre Ayton,11,19,0.5789473684210527
3296,10/19/2022,28.197260273972603,W,0,18.8,3,7,0.429,1,2,0.5,0,0,,1,0,1,1,1,0,2,3,7,2.5,15.0,Cameron Payne,2,5,0.4
3297,10/21/2022,28.202739726027396,L,0,16.833333333333332,1,3,0.333,1,3,0.333,2,2,1.0,0,2,2,1,0,0,2,2,5,1.8,-2.0,Cameron Payne,0,0,
3298,10/23/2022,28.208219178082192,W,0,14.566666666666666,4,11,0.364,1,3,0.333,1,2,0.5,0,1,1,2,1,0,2,0,10,4.2,0.0,Cameron Payne,3,8,0.375
3299,10/25/2022,28.213698630136985,W,0,13.5,3,6,0.5,0,0,,2,2,1.0,0,4,4,5,0,0,1,1,8,8.3,8.0,Cameron Payne,3,6,0.5
3300,10/28/2022,28.221917808219178,W,0,17.366666666666667,5,10,0.5,2,3,0.667,0,0,,1,1,2,5,1,1,1,0,12,12.2,16.0,Cameron Payne,3,7,0.42857142857142855
3301,10/30/2022,28.22739726027397,W,0,16.766666666666666,5,12,0.417,2,7,0.286,0,0,,0,2,2,4,4,0,3,0,12,10.0,-4.0,Cameron Payne,3,5,0.6
3302,11/1/2022,28.232876712328768,W,0,14.133333333333333,3,8,0.375,2,5,0.4,0,0,,0,2,2,2,1,0,2,1,8,4.2,-9.0,Cameron Payne,1,3,0.3333333333333333
3303,11/7/2022,28.24931506849315,L,0,27.716666666666665,6,14,0.429,1,4,0.25,1,2,0.5,0,2,2,5,0,0,3,4,14,5.7,-11.0,Cameron Payne,5,10,0.5
3304,11/9/2022,28.254794520547946,W,1,35.016666666666666,8,17,0.471,4,9,0.444,3,3,1.0,1,5,6,8,1,0,0,1,23,22.7,10.0,Cameron Payne,4,8,0.5
3305,11/11/2022,28.26027397260274,L,1,35.0,8,15,0.533,5,10,0.5,1,1,1.0,0,3,3,4,1,0,4,3,22,14.2,-17.0,Cameron Payne,3,5,0.6
3306,11/14/2022,28.268493150684932,L,1,30.7,4,17,0.235,1,6,0.167,0,0,,0,3,3,5,1,0,1,4,9,1.5,-13.0,Cameron Payne,3,11,0.2727272727272727
3307,11/16/2022,28.273972602739725,W,1,33.016666666666666,9,17,0.529,6,10,0.6,5,6,0.833,0,3,3,7,0,1,2,5,29,22.8,11.0,Cameron Payne,3,7,0.42857142857142855
3308,11/18/2022,28.279452054794522,L,1,33.6,6,12,0.5,2,4,0.5,3,4,0.75,0,0,0,5,3,0,4,4,17,11.5,3.0,Cameron Payne,4,8,0.5
3309,11/20/2022,28.284931506849315,W,1,32.083333333333336,7,14,0.5,2,5,0.4,5,5,1.0,1,6,7,9,0,2,2,1,21,21.8,15.0,Cameron Payne,5,9,0.5555555555555556
3310,11/22/2022,28.29041095890411,W,1,28.3,5,15,0.333,1,3,0.333,0,0,,1,1,2,7,1,0,5,5,11,2.4,12.0,Cameron Payne,4,12,0.3333333333333333
3311,11/25/2022,28.2986301369863,W,1,31.516666666666666,7,12,0.583,0,2,0.0,2,4,0.5,1,1,2,10,1,0,2,1,16,16.2,8.0,Cameron Payne,7,10,0.7
3312,11/26/2022,28.301369863013697,W,1,30.066666666666666,4,13,0.308,1,6,0.167,2,4,0.5,0,0,0,6,1,0,0,4,11,6.3,-1.0,Cameron Payne,3,7,0.42857142857142855
3313,10/19/2022,24.13150684931507,W,0,3.95,0,2,0.0,0,2,0.0,0,0,,0,1,1,0,0,0,0,1,0,-1.5,-8.0,Josh Okogie,0,0,
3314,10/21/2022,24.136986301369863,L,0,13.6,1,2,0.5,0,0,,0,0,,1,2,3,0,1,0,0,2,2,2.5,-5.0,Josh Okogie,1,2,0.5
3315,10/23/2022,24.14246575342466,W,0,1.2333333333333334,0,0,,0,0,,2,2,1.0,0,1,1,0,0,0,0,0,2,2.3,2.0,Josh Okogie,0,0,
3316,10/25/2022,24.147945205479452,W,0,1.5166666666666666,1,1,1.0,0,0,,0,0,,0,0,0,0,0,0,0,0,2,1.7,5.0,Josh Okogie,1,1,1.0
3317,10/28/2022,24.156164383561645,W,0,1.6333333333333333,0,0,,0,0,,0,0,,2,1,3,0,0,0,0,0,0,1.7,-1.0,Josh Okogie,0,0,
3318,10/30/2022,24.161643835616438,W,0,1.0166666666666666,1,1,1.0,0,0,,0,0,,0,0,0,0,0,0,0,0,2,1.7,0.0,Josh Okogie,1,1,1.0
3319,11/4/2022,24.175342465753424,L,0,5.066666666666666,0,0,,0,0,,0,0,,0,1,1,0,1,0,1,0,0,0.3,-7.0,Josh Okogie,0,0,
3320,11/5/2022,24.17808219178082,W,0,16.183333333333334,1,4,0.25,0,2,0.0,2,4,0.5,0,3,3,0,1,1,3,3,4,-0.8,2.0,Josh Okogie,1,2,0.5
3321,11/7/2022,24.183561643835617,L,0,1.3166666666666667,0,1,0.0,0,1,0.0,0,0,,0,0,0,0,0,0,0,0,0,-0.7,1.0,Josh Okogie,0,0,
3322,11/9/2022,24.18904109589041,W,0,3.2333333333333334,0,1,0.0,0,1,0.0,0,0,,0,0,0,0,0,0,0,0,0,-0.7,6.0,Josh Okogie,0,0,
3323,11/11/2022,24.194520547945206,L,0,7.816666666666666,0,2,0.0,0,1,0.0,0,0,,0,1,1,0,0,1,1,1,0,-1.8,4.0,Josh Okogie,0,1,0.0
3324,11/14/2022,24.202739726027396,L,0,6.6,0,0,,0,0,,0,0,,0,1,1,1,1,0,0,1,0,1.6,5.0,Josh Okogie,0,0,
3325,11/16/2022,24.208219178082192,W,0,8.633333333333333,0,2,0.0,0,1,0.0,0,0,,2,0,2,2,1,1,0,3,0,1.9,-6.0,Josh Okogie,0,1,0.0
3326,11/18/2022,24.213698630136985,L,0,3.0,0,0,,0,0,,0,0,,0,1,1,0,0,0,1,3,0,-1.9,2.0,Josh Okogie,0,0,
3327,11/20/2022,24.21917808219178,W,0,13.333333333333334,3,9,0.333,1,3,0.333,0,0,,3,2,5,1,0,1,2,3,7,2.8,3.0,Josh Okogie,2,6,0.3333333333333333
3328,11/22/2022,24.224657534246575,W,0,6.916666666666667,0,2,0.0,0,1,0.0,0,0,,1,1,2,1,0,0,1,0,0,-0.7,-1.0,Josh Okogie,0,1,0.0
3329,11/25/2022,24.232876712328768,W,0,14.15,2,4,0.5,0,2,0.0,3,4,0.75,1,1,2,1,2,1,0,2,7,8.2,-3.0,Josh Okogie,2,2,1.0
3330,10/19/2022,26.983561643835618,W,0,10.15,2,5,0.4,0,2,0.0,3,4,0.75,1,1,2,0,0,1,1,4,7,3.0,-6.0,Jock Landale,2,3,0.6666666666666666
3331,10/21/2022,26.98904109589041,L,0,14.466666666666667,2,5,0.4,1,2,0.5,1,2,0.5,2,2,4,0,0,0,1,4,6,2.3,-3.0,Jock Landale,1,3,0.3333333333333333
3332,10/23/2022,26.994520547945207,W,0,17.316666666666666,4,8,0.5,0,2,0.0,1,1,1.0,2,8,10,1,0,0,0,0,9,9.5,13.0,Jock Landale,4,6,0.6666666666666666
3333,10/25/2022,27.0,W,0,22.15,6,12,0.5,1,4,0.25,4,5,0.8,2,5,7,0,0,2,1,1,17,13.5,27.0,Jock Landale,5,8,0.625
3334,10/28/2022,27.008219178082193,W,0,17.0,4,9,0.444,0,4,0.0,0,0,,0,2,2,2,0,1,0,2,8,5.2,18.0,Jock Landale,4,5,0.8
3335,10/30/2022,27.013698630136986,W,0,23.45,6,9,0.667,0,1,0.0,4,4,1.0,5,2,7,0,1,1,2,5,16,13.9,0.0,Jock Landale,6,8,0.75
3336,11/1/2022,27.019178082191782,W,0,16.45,2,6,0.333,0,4,0.0,0,0,,0,1,1,1,0,1,0,4,4,0.7,-4.0,Jock Landale,2,2,1.0
3337,11/4/2022,27.027397260273972,L,0,14.716666666666667,3,3,1.0,1,1,1.0,2,2,1.0,4,2,6,1,0,0,2,2,9,9.4,3.0,Jock Landale,2,2,1.0
3338,11/5/2022,27.03013698630137,W,0,18.3,2,4,0.5,0,1,0.0,1,2,0.5,2,1,3,4,1,1,2,1,5,6.4,17.0,Jock Landale,2,3,0.6666666666666666
3339,11/7/2022,27.035616438356165,L,0,6.8,1,2,0.5,0,0,,0,0,,0,2,2,1,1,2,0,5,2,2.7,-3.0,Jock Landale,1,2,0.5
3340,11/9/2022,27.041095890410958,W,0,12.0,1,5,0.2,0,1,0.0,2,2,1.0,1,3,4,1,1,1,0,5,4,2.9,-2.0,Jock Landale,1,4,0.25
3341,11/11/2022,27.046575342465754,L,0,13.15,3,4,0.75,0,1,0.0,1,2,0.5,2,4,6,0,0,0,0,0,7,7.6,5.0,Jock Landale,3,3,1.0
3342,11/14/2022,27.054794520547944,L,0,8.416666666666666,1,3,0.333,0,1,0.0,0,0,,2,1,3,0,0,0,0,0,2,2.0,6.0,Jock Landale,1,2,0.5
3343,11/16/2022,27.06027397260274,W,0,16.483333333333334,3,5,0.6,0,1,0.0,1,2,0.5,1,3,4,0,1,2,2,3,7,5.1,-5.0,Jock Landale,3,4,0.75
3344,11/18/2022,27.065753424657533,L,0,11.366666666666667,3,4,0.75,0,1,0.0,1,1,1.0,0,0,0,0,0,0,1,0,7,4.4,-1.0,Jock Landale,3,3,1.0
3345,11/26/2022,27.087671232876712,W,0,5.4,2,2,1.0,0,0,,0,0,,1,0,1,1,0,0,0,0,4,4.8,7.0,Jock Landale,2,2,1.0
3346,10/19/2022,30.14246575342466,W,0,7.433333333333334,0,1,0.0,0,0,,0,0,,0,2,2,1,0,0,1,2,0,-1.2,-7.0,Bismack Biyombo,0,1,0.0
3347,10/21/2022,30.147945205479452,L,0,0.016666666666666666,0,0,,0,0,,0,0,,0,0,0,0,0,0,0,0,0,0.0,0.0,Bismack Biyombo,0,0,
3348,10/28/2022,30.167123287671235,W,0,23.3,5,7,0.714,0,0,,1,2,0.5,4,9,13,2,0,2,0,5,11,14.0,0.0,Bismack Biyombo,5,7,0.7142857142857143
3349,10/30/2022,30.172602739726027,W,1,21.983333333333334,1,1,1.0,0,0,,3,5,0.6,0,5,5,0,0,5,2,3,5,5.7,12.0,Bismack Biyombo,1,1,1.0
3350,11/1/2022,30.17808219178082,W,1,29.833333333333332,4,5,0.8,0,0,,0,0,,1,3,4,1,0,4,1,2,8,9.4,11.0,Bismack Biyombo,4,5,0.8
3351,11/4/2022,30.186301369863013,L,0,3.716666666666667,1,3,0.333,0,0,,0,0,,0,1,1,0,0,2,0,0,2,2.0,-8.0,Bismack Biyombo,1,3,0.3333333333333333
3352,11/5/2022,30.18904109589041,W,0,13.816666666666666,1,4,0.25,0,0,,1,1,1.0,1,3,4,0,0,3,2,3,3,1.1,2.0,Bismack Biyombo,1,4,0.25
3353,11/7/2022,30.194520547945206,L,0,10.6,0,0,,0,0,,0,0,,1,3,4,1,0,0,0,1,0,1.9,4.0,Bismack Biyombo,0,0,
3354,11/9/2022,30.2,W,0,3.033333333333333,0,0,,0,0,,0,0,,0,0,0,0,1,1,0,1,0,1.3,-2.0,Bismack Biyombo,0,0,
3355,11/11/2022,30.205479452054796,L,0,11.016666666666667,3,6,0.5,0,0,,1,1,1.0,1,1,2,1,1,1,0,2,7,6.6,-4.0,Bismack Biyombo,3,6,0.5
3356,11/14/2022,30.213698630136985,L,0,5.216666666666667,0,0,,0,0,,0,0,,0,1,1,0,0,1,1,1,0,-0.4,1.0,Bismack Biyombo,0,0,
3357,11/20/2022,30.23013698630137,W,0,21.2,2,6,0.333,0,0,,1,2,0.5,6,4,10,3,0,1,4,5,5,3.4,15.0,Bismack Biyombo,2,6,0.3333333333333333
3358,11/22/2022,30.235616438356164,W,0,16.45,1,3,0.333,0,0,,0,2,0.0,0,3,3,1,1,2,2,0,2,1.5,1.0,Bismack Biyombo,1,3,0.3333333333333333
3359,11/25/2022,30.243835616438357,W,0,18.033333333333335,2,3,0.667,0,0,,1,2,0.5,0,5,5,1,0,1,3,3,5,2.0,-7.0,Bismack Biyombo,2,3,0.6666666666666666
3360,11/26/2022,30.246575342465754,W,0,8.466666666666667,0,1,0.0,0,0,,0,2,0.0,0,0,0,2,2,1,0,1,0,2.2,-2.0,Bismack Biyombo,0,1,0.0
3361,10/23/2022,22.583561643835615,W,0,1.2333333333333334,0,1,0.0,0,0,,0,0,,0,0,0,0,0,0,0,0,0,-0.7,2.0,Duane Washington Jr.,0,1,0.0
3362,10/28/2022,22.5972602739726,W,0,1.6333333333333333,1,3,0.333,0,2,0.0,0,0,,0,0,0,0,0,0,0,0,2,0.3,-1.0,Duane Washington Jr.,1,1,1.0
3363,10/30/2022,22.602739726027398,W,0,1.0166666666666666,0,0,,0,0,,0,0,,0,0,0,0,0,0,0,0,0,0.0,0.0,Duane Washington Jr.,0,0,
3364,11/5/2022,22.61917808219178,W,0,5.433333333333334,1,5,0.2,0,2,0.0,0,0,,0,0,0,0,0,0,1,0,2,-2.1,-9.0,Duane Washington Jr.,1,3,0.3333333333333333
3365,11/11/2022,22.635616438356166,L,0,7.316666666666666,2,6,0.333,1,4,0.25,0,0,,0,0,0,1,0,0,0,1,5,1.9,-2.0,Duane Washington Jr.,1,2,0.5
3366,11/14/2022,22.643835616438356,L,0,19.05,8,14,0.571,5,8,0.625,0,0,,0,0,0,4,0,0,1,0,21,16.2,12.0,Duane Washington Jr.,3,6,0.5
3367,11/16/2022,22.649315068493152,W,0,13.55,2,6,0.333,1,4,0.25,0,2,0.0,0,2,2,2,0,0,0,0,5,2.8,-7.0,Duane Washington Jr.,1,2,0.5
3368,11/18/2022,22.654794520547945,L,0,12.566666666666666,2,4,0.5,0,2,0.0,0,0,,0,1,1,0,0,0,0,0,4,2.3,-4.0,Duane Washington Jr.,2,2,1.0
3369,11/20/2022,22.660273972602738,W,0,15.916666666666666,2,10,0.2,1,3,0.333,0,0,,0,1,1,1,0,0,1,2,5,-2.0,6.0,Duane Washington Jr.,1,7,0.14285714285714285
3370,11/22/2022,22.665753424657535,W,0,18.333333333333332,7,15,0.467,1,5,0.2,0,0,,0,2,2,1,1,0,2,0,15,7.6,1.0,Duane Washington Jr.,6,10,0.6
3371,11/25/2022,22.673972602739727,W,0,17.433333333333334,2,5,0.4,1,3,0.333,0,0,,0,1,1,1,0,0,2,2,5,0.5,-3.0,Duane Washington Jr.,1,2,0.5
3372,11/26/2022,22.676712328767124,W,0,4.083333333333333,0,2,0.0,0,1,0.0,0,0,,0,0,0,0,0,0,0,0,0,-1.4,-7.0,Duane Washington Jr.,0,1,0.0
3373,10/19/2022,37.45479452054794,W,1,30.283333333333335,1,6,0.167,0,2,0.0,4,4,1.0,0,3,3,9,2,0,3,3,6,7.2,-9.0,Chris Paul,1,4,0.25
3374,10/21/2022,37.46027397260274,L,1,36.15,5,11,0.455,0,1,0.0,0,0,,0,4,4,12,5,0,1,5,10,15.9,0.0,Chris Paul,5,10,0.5
3375,10/23/2022,37.465753424657535,W,1,32.61666666666667,3,11,0.273,1,8,0.125,0,0,,3,5,8,11,1,1,2,2,7,10.7,15.0,Chris Paul,2,3,0.6666666666666666
3376,10/25/2022,37.47123287671233,W,1,35.21666666666667,5,10,0.5,4,5,0.8,2,2,1.0,0,7,7,9,1,0,2,4,16,16.8,21.0,Chris Paul,1,5,0.2
3377,10/28/2022,37.47945205479452,W,1,30.633333333333333,1,7,0.143,0,1,0.0,5,6,0.833,1,4,5,9,1,0,3,1,7,7.9,-3.0,Chris Paul,1,6,0.16666666666666666
3378,10/30/2022,37.484931506849314,W,1,31.233333333333334,3,7,0.429,0,4,0.0,4,5,0.8,0,1,1,15,0,0,0,1,10,16.3,19.0,Chris Paul,3,3,1.0
3379,11/1/2022,37.49041095890411,W,1,33.86666666666667,5,12,0.417,1,5,0.2,4,6,0.667,1,7,8,12,3,0,1,2,15,20.2,18.0,Chris Paul,4,7,0.5714285714285714
3380,11/4/2022,37.4986301369863,L,1,33.8,1,4,0.25,1,3,0.333,4,4,1.0,0,2,2,11,2,1,0,2,7,14.8,4.0,Chris Paul,0,1,0.0
3381,11/5/2022,37.5013698630137,W,1,24.35,3,7,0.429,2,4,0.5,7,7,1.0,0,5,5,4,0,0,1,2,15,13.8,16.0,Chris Paul,1,3,0.3333333333333333
3382,11/7/2022,37.50684931506849,L,1,13.75,1,1,1.0,0,0,,0,0,,0,2,2,2,2,0,2,1,2,3.3,-10.0,Chris Paul,1,1,1.0
3383,10/23/2022,25.613698630136987,W,0,13.333333333333334,2,5,0.4,2,5,0.4,2,2,1.0,0,1,1,1,1,0,0,1,8,6.9,4.0,Landry Shamet,0,0,
3384,10/25/2022,25.61917808219178,W,0,15.133333333333333,1,2,0.5,0,0,,0,0,,0,0,0,1,1,0,1,2,2,0.9,8.0,Landry Shamet,1,2,0.5
3385,10/28/2022,25.627397260273973,W,0,17.283333333333335,2,4,0.5,1,3,0.333,0,0,,1,0,1,2,1,0,0,4,5,4.5,13.0,Landry Shamet,1,1,1.0
3386,10/30/2022,25.632876712328766,W,0,15.2,3,6,0.5,2,5,0.4,2,4,0.5,0,1,1,1,2,0,1,1,10,7.8,3.0,Landry Shamet,1,1,1.0
3387,11/1/2022,25.638356164383563,W,0,16.85,2,8,0.25,2,5,0.4,2,2,1.0,0,0,0,0,0,0,1,0,8,2.2,-6.0,Landry Shamet,0,3,0.0
3388,11/4/2022,25.646575342465752,L,0,19.25,2,8,0.25,1,5,0.2,1,1,1.0,1,0,1,2,0,0,2,1,6,0.9,-5.0,Landry Shamet,1,3,0.3333333333333333
3389,11/5/2022,25.649315068493152,W,0,19.316666666666666,3,6,0.5,2,4,0.5,0,0,,0,1,1,2,0,1,0,0,8,7.4,11.0,Landry Shamet,1,2,0.5
3390,11/7/2022,25.654794520547945,L,0,11.133333333333333,0,4,0.0,0,3,0.0,0,0,,0,1,1,1,0,0,0,1,0,-2.2,6.0,Landry Shamet,0,1,0.0
3391,11/9/2022,25.660273972602738,W,0,18.933333333333334,5,7,0.714,2,3,0.667,4,4,1.0,0,0,0,1,0,0,3,2,16,10.0,8.0,Landry Shamet,3,4,0.75
3392,11/26/2022,25.706849315068492,W,0,14.916666666666666,1,2,0.5,0,0,,0,0,,0,0,0,0,0,1,1,2,2,-0.1,-2.0,Landry Shamet,1,2,0.5
3393,10/19/2022,26.63013698630137,W,1,27.166666666666668,6,13,0.462,3,6,0.5,0,0,,0,3,3,0,0,2,0,2,15,9.8,-3.0,Cameron Johnson,3,7,0.42857142857142855
3394,10/21/2022,26.635616438356166,L,1,22.516666666666666,2,9,0.222,1,6,0.167,0,0,,1,2,3,2,2,0,2,1,5,1.8,-5.0,Cameron Johnson,1,3,0.3333333333333333
3395,10/23/2022,26.64109589041096,W,1,22.6,4,6,0.667,3,4,0.75,0,0,,1,4,5,2,1,0,0,4,11,11.1,13.0,Cameron Johnson,1,2,0.5
3396,10/25/2022,26.646575342465752,W,1,33.38333333333333,3,11,0.273,1,6,0.167,2,4,0.5,3,2,5,2,0,0,0,0,9,5.8,26.0,Cameron Johnson,2,5,0.4
3397,10/28/2022,26.654794520547945,W,1,26.9,5,10,0.5,2,6,0.333,4,4,1.0,0,2,2,3,2,0,0,2,16,14.9,-2.0,Cameron Johnson,3,4,0.75
3398,10/30/2022,26.660273972602738,W,1,31.233333333333334,7,15,0.467,5,11,0.455,0,0,,0,7,7,1,1,0,0,3,19,13.9,19.0,Cameron Johnson,2,4,0.5
3399,11/1/2022,26.665753424657535,W,1,33.25,10,17,0.588,7,11,0.636,2,3,0.667,0,2,2,3,3,1,0,1,29,26.7,17.0,Cameron Johnson,3,6,0.5
3400,11/4/2022,26.673972602739727,L,1,5.233333333333333,0,2,0.0,0,1,0.0,0,0,,0,0,0,1,0,0,0,1,0,-1.1,8.0,Cameron Johnson,0,1,0.0
3401,10/19/2022,28.53150684931507,W,0,1.6833333333333333,0,1,0.0,0,0,,0,0,,0,0,0,0,0,0,0,0,0,-0.7,-8.0,Dario Šarić,0,1,0.0
3402,11/1/2022,28.567123287671233,W,0,5.016666666666667,1,1,1.0,1,1,1.0,0,0,,1,2,3,1,1,0,0,1,3,5.3,0.0,Dario Šarić,0,0,
3403,11/4/2022,28.575342465753426,L,0,9.15,0,4,0.0,0,3,0.0,0,0,,1,1,2,1,1,0,1,1,0,-1.5,-8.0,Dario Šarić,0,1,0.0
3404,11/5/2022,28.578082191780823,W,0,21.0,4,9,0.444,1,2,0.5,0,1,0.0,4,5,9,1,1,0,2,3,9,6.7,2.0,Dario Šarić,3,7,0.42857142857142855
3405,11/7/2022,28.583561643835615,L,0,3.15,0,0,,0,0,,0,0,,0,1,1,0,0,0,0,0,0,0.3,1.0,Dario Šarić,0,0,
3406,11/9/2022,28.589041095890412,W,0,12.766666666666667,2,4,0.5,0,1,0.0,1,1,1.0,2,0,2,2,0,0,0,3,5,4.6,6.0,Dario Šarić,2,3,0.6666666666666666
3407,11/11/2022,28.594520547945205,L,0,9.783333333333333,0,4,0.0,0,2,0.0,0,0,,1,2,3,1,0,0,0,0,0,-0.8,8.0,Dario Šarić,0,2,0.0
3408,11/18/2022,28.613698630136987,L,0,12.566666666666666,1,3,0.333,0,1,0.0,2,2,1.0,2,4,6,1,0,0,1,3,4,3.4,-1.0,Dario Šarić,1,2,0.5
3409,11/16/2022,28.17808219178082,W,0,1.4333333333333333,1,2,0.5,1,2,0.5,0,0,,0,0,0,0,0,0,0,0,3,2.0,-4.0,Ish Wainright,0,0,
3410,11/20/2022,28.18904109589041,W,0,20.416666666666668,1,8,0.125,1,6,0.167,0,0,,4,3,7,2,0,0,2,2,3,0.1,17.0,Ish Wainright,0,2,0.0
3411,11/22/2022,28.194520547945206,W,0,11.5,2,2,1.0,2,2,1.0,0,0,,2,1,3,1,0,2,0,2,6,8.4,11.0,Ish Wainright,0,0,
3412,11/26/2022,28.205479452054796,W,0,17.5,2,3,0.667,2,2,1.0,0,0,,1,1,2,0,3,0,0,2,6,7.9,4.0,Ish Wainright,0,1,0.0
3413,10/19/2022,26.463013698630135,L,1,33.11666666666667,5,10,0.5,0,1,0.0,3,6,0.5,1,3,4,5,1,1,3,6,13,8.2,7.0,Domantas Sabonis,5,9,0.5555555555555556
3414,10/22/2022,26.471232876712328,L,1,34.65,4,12,0.333,0,3,0.0,3,6,0.5,3,7,10,7,2,2,1,4,11,12.9,7.0,Domantas Sabonis,4,9,0.4444444444444444
3415,10/23/2022,26.473972602739725,L,1,22.35,6,10,0.6,0,1,0.0,7,8,0.875,3,11,14,4,0,1,1,2,19,21.1,-25.0,Domantas Sabonis,6,9,0.6666666666666666
3416,10/27/2022,26.484931506849314,L,1,30.866666666666667,4,6,0.667,0,1,0.0,3,4,0.75,3,8,11,9,1,0,4,4,11,14.2,7.0,Domantas Sabonis,4,5,0.8
3417,10/29/2022,26.49041095890411,W,1,22.733333333333334,8,9,0.889,0,0,,2,2,1.0,2,5,7,3,0,1,2,6,18,16.2,6.0,Domantas Sabonis,8,9,0.8888888888888888
3418,10/31/2022,26.495890410958904,W,1,31.233333333333334,3,9,0.333,0,1,0.0,3,5,0.6,4,12,16,7,1,0,3,6,9,10.0,12.0,Domantas Sabonis,3,8,0.375
3419,11/2/2022,26.5013698630137,L,1,37.2,8,15,0.533,1,1,1.0,5,7,0.714,0,12,12,8,1,0,2,2,22,21.3,-5.0,Domantas Sabonis,7,14,0.5
3420,11/5/2022,26.50958904109589,W,1,37.81666666666667,10,14,0.714,0,1,0.0,5,12,0.417,2,9,11,6,1,1,2,4,25,22.8,4.0,Domantas Sabonis,10,13,0.7692307692307693
3421,11/7/2022,26.515068493150686,L,1,33.21666666666667,6,15,0.4,0,2,0.0,7,8,0.875,4,10,14,6,0,0,3,4,19,15.9,-16.0,Domantas Sabonis,6,13,0.46153846153846156
3422,11/9/2022,26.52054794520548,W,1,35.15,5,8,0.625,0,1,0.0,11,12,0.917,1,4,5,6,3,0,1,3,21,23.9,15.0,Domantas Sabonis,5,7,0.7142857142857143
3423,11/11/2022,26.526027397260275,W,1,31.566666666666666,9,15,0.6,0,0,,3,3,1.0,2,8,10,6,1,0,2,5,21,19.1,10.0,Domantas Sabonis,9,15,0.6
3424,11/13/2022,26.53150684931507,W,1,34.2,10,17,0.588,2,2,1.0,4,6,0.667,6,16,22,8,0,0,3,1,26,28.5,5.0,Domantas Sabonis,8,15,0.5333333333333333
3425,11/15/2022,26.536986301369865,W,1,27.6,6,6,1.0,0,0,,5,5,1.0,1,6,7,7,1,1,3,4,17,19.7,44.0,Domantas Sabonis,6,6,1.0
3426,11/17/2022,26.542465753424658,W,1,32.4,4,5,0.8,1,1,1.0,7,7,1.0,0,8,8,1,0,0,2,4,16,13.6,-1.0,Domantas Sabonis,3,4,0.75
3427,11/20/2022,26.55068493150685,W,1,33.8,4,5,0.8,1,1,1.0,6,8,0.75,3,10,13,7,1,0,3,5,15,18.3,12.0,Domantas Sabonis,3,4,0.75
3428,11/22/2022,26.556164383561644,W,1,37.35,3,8,0.375,0,1,0.0,3,6,0.5,2,11,13,8,0,0,2,5,9,9.7,1.0,Domantas Sabonis,3,7,0.42857142857142855
3429,11/23/2022,26.55890410958904,L,1,34.2,6,11,0.545,0,1,0.0,3,4,0.75,1,12,13,7,1,0,3,1,15,16.1,-4.0,Domantas Sabonis,6,10,0.6
3430,11/25/2022,26.564383561643837,L,1,33.2,7,13,0.538,0,2,0.0,4,4,1.0,2,8,10,6,0,0,3,5,18,14.7,-14.0,Domantas Sabonis,7,11,0.6363636363636364
3431,10/19/2022,24.145205479452056,L,1,28.8,8,12,0.667,6,9,0.667,1,2,0.5,0,3,3,2,1,0,1,2,23,18.9,16.0,Kevin Huerter,2,3,0.6666666666666666
3432,10/22/2022,24.153424657534245,L,1,32.43333333333333,5,9,0.556,5,8,0.625,3,4,0.75,0,3,3,5,0,0,1,4,18,15.1,5.0,Kevin Huerter,0,1,0.0
3433,10/23/2022,24.156164383561645,L,1,30.933333333333334,3,14,0.214,1,8,0.125,2,2,1.0,0,5,5,4,0,0,2,3,9,1.5,5.0,Kevin Huerter,2,6,0.3333333333333333
3434,10/27/2022,24.167123287671235,L,1,19.15,3,8,0.375,1,4,0.25,0,0,,0,2,2,2,0,0,0,1,7,4.2,7.0,Kevin Huerter,2,4,0.5
3435,10/29/2022,24.172602739726027,W,1,38.18333333333333,8,11,0.727,7,8,0.875,4,6,0.667,0,3,3,7,0,0,0,2,27,26.7,5.0,Kevin Huerter,1,3,0.3333333333333333
3436,10/31/2022,24.17808219178082,W,1,35.78333333333333,8,16,0.5,5,10,0.5,5,5,1.0,0,2,2,5,2,1,2,1,26,22.4,10.0,Kevin Huerter,3,6,0.5
3437,11/2/2022,24.183561643835617,L,1,38.06666666666667,9,17,0.529,4,9,0.444,0,0,,0,2,2,2,1,0,1,3,22,14.5,-1.0,Kevin Huerter,5,8,0.625
3438,11/5/2022,24.19178082191781,W,1,32.2,3,7,0.429,3,6,0.5,0,2,0.0,0,1,1,2,0,1,1,2,9,5.1,-16.0,Kevin Huerter,0,1,0.0
3439,11/7/2022,24.197260273972603,L,1,31.8,4,9,0.444,3,6,0.5,0,0,,0,3,3,1,2,0,1,2,11,8.1,-13.0,Kevin Huerter,1,3,0.3333333333333333
3440,11/9/2022,24.202739726027396,W,1,29.833333333333332,3,7,0.429,2,5,0.4,6,7,0.857,0,0,0,2,2,1,1,3,14,11.8,12.0,Kevin Huerter,1,2,0.5
3441,11/11/2022,24.208219178082192,W,1,32.46666666666667,6,13,0.462,4,9,0.444,0,1,0.0,1,5,6,2,3,2,3,1,16,13.5,6.0,Kevin Huerter,2,4,0.5
3442,11/13/2022,24.213698630136985,W,1,32.45,6,9,0.667,4,6,0.667,1,4,0.25,0,5,5,4,0,0,3,1,17,12.8,2.0,Kevin Huerter,2,3,0.6666666666666666
3443,11/15/2022,24.21917808219178,W,1,29.666666666666668,7,10,0.7,5,7,0.714,0,0,,1,1,2,3,1,0,2,2,19,16.1,40.0,Kevin Huerter,2,3,0.6666666666666666
3444,11/17/2022,24.224657534246575,W,1,34.18333333333333,3,11,0.273,1,5,0.2,0,0,,0,2,2,6,1,1,2,3,7,3.8,2.0,Kevin Huerter,2,6,0.3333333333333333
3445,11/20/2022,24.232876712328768,W,1,38.31666666666667,10,19,0.526,4,11,0.364,0,0,,2,3,5,5,1,0,2,4,24,17.9,20.0,Kevin Huerter,6,8,0.75
3446,11/22/2022,24.23835616438356,W,1,33.333333333333336,6,10,0.6,4,7,0.571,2,4,0.5,2,4,6,1,3,1,3,3,18,15.4,-2.0,Kevin Huerter,2,3,0.6666666666666666
3447,11/23/2022,24.24109589041096,L,1,29.266666666666666,4,10,0.4,3,7,0.429,2,2,1.0,0,4,4,5,1,1,2,5,13,10.0,-7.0,Kevin Huerter,1,3,0.3333333333333333
3448,11/25/2022,24.246575342465754,L,1,31.816666666666666,2,10,0.2,0,6,0.0,3,3,1.0,0,3,3,3,0,1,2,2,7,1.7,-13.0,Kevin Huerter,2,4,0.5
3449,10/19/2022,24.704109589041096,L,0,15.7,2,7,0.286,2,5,0.4,0,0,,1,1,2,3,0,1,2,1,6,3.3,-18.0,Malik Monk,0,2,0.0
3450,10/22/2022,24.71232876712329,L,0,13.05,0,4,0.0,0,2,0.0,0,1,0.0,0,2,2,1,1,0,2,1,0,-3.3,-13.0,Malik Monk,0,2,0.0
3451,10/23/2022,24.715068493150685,L,0,28.55,6,15,0.4,4,10,0.4,0,0,,3,4,7,8,3,0,1,0,16,18.8,2.0,Malik Monk,2,5,0.4
3452,10/27/2022,24.726027397260275,L,0,22.016666666666666,5,9,0.556,3,7,0.429,2,2,1.0,0,2,2,7,0,1,1,2,15,15.1,-11.0,Malik Monk,2,2,1.0
3453,10/29/2022,24.731506849315068,W,0,13.516666666666667,2,5,0.4,1,4,0.25,1,1,1.0,0,2,2,2,0,0,2,2,6,2.5,0.0,Malik Monk,1,1,1.0
3454,10/31/2022,24.736986301369864,W,0,15.133333333333333,2,9,0.222,2,7,0.286,1,1,1.0,0,1,1,2,0,0,1,0,7,2.2,-7.0,Malik Monk,0,2,0.0
3455,11/2/2022,24.742465753424657,L,0,22.0,8,13,0.615,2,5,0.4,1,1,1.0,0,0,0,7,0,1,3,3,19,14.5,1.0,Malik Monk,6,8,0.75
3456,11/5/2022,24.75068493150685,W,0,28.516666666666666,5,10,0.5,3,7,0.429,2,2,1.0,0,1,1,5,0,0,1,3,15,11.6,16.0,Malik Monk,2,3,0.6666666666666666
3457,11/7/2022,24.756164383561643,L,0,30.583333333333332,7,16,0.438,3,8,0.375,7,7,1.0,0,6,6,4,1,0,0,1,24,20.8,12.0,Malik Monk,4,8,0.5
3458,11/9/2022,24.76164383561644,W,0,27.366666666666667,4,9,0.444,3,5,0.6,3,4,0.75,0,2,2,5,0,1,1,3,14,11.5,5.0,Malik Monk,1,4,0.25
3459,11/11/2022,24.767123287671232,W,0,20.966666666666665,3,7,0.429,0,2,0.0,2,2,1.0,1,0,1,3,0,0,3,2,8,3.3,4.0,Malik Monk,3,5,0.6
3460,11/13/2022,24.77260273972603,W,0,24.366666666666667,2,8,0.25,1,4,0.25,7,7,1.0,0,1,1,4,0,0,3,2,12,6.5,-2.0,Malik Monk,1,4,0.25
3461,11/15/2022,24.778082191780822,W,0,17.35,6,9,0.667,1,2,0.5,2,2,1.0,1,2,3,6,0,0,2,2,15,13.8,-5.0,Malik Monk,5,7,0.7142857142857143
3462,11/17/2022,24.783561643835615,W,0,28.016666666666666,11,19,0.579,4,9,0.444,0,0,,1,3,4,2,0,0,1,1,26,18.7,10.0,Malik Monk,7,10,0.7
3463,11/20/2022,24.791780821917808,W,0,19.083333333333332,3,6,0.5,0,2,0.0,2,2,1.0,0,1,1,3,2,0,2,2,8,6.6,-16.0,Malik Monk,3,4,0.75
3464,11/22/2022,24.797260273972604,W,0,23.416666666666668,5,13,0.385,2,8,0.25,2,3,0.667,0,2,2,4,1,0,3,2,14,7.1,6.0,Malik Monk,3,5,0.6
3465,11/23/2022,24.8,L,0,26.283333333333335,12,18,0.667,3,7,0.429,0,0,,0,0,0,4,2,0,2,5,27,20.0,-2.0,Malik Monk,9,11,0.8181818181818182
3466,11/25/2022,24.805479452054794,L,0,22.583333333333332,4,12,0.333,1,6,0.167,0,1,0.0,0,2,2,3,1,0,1,1,9,4.1,-9.0,Malik Monk,3,6,0.5
3467,10/19/2022,30.389041095890413,L,1,31.35,4,8,0.5,0,2,0.0,1,2,0.5,1,7,8,4,0,1,1,2,9,9.1,-6.0,Harrison Barnes,4,6,0.6666666666666666
3468,10/22/2022,30.397260273972602,L,1,34.483333333333334,2,10,0.2,0,3,0.0,4,7,0.571,1,6,7,0,1,0,1,2,8,2.3,4.0,Harrison Barnes,2,7,0.2857142857142857
3469,10/23/2022,30.4,L,1,21.45,1,1,1.0,0,0,,2,4,0.5,0,2,2,0,1,0,2,1,4,2.1,-18.0,Harrison Barnes,1,1,1.0
3470,10/27/2022,30.410958904109588,L,1,37.46666666666667,6,12,0.5,1,4,0.25,7,8,0.875,0,3,3,3,1,0,2,0,20,15.6,-12.0,Harrison Barnes,5,8,0.625
3471,10/29/2022,30.416438356164385,W,1,33.666666666666664,3,7,0.429,1,4,0.25,4,4,1.0,1,3,4,6,0,0,2,5,11,9.1,12.0,Harrison Barnes,2,3,0.6666666666666666
3472,10/31/2022,30.421917808219177,W,1,37.333333333333336,4,12,0.333,0,5,0.0,8,8,1.0,2,7,9,2,0,0,0,0,16,14.1,-1.0,Harrison Barnes,4,7,0.5714285714285714
3473,11/2/2022,30.427397260273974,L,1,34.8,4,12,0.333,2,5,0.4,2,2,1.0,2,5,7,1,0,0,0,0,12,8.8,-3.0,Harrison Barnes,2,7,0.2857142857142857
3474,11/5/2022,30.435616438356163,W,1,35.06666666666667,4,10,0.4,1,4,0.25,0,0,,2,3,5,1,1,0,1,1,9,6.2,5.0,Harrison Barnes,3,6,0.5
3475,11/7/2022,30.44109589041096,L,1,22.466666666666665,0,4,0.0,0,3,0.0,0,0,,1,2,3,0,1,0,2,0,0,-2.5,-10.0,Harrison Barnes,0,1,0.0
3476,11/9/2022,30.446575342465753,W,1,35.3,6,8,0.75,2,4,0.5,6,8,0.75,1,8,9,3,2,0,0,3,20,22.0,10.0,Harrison Barnes,4,4,1.0
3477,11/11/2022,30.45205479452055,W,1,30.566666666666666,3,7,0.429,1,3,0.333,6,6,1.0,3,5,8,2,1,1,2,1,13,13.6,9.0,Harrison Barnes,2,4,0.5
3478,11/13/2022,30.457534246575342,W,1,27.416666666666668,4,8,0.5,1,3,0.333,0,0,,0,0,0,3,1,1,0,1,9,8.4,3.0,Harrison Barnes,3,5,0.6
3479,11/15/2022,30.463013698630135,W,1,21.433333333333334,5,8,0.625,2,4,0.5,4,4,1.0,1,3,4,3,1,0,0,4,16,15.5,33.0,Harrison Barnes,3,4,0.75
3480,11/17/2022,30.46849315068493,W,1,29.35,4,7,0.571,1,3,0.333,7,8,0.875,1,7,8,2,2,0,1,0,16,17.5,7.0,Harrison Barnes,3,4,0.75
3481,11/20/2022,30.476712328767125,W,1,36.15,8,11,0.727,1,2,0.5,10,11,0.909,2,7,9,3,0,0,0,0,27,27.7,20.0,Harrison Barnes,7,9,0.7777777777777778
3482,11/22/2022,30.482191780821918,W,1,33.03333333333333,7,13,0.538,4,8,0.5,8,8,1.0,0,4,4,0,1,0,5,2,26,16.1,-3.0,Harrison Barnes,3,5,0.6
3483,11/23/2022,30.484931506849314,L,1,32.35,4,8,0.5,0,2,0.0,0,0,,0,7,7,1,0,0,1,0,8,5.8,-5.0,Harrison Barnes,4,6,0.6666666666666666
3484,11/25/2022,30.49041095890411,L,1,22.6,4,9,0.444,0,0,,4,4,1.0,3,2,5,1,0,0,2,3,12,7.5,-19.0,Harrison Barnes,4,9,0.4444444444444444
3485,10/19/2022,24.12054794520548,L,0,25.833333333333332,1,8,0.125,0,5,0.0,0,0,,0,3,3,4,0,0,0,1,2,0.1,-7.0,Davion Mitchell,1,3,0.3333333333333333
3486,10/22/2022,24.12876712328767,L,0,16.1,2,7,0.286,0,2,0.0,0,0,,0,0,0,2,0,0,1,2,4,-0.5,-10.0,Davion Mitchell,2,5,0.4
3487,10/23/2022,24.13150684931507,L,0,11.766666666666667,3,5,0.6,1,2,0.5,0,0,,0,1,1,3,0,0,1,4,7,4.5,2.0,Davion Mitchell,2,3,0.6666666666666666
3488,10/27/2022,24.14246575342466,L,0,12.016666666666667,2,4,0.5,1,2,0.5,2,2,1.0,0,1,1,1,1,0,0,0,7,7.0,-13.0,Davion Mitchell,1,2,0.5
3489,10/29/2022,24.147945205479452,W,0,11.783333333333333,1,2,0.5,0,1,0.0,0,1,0.0,0,3,3,1,0,0,4,2,2,-2.6,2.0,Davion Mitchell,1,1,1.0
3490,10/31/2022,24.153424657534245,W,0,31.283333333333335,9,11,0.818,5,6,0.833,0,0,,0,4,4,0,3,0,5,2,23,17.3,5.0,Davion Mitchell,4,5,0.8
3491,11/2/2022,24.15890410958904,L,1,29.233333333333334,4,9,0.444,1,4,0.25,0,0,,0,1,1,4,0,0,1,2,9,5.6,-11.0,Davion Mitchell,3,5,0.6
3492,11/5/2022,24.167123287671235,W,0,12.716666666666667,0,2,0.0,0,1,0.0,0,0,,0,1,1,1,0,0,2,2,0,-3.2,15.0,Davion Mitchell,0,1,0.0
3493,11/7/2022,24.172602739726027,L,0,21.4,5,11,0.455,2,5,0.4,0,0,,0,0,0,1,2,0,1,2,12,7.2,-2.0,Davion Mitchell,3,6,0.5
3494,11/9/2022,24.17808219178082,W,0,19.7,3,6,0.5,1,4,0.25,0,0,,0,1,1,3,0,0,1,1,7,5.0,-2.0,Davion Mitchell,2,2,1.0
3495,11/11/2022,24.183561643835617,W,0,19.566666666666666,2,4,0.5,2,3,0.667,0,0,,0,0,0,0,0,0,0,1,6,3.6,-14.0,Davion Mitchell,0,1,0.0
3496,11/13/2022,24.18904109589041,W,0,14.15,1,3,0.333,0,2,0.0,0,0,,1,0,1,1,0,0,0,1,2,1.3,-8.0,Davion Mitchell,1,1,1.0
3497,11/15/2022,24.194520547945206,W,0,16.766666666666666,3,4,0.75,0,1,0.0,2,3,0.667,0,0,0,3,0,1,1,2,8,7.0,26.0,Davion Mitchell,3,3,1.0
3498,11/17/2022,24.2,W,0,27.65,3,6,0.5,0,1,0.0,0,0,,0,2,2,4,0,0,0,0,6,6.4,9.0,Davion Mitchell,3,5,0.6
3499,11/20/2022,24.208219178082192,W,0,14.183333333333334,2,5,0.4,1,3,0.333,0,0,,0,1,1,3,0,0,0,1,5,4.3,-4.0,Davion Mitchell,1,2,0.5
3500,11/22/2022,24.213698630136985,W,0,18.95,1,5,0.2,0,3,0.0,0,0,,1,1,2,4,1,0,2,2,2,0.9,4.0,Davion Mitchell,1,2,0.5
3501,11/23/2022,24.216438356164385,L,0,19.3,2,6,0.333,0,1,0.0,0,1,0.0,0,0,0,2,0,0,0,1,4,1.2,0.0,Davion Mitchell,2,5,0.4
3502,11/25/2022,24.221917808219178,L,0,14.133333333333333,5,6,0.833,1,1,1.0,2,2,1.0,0,0,0,1,0,1,1,1,13,10.8,-3.0,Davion Mitchell,4,5,0.8
3503,10/19/2022,24.83013698630137,L,1,35.15,12,21,0.571,5,9,0.556,4,5,0.8,0,7,7,7,2,0,8,5,33,21.7,1.0,De'Aaron Fox,7,12,0.5833333333333334
3504,10/22/2022,24.838356164383562,L,1,32.43333333333333,15,23,0.652,3,5,0.6,3,6,0.5,1,4,5,4,1,1,3,1,36,27.7,5.0,De'Aaron Fox,12,18,0.6666666666666666
3505,10/23/2022,24.84109589041096,L,1,36.35,11,20,0.55,1,6,0.167,3,3,1.0,1,4,5,10,1,0,3,4,26,21.7,-7.0,De'Aaron Fox,10,14,0.7142857142857143
3506,10/27/2022,24.852054794520548,L,1,35.416666666666664,11,19,0.579,2,6,0.333,3,3,1.0,1,5,6,2,1,1,3,5,27,18.4,-2.0,De'Aaron Fox,9,13,0.6923076923076923
3507,10/29/2022,24.85753424657534,W,1,36.25,6,17,0.353,0,2,0.0,5,5,1.0,2,11,13,5,0,2,3,4,17,12.5,4.0,De'Aaron Fox,6,15,0.4
3508,10/31/2022,24.863013698630137,W,1,9.0,2,4,0.5,1,3,0.333,3,3,1.0,0,0,0,1,0,0,3,1,8,3.3,-8.0,De'Aaron Fox,1,1,1.0
3509,11/5/2022,24.876712328767123,W,1,40.28333333333333,14,24,0.583,2,7,0.286,7,7,1.0,0,5,5,3,1,0,4,3,37,25.2,-12.0,De'Aaron Fox,12,17,0.7058823529411765
3510,11/7/2022,24.882191780821916,L,1,36.55,8,17,0.471,2,5,0.4,10,12,0.833,1,1,2,6,0,0,2,3,28,20.5,0.0,De'Aaron Fox,6,12,0.5
3511,11/9/2022,24.887671232876713,W,1,28.516666666666666,6,14,0.429,1,4,0.25,2,2,1.0,0,2,2,8,3,0,0,1,15,16.4,9.0,De'Aaron Fox,5,10,0.5
3512,11/11/2022,24.893150684931506,W,1,35.55,13,19,0.684,2,5,0.4,4,5,0.8,0,7,7,12,2,0,3,2,32,32.2,13.0,De'Aaron Fox,11,14,0.7857142857142857
3513,11/13/2022,24.898630136986302,W,1,34.35,10,19,0.526,2,4,0.5,0,2,0.0,1,3,4,8,3,1,3,3,22,18.6,15.0,De'Aaron Fox,8,15,0.5333333333333333
3514,11/15/2022,24.904109589041095,W,1,23.75,5,12,0.417,1,5,0.2,3,5,0.6,0,4,4,9,1,1,1,1,14,14.6,11.0,De'Aaron Fox,4,7,0.5714285714285714
3515,11/17/2022,24.90958904109589,W,1,31.8,11,15,0.733,2,3,0.667,4,4,1.0,0,3,3,8,1,0,0,3,28,28.2,36.0,De'Aaron Fox,9,12,0.75
3516,11/20/2022,24.91780821917808,W,1,35.983333333333334,11,18,0.611,2,4,0.5,9,9,1.0,0,4,4,7,0,0,2,4,33,27.3,12.0,De'Aaron Fox,9,14,0.6428571428571429
3517,11/22/2022,24.923287671232877,W,1,35.166666666666664,11,21,0.524,5,8,0.625,5,6,0.833,1,7,8,6,4,0,1,3,32,30.1,-4.0,De'Aaron Fox,6,13,0.46153846153846156
3518,11/23/2022,24.926027397260274,L,1,32.21666666666667,7,20,0.35,1,6,0.167,3,7,0.429,1,4,5,5,0,0,4,3,18,5.4,-11.0,De'Aaron Fox,6,14,0.42857142857142855
3519,11/25/2022,24.931506849315067,L,1,30.516666666666666,6,17,0.353,3,9,0.333,5,5,1.0,0,4,4,2,0,0,2,1,20,10.7,-26.0,De'Aaron Fox,3,8,0.375
3520,10/19/2022,25.427397260273974,L,0,25.05,4,9,0.444,2,5,0.4,4,4,1.0,1,4,5,1,2,1,0,3,14,13.4,-8.0,Terence Davis,2,4,0.5
3521,10/22/2022,25.435616438356163,L,0,12.4,3,5,0.6,2,4,0.5,0,0,,0,1,1,2,0,0,1,1,8,6.0,1.0,Terence Davis,1,1,1.0
3522,10/23/2022,25.438356164383563,L,0,15.866666666666667,3,6,0.5,0,2,0.0,1,2,0.5,1,1,2,0,1,0,0,6,7,3.2,-3.0,Terence Davis,3,4,0.75
3523,10/27/2022,25.44931506849315,L,0,10.866666666666667,1,5,0.2,1,4,0.25,0,0,,0,2,2,1,1,0,1,1,3,0.8,-14.0,Terence Davis,0,1,0.0
3524,10/29/2022,25.454794520547946,W,0,5.316666666666666,0,1,0.0,0,1,0.0,0,0,,0,0,0,0,0,0,0,0,0,-0.7,-4.0,Terence Davis,0,0,
3525,10/31/2022,25.46027397260274,W,0,4.483333333333333,1,1,1.0,0,0,,1,2,0.5,1,1,2,1,0,0,1,1,3,2.6,-1.0,Terence Davis,1,1,1.0
3526,11/2/2022,25.465753424657535,L,0,8.016666666666667,0,3,0.0,0,3,0.0,4,4,1.0,0,3,3,2,0,0,0,2,4,3.4,-2.0,Terence Davis,0,0,
3527,11/5/2022,25.473972602739725,W,0,8.483333333333333,2,5,0.4,1,3,0.333,0,0,,0,1,1,3,1,1,0,1,5,6.0,6.0,Terence Davis,1,2,0.5
3528,11/7/2022,25.47945205479452,L,0,18.216666666666665,3,8,0.375,3,7,0.429,0,0,,1,4,5,1,1,0,1,2,9,6.4,-1.0,Terence Davis,0,1,0.0
3529,11/11/2022,25.49041095890411,W,0,12.7,4,6,0.667,2,4,0.5,2,2,1.0,0,0,0,1,1,0,0,1,12,10.7,-2.0,Terence Davis,2,2,1.0
3530,11/13/2022,25.495890410958904,W,0,17.616666666666667,2,4,0.5,1,3,0.333,0,0,,1,5,6,2,0,0,1,1,5,5.2,14.0,Terence Davis,1,1,1.0
3531,11/15/2022,25.5013698630137,W,0,26.3,12,16,0.75,7,10,0.7,0,0,,0,9,9,4,3,1,0,3,31,32.6,35.0,Terence Davis,5,6,0.8333333333333334
3532,11/17/2022,25.506849315068493,W,1,14.65,2,7,0.286,1,3,0.333,0,0,,1,2,3,3,1,0,3,2,5,1.5,3.0,Terence Davis,1,4,0.25
3533,11/20/2022,25.515068493150686,W,0,3.4166666666666665,1,3,0.333,1,1,1.0,0,0,,0,0,0,0,0,0,0,1,3,0.9,-5.0,Terence Davis,0,2,0.0
3534,11/22/2022,25.52054794520548,W,0,9.416666666666666,0,4,0.0,0,4,0.0,0,0,,0,1,1,2,1,0,0,2,0,-0.9,6.0,Terence Davis,0,0,
3535,11/23/2022,25.523287671232875,L,0,8.95,0,1,0.0,0,0,,0,0,,1,1,2,0,1,0,2,1,0,-1.1,-4.0,Terence Davis,0,1,0.0
3536,11/25/2022,25.528767123287672,L,0,13.933333333333334,1,2,0.5,1,2,0.5,0,0,,0,3,3,1,0,0,2,2,3,0.8,0.0,Terence Davis,0,0,
3537,10/22/2022,22.175342465753424,L,0,32.8,7,10,0.7,3,6,0.5,2,2,1.0,1,4,5,2,0,2,2,3,19,16.3,-4.0,Keegan Murray,4,4,1.0
3538,10/23/2022,22.17808219178082,L,0,38.43333333333333,6,14,0.429,4,10,0.4,0,0,,1,3,4,0,1,0,2,2,16,8.4,2.0,Keegan Murray,2,4,0.5
3539,10/27/2022,22.18904109589041,L,1,39.21666666666667,7,15,0.467,3,8,0.375,1,1,1.0,3,3,6,0,0,0,2,1,18,10.9,-10.0,Keegan Murray,4,7,0.5714285714285714
3540,10/29/2022,22.194520547945206,W,1,35.8,8,13,0.615,3,7,0.429,3,4,0.75,0,1,1,3,0,2,5,4,22,12.9,2.0,Keegan Murray,5,6,0.8333333333333334
3541,10/31/2022,22.2,W,1,31.933333333333334,5,15,0.333,2,7,0.286,0,0,,1,3,4,2,1,1,1,1,12,6.8,15.0,Keegan Murray,3,8,0.375
3542,11/2/2022,22.205479452054796,L,1,27.266666666666666,3,7,0.429,1,5,0.2,0,0,,0,4,4,3,1,2,2,1,7,6.6,7.0,Keegan Murray,2,2,1.0
3543,11/5/2022,22.213698630136985,W,1,24.266666666666666,1,6,0.167,1,4,0.25,0,0,,0,2,2,0,1,0,1,1,3,-0.6,-12.0,Keegan Murray,0,2,0.0
3544,11/7/2022,22.21917808219178,L,1,26.966666666666665,2,7,0.286,1,4,0.25,1,2,0.5,2,5,7,2,2,0,0,4,6,6.2,-4.0,Keegan Murray,1,3,0.3333333333333333
3545,11/9/2022,22.224657534246575,W,1,32.93333333333333,5,10,0.5,4,7,0.571,0,0,,0,3,3,1,2,1,1,4,14,10.7,-7.0,Keegan Murray,1,3,0.3333333333333333
3546,11/11/2022,22.23013698630137,W,1,25.683333333333334,1,4,0.25,0,3,0.0,0,0,,0,1,1,0,1,1,1,3,2,-0.6,15.0,Keegan Murray,1,1,1.0
3547,11/13/2022,22.235616438356164,W,1,36.6,8,15,0.533,5,9,0.556,0,0,,0,4,4,0,3,0,2,4,21,14.3,16.0,Keegan Murray,3,6,0.5
3548,11/15/2022,22.24109589041096,W,1,12.3,2,6,0.333,0,2,0.0,0,0,,0,3,3,0,0,0,0,0,4,1.5,3.0,Keegan Murray,2,4,0.5
3549,11/20/2022,22.254794520547946,W,1,34.68333333333333,4,10,0.4,1,6,0.167,4,5,0.8,0,2,2,1,0,0,2,0,13,6.5,9.0,Keegan Murray,3,4,0.75
3550,11/22/2022,22.26027397260274,W,1,23.716666666666665,1,8,0.125,0,4,0.0,0,0,,1,2,3,2,0,0,0,2,2,-1.3,2.0,Keegan Murray,1,4,0.25
3551,11/23/2022,22.263013698630136,L,1,20.816666666666666,0,5,0.0,0,3,0.0,4,4,1.0,1,3,4,0,0,0,2,2,4,-0.7,0.0,Keegan Murray,0,2,0.0
3552,11/25/2022,22.268493150684932,L,1,22.716666666666665,1,8,0.125,1,6,0.167,0,0,,3,7,10,0,1,1,1,2,3,1.9,-14.0,Keegan Murray,0,2,0.0
3553,10/19/2022,26.953424657534246,L,0,14.533333333333333,2,8,0.25,2,7,0.286,0,0,,0,4,4,0,1,0,0,0,6,3.4,-4.0,Trey Lyles,0,1,0.0
3554,10/23/2022,26.964383561643835,L,0,3.9333333333333336,1,3,0.333,0,2,0.0,0,0,,0,1,1,1,1,0,1,2,2,0.5,4.0,Trey Lyles,1,1,1.0
3555,10/29/2022,26.980821917808218,W,0,18.366666666666667,4,7,0.571,2,4,0.5,0,2,0.0,1,4,5,0,1,1,1,1,10,8.1,3.0,Trey Lyles,2,3,0.6666666666666666
3556,10/31/2022,26.986301369863014,W,0,21.15,1,4,0.25,1,3,0.333,3,4,0.75,2,2,4,3,1,2,2,4,6,6.1,11.0,Trey Lyles,0,1,0.0
3557,11/2/2022,26.991780821917807,L,0,12.85,1,3,0.333,1,3,0.333,0,0,,0,4,4,1,0,0,1,0,3,2.2,-4.0,Trey Lyles,0,0,
3558,11/5/2022,27.0,W,0,29.566666666666666,5,10,0.5,4,7,0.571,1,1,1.0,0,3,3,2,0,1,2,2,15,10.2,10.0,Trey Lyles,1,3,0.3333333333333333
3559,11/7/2022,27.005479452054793,L,0,4.0,1,1,1.0,0,0,,0,0,,0,1,1,0,0,0,0,0,2,2.0,6.0,Trey Lyles,1,1,1.0
3560,11/9/2022,27.01095890410959,W,0,18.566666666666666,5,9,0.556,4,7,0.571,2,2,1.0,0,1,1,1,0,1,3,2,16,9.6,1.0,Trey Lyles,1,2,0.5
3561,11/11/2022,27.016438356164382,W,0,14.5,0,4,0.0,0,4,0.0,0,0,,1,1,2,1,0,0,0,0,0,-1.1,-7.0,Trey Lyles,0,0,
3562,11/13/2022,27.02191780821918,W,0,5.433333333333334,0,2,0.0,0,2,0.0,0,0,,0,0,0,1,0,0,0,1,0,-1.1,-9.0,Trey Lyles,0,0,
3563,11/15/2022,27.027397260273972,W,0,17.916666666666668,4,13,0.308,3,8,0.375,1,2,0.5,4,1,5,0,0,0,2,1,12,4.8,-3.0,Trey Lyles,1,5,0.2
3564,11/17/2022,27.03287671232877,W,0,19.683333333333334,5,8,0.625,1,4,0.25,3,4,0.75,2,1,3,0,1,0,0,0,14,12.7,7.0,Trey Lyles,4,4,1.0
3565,11/20/2022,27.041095890410958,W,0,10.183333333333334,1,4,0.25,1,4,0.25,0,0,,0,0,0,0,0,0,0,0,3,0.6,-4.0,Trey Lyles,0,0,
3566,11/22/2022,27.046575342465754,W,0,15.016666666666667,0,1,0.0,0,1,0.0,0,0,,1,2,3,0,0,1,1,1,0,-0.1,8.0,Trey Lyles,0,0,
3567,11/23/2022,27.04931506849315,L,0,20.45,4,7,0.571,1,3,0.333,3,3,1.0,5,2,7,2,1,1,2,4,12,12.3,-6.0,Trey Lyles,3,4,0.75
3568,11/25/2022,27.054794520547944,L,0,8.483333333333333,1,1,1.0,1,1,1.0,3,4,0.75,1,1,2,0,0,0,2,0,6,4.3,4.0,Trey Lyles,0,0,
3569,10/22/2022,25.586301369863016,L,0,0.5,0,0,,0,0,,0,0,,0,0,0,0,0,0,0,0,0,0.0,-1.0,Chimezie Metu,0,0,
3570,10/23/2022,25.589041095890412,L,0,10.55,1,3,0.333,0,1,0.0,2,2,1.0,0,4,4,1,1,1,0,2,4,5.1,15.0,Chimezie Metu,1,2,0.5
3571,10/27/2022,25.6,L,0,13.95,1,4,0.25,0,2,0.0,0,0,,0,3,3,2,0,0,0,1,2,1.5,-6.0,Chimezie Metu,1,2,0.5
3572,11/5/2022,25.624657534246577,W,0,10.9,2,3,0.667,0,0,,2,2,1.0,0,3,3,1,0,0,0,0,6,6.3,7.0,Chimezie Metu,2,3,0.6666666666666666
3573,11/7/2022,25.63013698630137,L,0,14.766666666666667,1,3,0.333,0,0,,0,0,,0,2,2,3,0,0,0,2,2,2.2,13.0,Chimezie Metu,1,3,0.3333333333333333
3574,11/9/2022,25.635616438356166,W,0,12.633333333333333,3,5,0.6,0,2,0.0,0,0,,0,1,1,1,0,0,1,0,6,3.7,-8.0,Chimezie Metu,3,3,1.0
3575,11/11/2022,25.64109589041096,W,0,16.433333333333334,4,8,0.5,1,3,0.333,1,2,0.5,2,3,5,0,1,0,1,1,10,7.5,-4.0,Chimezie Metu,3,5,0.6
3576,11/13/2022,25.646575342465752,W,0,13.416666666666666,4,6,0.667,0,2,0.0,0,0,,0,2,2,0,1,0,0,2,8,6.2,-1.0,Chimezie Metu,4,4,1.0
3577,11/15/2022,25.65205479452055,W,0,15.216666666666667,1,3,0.333,0,1,0.0,0,0,,1,3,4,0,1,0,4,1,2,-1.5,-13.0,Chimezie Metu,1,2,0.5
3578,11/17/2022,25.65753424657534,W,0,13.983333333333333,4,4,1.0,1,1,1.0,1,1,1.0,1,2,3,1,1,0,1,1,10,10.4,19.0,Chimezie Metu,3,3,1.0
3579,11/20/2022,25.665753424657535,W,0,14.2,3,4,0.75,0,1,0.0,0,0,,1,5,6,0,0,0,0,1,6,6.2,-4.0,Chimezie Metu,3,3,1.0
3580,11/22/2022,25.671232876712327,W,0,10.6,5,7,0.714,0,1,0.0,0,0,,1,2,3,0,0,0,1,3,10,6.2,2.0,Chimezie Metu,5,6,0.8333333333333334
3581,11/23/2022,25.673972602739727,L,0,13.8,2,3,0.667,1,1,1.0,0,0,,1,5,6,1,0,0,0,1,5,6.2,-5.0,Chimezie Metu,1,2,0.5
3582,11/25/2022,25.67945205479452,L,0,10.3,1,2,0.5,0,0,,2,2,1.0,1,1,2,0,0,0,2,1,4,1.6,-11.0,Chimezie Metu,1,2,0.5
3583,10/19/2022,29.01095890410959,L,0,14.516666666666667,1,1,1.0,0,0,,0,0,,0,3,3,0,1,1,0,2,2,3.5,-12.0,Richaun Holmes,1,1,1.0
3584,10/22/2022,29.019178082191782,L,0,12.816666666666666,1,2,0.5,0,0,,0,0,,2,1,3,0,0,0,0,2,2,1.9,-6.0,Richaun Holmes,1,2,0.5
3585,10/23/2022,29.02191780821918,L,0,16.25,6,8,0.75,0,0,,3,4,0.75,3,2,5,0,1,0,3,3,15,10.9,8.0,Richaun Holmes,6,8,0.75
3586,10/27/2022,29.03287671232877,L,0,8.4,0,0,,0,0,,0,0,,0,1,1,0,0,0,0,3,0,-0.9,-12.0,Richaun Holmes,0,0,
3587,10/29/2022,29.03835616438356,W,0,21.183333333333334,2,4,0.5,0,0,,1,2,0.5,0,4,4,0,0,0,1,2,5,2.0,1.0,Richaun Holmes,2,4,0.5
3588,10/31/2022,29.043835616438358,W,0,12.416666666666666,1,1,1.0,0,0,,0,0,,0,0,0,0,0,0,1,1,2,0.3,-7.0,Richaun Holmes,1,1,1.0
3589,11/2/2022,29.04931506849315,L,0,10.8,2,2,1.0,0,0,,0,0,,1,3,4,0,0,0,0,1,4,4.6,2.0,Richaun Holmes,2,2,1.0
3590,11/5/2022,29.057534246575344,W,0,5.183333333333334,1,2,0.5,0,0,,0,0,,2,1,3,0,0,0,0,1,2,2.3,-8.0,Richaun Holmes,1,2,0.5
3591,11/15/2022,29.084931506849315,W,0,6.483333333333333,2,2,1.0,1,1,1.0,0,0,,0,1,1,0,0,0,0,2,5,3.9,-3.0,Richaun Holmes,1,1,1.0
3592,11/25/2022,29.112328767123287,L,0,4.5,0,0,,0,0,,0,0,,0,0,0,0,0,0,0,0,0,0.0,7.0,Richaun Holmes,0,0,
3593,10/19/2022,23.476712328767125,L,1,15.95,0,1,0.0,0,1,0.0,0,0,,0,2,2,1,0,0,0,3,0,-0.6,-4.0,KZ Okpala,0,0,
3594,10/22/2022,23.484931506849314,L,1,18.333333333333332,1,3,0.333,1,2,0.5,0,0,,1,2,3,1,0,0,0,1,3,2.9,2.0,KZ Okpala,0,1,0.0
3595,10/23/2022,23.487671232876714,L,1,3.5666666666666664,0,1,0.0,0,1,0.0,0,0,,1,0,1,0,0,0,0,0,0,0.0,-10.0,KZ Okpala,0,0,
3596,10/27/2022,23.4986301369863,L,0,0.5666666666666667,0,0,,0,0,,0,0,,0,0,0,0,0,0,0,0,0,0.0,0.0,KZ Okpala,0,0,
3597,10/29/2022,23.504109589041096,W,0,0.05,0,0,,0,0,,0,0,,0,0,0,0,0,0,0,0,0,0.0,0.0,KZ Okpala,0,0,
3598,10/31/2022,23.50958904109589,W,0,0.06666666666666667,0,0,,0,0,,0,0,,0,0,0,0,0,0,0,0,0,0.0,0.0,KZ Okpala,0,0,
3599,11/15/2022,23.55068493150685,W,0,12.433333333333334,1,1,1.0,0,0,,4,4,1.0,0,0,0,0,0,0,0,2,6,4.9,-3.0,KZ Okpala,1,1,1.0
3600,11/17/2022,23.556164383561644,W,0,1.8166666666666667,0,0,,0,0,,0,0,,0,0,0,1,0,0,0,0,0,0.7,-2.0,KZ Okpala,0,0,
3601,11/23/2022,23.572602739726026,L,0,0.26666666666666666,0,0,,0,0,,0,0,,0,0,0,0,0,0,0,0,0,0.0,0.0,KZ Okpala,0,0,
3602,11/25/2022,23.578082191780823,L,0,20.716666666666665,3,5,0.6,1,2,0.5,0,0,,1,3,4,1,1,1,0,4,7,7.1,1.0,KZ Okpala,2,3,0.6666666666666666
3603,10/27/2022,32.134246575342466,L,0,0.5666666666666667,0,0,,0,0,,0,0,,0,0,0,0,0,0,0,0,0,0.0,0.0,Matthew Dellavedova,0,0,
3604,10/31/2022,32.14520547945205,W,0,8.233333333333333,1,2,0.5,1,2,0.5,0,0,,0,0,0,3,0,0,0,1,3,3.7,10.0,Matthew Dellavedova,0,0,
3605,11/2/2022,32.15068493150685,L,0,19.766666666666666,2,5,0.4,1,1,1.0,0,0,,1,1,2,1,1,0,2,4,5,1.4,1.0,Matthew Dellavedova,1,4,0.25
3606,11/15/2022,32.18630136986302,W,0,7.716666666666667,0,2,0.0,0,0,,0,0,,0,0,0,4,1,0,1,0,0,1.4,-5.0,Matthew Dellavedova,0,2,0.0
3607,11/17/2022,32.19178082191781,W,0,1.6166666666666667,0,0,,0,0,,0,0,,0,1,1,0,0,0,0,0,0,0.3,0.0,Matthew Dellavedova,0,0,
3608,11/23/2022,32.20821917808219,L,0,2.1,0,0,,0,0,,0,0,,0,0,0,0,0,0,0,0,0,0.0,-1.0,Matthew Dellavedova,0,0,
3609,11/25/2022,32.21369863013699,L,0,4.5,1,2,0.5,0,1,0.0,0,1,0.0,0,0,0,2,0,0,0,0,2,2.0,7.0,Matthew Dellavedova,1,1,1.0
3610,10/27/2022,29.364383561643837,L,0,3.2,0,0,,0,0,,0,0,,0,1,1,0,0,0,0,0,0,0.3,0.0,Alex Len,0,0,
3611,10/29/2022,29.36986301369863,W,0,3.15,0,0,,0,0,,1,2,0.5,0,1,1,0,0,0,0,1,1,0.5,-1.0,Alex Len,0,0,
3612,10/31/2022,29.375342465753423,W,0,1.95,0,1,0.0,0,0,,0,0,,0,0,0,0,0,0,0,1,0,-1.1,-4.0,Alex Len,0,1,0.0
3613,11/15/2022,29.416438356164385,W,0,5.066666666666666,2,2,1.0,0,0,,0,0,,0,1,1,0,0,0,0,0,4,3.7,0.0,Alex Len,2,2,1.0
3614,11/17/2022,29.421917808219177,W,0,1.6166666666666667,0,0,,0,0,,0,0,,0,0,0,0,0,0,0,0,0,0.0,0.0,Alex Len,0,0,
3615,10/27/2022,26.84109589041096,L,0,6.3,0,1,0.0,0,0,,0,2,0.0,2,0,2,1,0,0,0,2,0,-0.2,-9.0,Chima Moneke,0,1,0.0
3616,11/17/2022,26.898630136986302,W,0,1.6166666666666667,1,1,1.0,0,0,,0,0,,0,0,0,0,0,0,2,0,2,-0.3,0.0,Chima Moneke,1,1,1.0
3617,11/17/2022,22.85753424657534,W,0,1.6166666666666667,0,0,,0,0,,0,0,,0,0,0,0,0,0,0,1,0,-0.4,0.0,Keon Ellis,0,0,
3618,10/20/2022,29.405479452054795,W,1,21.75,2,8,0.25,1,3,0.333,4,7,0.571,0,4,4,0,1,0,4,3,9,0.0,-12.0,Norman Powell,1,5,0.2
3619,10/22/2022,29.410958904109588,W,1,32.03333333333333,1,10,0.1,0,2,0.0,2,2,1.0,0,3,3,4,0,0,2,0,4,-0.9,-1.0,Norman Powell,1,8,0.125
3620,10/23/2022,29.413698630136988,L,1,20.766666666666666,4,9,0.444,0,2,0.0,0,0,,0,3,3,0,2,0,3,2,8,2.4,-17.0,Norman Powell,4,7,0.5714285714285714
3621,10/25/2022,29.41917808219178,L,1,30.4,3,10,0.3,0,5,0.0,1,2,0.5,0,2,2,2,0,0,4,2,7,-2.0,-20.0,Norman Powell,3,5,0.6
3622,10/27/2022,29.424657534246574,L,1,31.383333333333333,9,15,0.6,2,7,0.286,1,2,0.5,1,2,3,2,0,1,3,2,21,13.3,-16.0,Norman Powell,7,8,0.875
3623,10/30/2022,29.432876712328767,L,0,25.116666666666667,7,14,0.5,3,7,0.429,1,2,0.5,2,1,3,3,0,1,2,1,18,12.7,-7.0,Norman Powell,4,7,0.5714285714285714
3624,10/31/2022,29.435616438356163,W,0,20.916666666666668,3,11,0.273,1,5,0.2,2,2,1.0,0,1,1,0,0,1,0,1,9,3.1,6.0,Norman Powell,2,6,0.3333333333333333
3625,11/2/2022,29.44109589041096,W,0,24.4,3,6,0.5,1,2,0.5,2,2,1.0,1,2,3,0,1,0,3,1,9,4.9,-8.0,Norman Powell,2,4,0.5
3626,11/4/2022,29.446575342465753,W,0,23.066666666666666,5,8,0.625,2,3,0.667,1,2,0.5,0,7,7,1,1,0,1,1,13,11.4,-17.0,Norman Powell,3,5,0.6
3627,11/6/2022,29.45205479452055,L,0,21.066666666666666,3,8,0.375,0,3,0.0,0,0,,0,2,2,1,1,0,0,3,6,2.7,-13.0,Norman Powell,3,5,0.6
3628,11/7/2022,29.454794520547946,W,0,27.55,5,6,0.833,1,1,1.0,6,7,0.857,0,1,1,0,2,0,0,5,17,14.7,3.0,Norman Powell,4,5,0.8
3629,11/9/2022,29.46027397260274,W,0,24.35,5,10,0.5,2,5,0.4,6,7,0.857,0,1,1,3,1,0,3,3,18,11.8,4.0,Norman Powell,3,5,0.6
3630,11/12/2022,29.46849315068493,L,0,26.516666666666666,6,14,0.429,1,1,1.0,3,3,1.0,1,1,2,1,2,1,0,1,16,12.6,1.0,Norman Powell,5,13,0.38461538461538464
3631,11/14/2022,29.473972602739725,W,0,23.033333333333335,4,10,0.4,1,6,0.167,8,9,0.889,0,3,3,3,2,0,3,2,17,12.4,13.0,Norman Powell,3,4,0.75
3632,11/15/2022,29.476712328767125,L,0,18.266666666666666,2,10,0.2,1,5,0.2,0,0,,0,2,2,1,0,0,0,1,5,-0.3,-11.0,Norman Powell,1,5,0.2
3633,11/17/2022,29.482191780821918,W,0,22.766666666666666,5,9,0.556,1,3,0.333,3,4,0.75,0,2,2,1,0,0,0,0,14,10.6,-16.0,Norman Powell,4,6,0.6666666666666666
3634,11/19/2022,29.487671232876714,W,0,31.016666666666666,10,16,0.625,5,8,0.625,1,2,0.5,0,1,1,2,2,0,1,3,26,19.9,10.0,Norman Powell,5,8,0.625
3635,11/21/2022,29.493150684931507,W,0,28.166666666666668,10,15,0.667,3,4,0.75,7,7,1.0,0,4,4,1,1,1,2,2,30,24.3,15.0,Norman Powell,7,11,0.6363636363636364
3636,11/23/2022,29.4986301369863,L,0,29.183333333333334,6,14,0.429,3,7,0.429,2,2,1.0,1,6,7,2,0,1,2,2,17,11.4,-14.0,Norman Powell,3,7,0.42857142857142855
3637,11/25/2022,29.504109589041096,L,0,23.783333333333335,3,8,0.375,2,3,0.667,3,6,0.5,0,1,1,2,0,1,2,0,11,5.8,-2.0,Norman Powell,1,5,0.2
3638,11/27/2022,29.50958904109589,W,0,26.3,7,19,0.368,2,8,0.25,3,4,0.75,1,4,5,2,1,0,0,2,19,11.6,0.0,Norman Powell,5,11,0.45454545454545453
3639,10/20/2022,32.512328767123286,W,1,23.466666666666665,3,9,0.333,1,3,0.333,1,2,0.5,0,1,1,4,1,0,2,0,8,4.6,9.0,Reggie Jackson,2,6,0.3333333333333333
3640,10/22/2022,32.51780821917808,W,1,26.766666666666666,4,5,0.8,3,3,1.0,3,3,1.0,0,2,2,5,1,0,3,2,14,13.4,0.0,Reggie Jackson,1,2,0.5
3641,10/23/2022,32.52054794520548,L,1,23.75,0,5,0.0,0,2,0.0,0,0,,0,2,2,2,1,0,0,0,0,-0.5,-14.0,Reggie Jackson,0,3,0.0
3642,10/25/2022,32.52602739726027,L,1,30.0,4,17,0.235,1,6,0.167,0,0,,0,3,3,6,0,0,3,2,9,0.0,-19.0,Reggie Jackson,3,11,0.2727272727272727
3643,10/27/2022,32.53150684931507,L,1,37.233333333333334,8,13,0.615,2,4,0.5,0,0,,0,2,2,4,1,0,0,1,18,16.1,-17.0,Reggie Jackson,6,9,0.6666666666666666
3644,10/30/2022,32.53972602739726,L,1,27.35,4,12,0.333,1,7,0.143,0,0,,2,3,5,3,1,0,4,1,9,3.2,-8.0,Reggie Jackson,3,5,0.6
3645,10/31/2022,32.54246575342466,W,1,30.033333333333335,2,11,0.182,0,6,0.0,2,2,1.0,1,1,2,6,0,0,1,1,6,2.9,0.0,Reggie Jackson,2,5,0.4
3646,11/2/2022,32.54794520547945,W,1,33.333333333333336,4,11,0.364,0,4,0.0,4,4,1.0,0,0,0,3,1,1,0,2,12,8.9,11.0,Reggie Jackson,4,7,0.5714285714285714
3647,11/4/2022,32.553424657534244,W,1,37.13333333333333,5,11,0.455,2,4,0.5,2,2,1.0,0,3,3,5,0,0,2,1,14,10.3,7.0,Reggie Jackson,3,7,0.42857142857142855
3648,11/6/2022,32.558904109589044,L,1,19.683333333333334,1,3,0.333,1,1,1.0,0,0,,0,1,1,0,1,0,1,1,3,1.2,3.0,Reggie Jackson,0,2,0.0
3649,11/7/2022,32.56164383561644,W,1,36.233333333333334,6,11,0.545,2,5,0.4,4,4,1.0,0,2,2,7,0,0,4,4,18,12.6,-2.0,Reggie Jackson,4,6,0.6666666666666666
3650,11/9/2022,32.56712328767123,W,1,24.033333333333335,7,14,0.5,0,2,0.0,0,0,,0,0,0,3,1,0,4,5,14,4.1,2.0,Reggie Jackson,7,12,0.5833333333333334
3651,11/12/2022,32.57534246575342,L,1,33.333333333333336,2,5,0.4,2,5,0.4,0,0,,1,5,6,6,1,0,3,2,6,6.9,-18.0,Reggie Jackson,0,0,
3652,11/14/2022,32.58082191780822,W,1,22.8,7,11,0.636,3,7,0.429,0,0,,0,2,2,6,0,0,3,4,17,12.3,7.0,Reggie Jackson,4,4,1.0
3653,11/15/2022,32.583561643835615,L,1,25.116666666666667,3,7,0.429,0,3,0.0,0,0,,0,4,4,2,1,0,2,0,6,3.9,6.0,Reggie Jackson,3,4,0.75
3654,11/17/2022,32.58904109589041,W,1,34.6,7,12,0.583,3,5,0.6,6,6,1.0,0,3,3,3,0,1,2,3,23,17.9,9.0,Reggie Jackson,4,7,0.5714285714285714
3655,11/19/2022,32.59452054794521,W,1,30.15,8,11,0.727,4,4,1.0,0,1,0.0,0,3,3,4,1,0,1,1,20,18.4,22.0,Reggie Jackson,4,7,0.5714285714285714
3656,11/21/2022,32.6,W,1,36.333333333333336,10,20,0.5,3,7,0.429,4,4,1.0,1,2,3,4,0,0,0,4,27,19.5,4.0,Reggie Jackson,7,13,0.5384615384615384
3657,11/23/2022,32.605479452054794,L,1,22.433333333333334,4,9,0.444,1,3,0.333,2,2,1.0,0,1,1,6,1,0,5,4,11,5.2,-8.0,Reggie Jackson,3,6,0.5
3658,11/25/2022,32.61095890410959,L,1,31.166666666666668,4,8,0.5,1,2,0.5,0,0,,0,5,5,8,0,0,4,1,9,7.7,-13.0,Reggie Jackson,3,6,0.5
3659,11/27/2022,32.61643835616438,W,1,25.966666666666665,2,10,0.2,1,5,0.2,0,0,,0,4,4,4,2,0,2,0,5,2.8,7.0,Reggie Jackson,1,5,0.2
3660,10/20/2022,25.59178082191781,W,1,35.36666666666667,6,6,1.0,0,0,,2,4,0.5,6,11,17,1,0,5,5,2,14,17.3,13.0,Ivica Zubac,6,6,1.0
3661,10/22/2022,25.5972602739726,W,1,24.166666666666668,4,7,0.571,0,0,,2,2,1.0,1,7,8,1,0,1,1,3,10,8.7,4.0,Ivica Zubac,4,7,0.5714285714285714
3662,10/23/2022,25.6,L,1,21.333333333333332,1,4,0.25,0,0,,0,0,,3,5,8,2,0,0,3,1,2,1.2,-8.0,Ivica Zubac,1,4,0.25
3663,10/25/2022,25.605479452054794,L,1,34.7,5,9,0.556,0,1,0.0,0,0,,4,10,14,2,0,7,1,2,10,16.0,-17.0,Ivica Zubac,5,8,0.625
3664,10/27/2022,25.610958904109587,L,1,34.35,4,9,0.444,0,0,,4,6,0.667,5,13,18,2,0,1,1,2,12,14.2,-14.0,Ivica Zubac,4,9,0.4444444444444444
3665,10/30/2022,25.61917808219178,L,1,23.433333333333334,2,3,0.667,0,0,,0,2,0.0,0,6,6,1,0,2,1,3,4,3.6,-10.0,Ivica Zubac,2,3,0.6666666666666666
3666,10/31/2022,25.621917808219177,W,1,31.666666666666668,6,8,0.75,0,0,,4,6,0.667,1,11,12,0,1,4,3,5,16,14.8,-2.0,Ivica Zubac,6,8,0.75
3667,11/2/2022,25.627397260273973,W,1,24.75,2,5,0.4,0,0,,1,2,0.5,1,5,6,2,1,1,2,5,5,3.2,3.0,Ivica Zubac,2,5,0.4
3668,11/4/2022,25.632876712328766,W,1,36.083333333333336,8,10,0.8,0,0,,1,2,0.5,1,14,15,2,1,4,4,4,17,17.3,15.0,Ivica Zubac,8,10,0.8
3669,11/6/2022,25.638356164383563,L,1,34.78333333333333,6,12,0.5,0,0,,0,0,,3,6,9,2,3,1,1,1,12,13.6,-1.0,Ivica Zubac,6,12,0.5
3670,11/7/2022,25.64109589041096,W,1,33.03333333333333,2,7,0.286,0,0,,6,8,0.75,4,5,9,0,1,1,0,1,10,10.7,-15.0,Ivica Zubac,2,7,0.2857142857142857
3671,11/9/2022,25.646575342465752,W,1,36.21666666666667,4,4,1.0,0,0,,2,5,0.4,2,6,8,2,1,2,2,3,10,11.4,-8.0,Ivica Zubac,4,4,1.0
3672,11/12/2022,25.654794520547945,L,1,27.7,6,8,0.75,0,0,,4,6,0.667,5,10,15,0,0,0,5,4,16,11.9,-5.0,Ivica Zubac,6,8,0.75
3673,11/14/2022,25.660273972602738,W,1,26.433333333333334,3,5,0.6,0,0,,3,3,1.0,3,4,7,1,0,1,2,2,9,8.6,8.0,Ivica Zubac,3,5,0.6
3674,11/15/2022,25.663013698630138,L,1,32.63333333333333,0,2,0.0,0,0,,3,4,0.75,2,5,7,4,0,2,1,5,3,5.3,-9.0,Ivica Zubac,0,2,0.0
3675,11/17/2022,25.66849315068493,W,1,39.53333333333333,3,8,0.375,0,0,,3,4,0.75,5,13,18,1,0,0,5,5,9,5.3,15.0,Ivica Zubac,3,8,0.375
3676,11/19/2022,25.673972602739727,W,1,23.983333333333334,0,1,0.0,0,0,,3,6,0.5,3,8,11,1,0,1,1,4,3,4.4,10.0,Ivica Zubac,0,1,0.0
3677,11/21/2022,25.67945205479452,W,1,35.233333333333334,6,8,0.75,0,0,,2,3,0.667,6,8,14,2,0,2,3,4,14,15.2,-3.0,Ivica Zubac,6,8,0.75
3678,11/23/2022,25.684931506849313,L,1,25.95,4,5,0.8,0,0,,0,0,,2,2,4,1,0,1,1,1,8,8.1,-8.0,Ivica Zubac,4,5,0.8
3679,11/25/2022,25.69041095890411,L,1,29.35,2,6,0.333,0,0,,2,2,1.0,2,7,9,0,0,0,1,2,6,4.3,-22.0,Ivica Zubac,2,6,0.3333333333333333
3680,11/27/2022,25.695890410958903,W,1,35.666666666666664,14,17,0.824,0,0,,3,3,1.0,12,17,29,3,0,3,5,6,31,35.0,13.0,Ivica Zubac,14,17,0.8235294117647058
3681,10/20/2022,26.005479452054793,W,0,5.583333333333333,0,0,,0,0,,0,0,,0,1,1,0,0,0,0,0,0,0.3,0.0,Terance Mann,0,0,
3682,10/22/2022,26.01095890410959,W,0,14.866666666666667,2,3,0.667,0,0,,1,2,0.5,1,1,2,1,0,0,0,2,5,4.2,0.0,Terance Mann,2,3,0.6666666666666666
3683,10/23/2022,26.013698630136986,L,0,9.366666666666667,4,5,0.8,1,2,0.5,0,0,,1,1,2,0,0,0,0,2,9,7.3,-8.0,Terance Mann,3,3,1.0
3684,10/25/2022,26.019178082191782,L,1,25.75,3,5,0.6,1,1,1.0,2,4,0.5,1,8,9,0,1,1,4,1,9,6.3,-14.0,Terance Mann,2,4,0.5
3685,10/27/2022,26.024657534246575,L,1,20.85,3,5,0.6,0,2,0.0,0,0,,1,0,1,0,1,1,3,4,6,1.5,8.0,Terance Mann,3,3,1.0
3686,10/30/2022,26.03287671232877,L,1,21.833333333333332,3,5,0.6,0,2,0.0,0,1,0.0,2,3,5,2,0,0,0,0,6,7.0,-9.0,Terance Mann,3,3,1.0
3687,10/31/2022,26.035616438356165,W,0,15.333333333333334,2,4,0.5,0,0,,0,0,,0,1,1,1,0,0,1,0,4,2.0,-10.0,Terance Mann,2,4,0.5
3688,11/2/2022,26.041095890410958,W,0,14.516666666666667,2,3,0.667,1,2,0.5,0,0,,0,2,2,2,0,1,0,1,5,6.0,-5.0,Terance Mann,1,1,1.0
3689,11/4/2022,26.046575342465754,W,0,3.3166666666666664,0,3,0.0,0,3,0.0,0,0,,1,0,1,0,0,0,2,2,0,-4.2,-4.0,Terance Mann,0,0,
3690,11/6/2022,26.052054794520547,L,1,29.75,7,8,0.875,0,1,0.0,0,0,,1,2,3,3,2,0,0,5,14,14.6,0.0,Terance Mann,7,7,1.0
3691,11/7/2022,26.054794520547944,W,1,30.35,6,9,0.667,1,2,0.5,3,4,0.75,0,4,4,5,2,0,1,1,16,17.0,20.0,Terance Mann,5,7,0.7142857142857143
3692,11/9/2022,26.06027397260274,W,0,21.483333333333334,3,7,0.429,1,2,0.5,0,0,,0,4,4,2,1,0,0,2,7,6.1,16.0,Terance Mann,2,5,0.4
3693,11/12/2022,26.068493150684933,L,0,19.15,1,5,0.2,0,3,0.0,0,0,,0,3,3,2,0,1,0,1,2,1.5,5.0,Terance Mann,1,2,0.5
3694,11/14/2022,26.073972602739726,W,0,24.166666666666668,4,7,0.571,0,2,0.0,6,7,0.857,0,4,4,4,0,0,1,2,14,12.5,6.0,Terance Mann,4,5,0.8
3695,11/15/2022,26.076712328767123,L,0,14.5,1,1,1.0,0,0,,0,0,,0,3,3,1,0,0,0,2,2,2.5,1.0,Terance Mann,1,1,1.0
3696,11/17/2022,26.08219178082192,W,0,14.65,2,4,0.5,0,2,0.0,1,1,1.0,1,1,2,0,0,0,0,2,5,3.2,-12.0,Terance Mann,2,2,1.0
3697,11/19/2022,26.087671232876712,W,0,28.416666666666668,3,4,0.75,2,2,1.0,2,2,1.0,2,1,3,1,0,0,4,2,10,6.0,0.0,Terance Mann,1,2,0.5
3698,11/21/2022,26.09315068493151,W,1,20.666666666666668,3,5,0.6,0,1,0.0,0,0,,0,2,2,1,1,0,1,3,6,3.8,-8.0,Terance Mann,3,4,0.75
3699,11/23/2022,26.0986301369863,L,1,33.03333333333333,7,11,0.636,3,3,1.0,0,0,,2,3,5,2,1,0,2,1,17,14.4,-3.0,Terance Mann,4,8,0.5
3700,11/25/2022,26.104109589041094,L,1,30.283333333333335,7,11,0.636,1,3,0.333,1,1,1.0,0,4,4,5,0,0,1,3,16,13.6,0.0,Terance Mann,6,8,0.75
3701,11/27/2022,26.10958904109589,W,1,38.05,5,13,0.385,0,3,0.0,4,4,1.0,2,5,7,5,0,0,2,3,14,10.1,17.0,Terance Mann,5,10,0.5
3702,10/20/2022,33.84931506849315,W,0,10.316666666666666,0,0,,0,0,,1,2,0.5,1,4,5,0,0,0,0,1,1,2.1,-5.0,Nicolas Batum,0,0,
3703,10/22/2022,33.85479452054795,W,0,28.016666666666666,3,3,1.0,1,1,1.0,0,0,,1,4,5,3,2,1,1,5,7,9.8,-3.0,Nicolas Batum,2,2,1.0
3704,10/23/2022,33.85753424657534,L,0,14.05,1,3,0.333,1,2,0.5,0,0,,0,3,3,0,0,0,0,1,3,1.8,-4.0,Nicolas Batum,0,1,0.0
3705,10/25/2022,33.863013698630134,L,1,18.066666666666666,2,4,0.5,2,3,0.667,2,2,1.0,1,3,4,1,0,1,0,2,8,8.2,-19.0,Nicolas Batum,0,1,0.0
3706,10/27/2022,33.868493150684934,L,0,21.1,3,4,0.75,1,2,0.5,0,0,,1,1,2,2,2,1,3,2,7,6.7,-14.0,Nicolas Batum,2,2,1.0
3707,10/30/2022,33.87671232876713,L,0,15.766666666666667,1,5,0.2,0,4,0.0,1,2,0.5,0,2,2,0,0,1,0,1,3,0.4,-11.0,Nicolas Batum,1,1,1.0
3708,10/31/2022,33.87945205479452,W,0,15.916666666666666,1,3,0.333,0,2,0.0,0,0,,1,2,3,3,0,2,2,2,2,2.3,-1.0,Nicolas Batum,1,1,1.0
3709,11/2/2022,33.88493150684931,W,0,14.116666666666667,1,4,0.25,1,3,0.333,1,1,1.0,0,3,3,2,1,2,0,6,4,3.9,2.0,Nicolas Batum,0,1,0.0
3710,11/4/2022,33.89041095890411,W,0,19.616666666666667,1,3,0.333,1,3,0.333,0,0,,1,3,4,2,0,1,1,5,3,2.0,-10.0,Nicolas Batum,0,0,
3711,11/6/2022,33.895890410958906,L,0,23.416666666666668,1,3,0.333,1,3,0.333,0,0,,0,3,3,2,0,1,1,3,3,2.1,7.0,Nicolas Batum,0,0,
3712,11/7/2022,33.8986301369863,W,0,15.233333333333333,1,4,0.25,1,3,0.333,0,0,,0,4,4,3,0,0,2,1,3,1.5,6.0,Nicolas Batum,0,1,0.0
3713,11/9/2022,33.9041095890411,W,0,15.65,0,1,0.0,0,1,0.0,2,2,1.0,3,3,6,1,0,0,1,2,2,3.2,1.0,Nicolas Batum,0,0,
3714,11/12/2022,33.912328767123284,L,0,17.6,0,5,0.0,0,3,0.0,0,0,,1,5,6,1,0,2,0,0,0,0.8,0.0,Nicolas Batum,0,2,0.0
3715,11/14/2022,33.917808219178085,W,0,19.383333333333333,4,7,0.571,2,5,0.4,0,2,0.0,1,5,6,0,1,1,1,3,10,7.6,10.0,Nicolas Batum,2,2,1.0
3716,11/15/2022,33.92054794520548,L,0,26.433333333333334,7,7,1.0,7,7,1.0,1,2,0.5,1,4,5,0,1,0,2,3,22,19.2,-10.0,Nicolas Batum,0,0,
3717,11/17/2022,33.92602739726027,W,0,13.916666666666666,0,1,0.0,0,1,0.0,0,0,,0,3,3,0,0,0,0,0,0,0.2,-10.0,Nicolas Batum,0,0,
3718,11/19/2022,33.93150684931507,W,0,15.95,1,4,0.25,1,3,0.333,0,0,,1,2,3,1,0,0,1,2,3,0.8,17.0,Nicolas Batum,0,1,0.0
3719,11/21/2022,33.93698630136986,W,0,25.083333333333332,3,5,0.6,1,3,0.333,0,0,,0,5,5,4,3,0,1,2,7,10.2,17.0,Nicolas Batum,2,2,1.0
3720,11/23/2022,33.942465753424656,L,0,10.816666666666666,0,4,0.0,0,2,0.0,0,0,,0,2,2,0,1,0,0,0,0,-1.2,-16.0,Nicolas Batum,0,2,0.0
3721,11/25/2022,33.94794520547945,L,0,24.183333333333334,0,3,0.0,0,3,0.0,0,0,,1,2,3,0,0,2,0,2,0,-0.2,14.0,Nicolas Batum,0,0,
3722,11/27/2022,33.95342465753425,W,0,23.916666666666668,2,5,0.4,0,3,0.0,0,0,,1,7,8,2,1,1,2,1,4,4.8,11.0,Nicolas Batum,2,2,1.0
3723,10/20/2022,33.131506849315066,W,1,22.966666666666665,5,9,0.556,1,3,0.333,3,3,1.0,1,3,4,1,1,0,1,2,14,11.2,11.0,Marcus Morris,4,6,0.6666666666666666
3724,10/22/2022,33.136986301369866,W,1,21.033333333333335,4,7,0.571,1,1,1.0,0,0,,0,5,5,2,1,0,0,5,9,7.6,2.0,Marcus Morris,3,6,0.5
3725,10/23/2022,33.13972602739726,L,1,31.416666666666668,10,14,0.714,2,5,0.4,0,0,,1,4,5,1,1,0,1,1,22,18.4,-10.0,Marcus Morris,8,9,0.8888888888888888
3726,10/30/2022,33.15890410958904,L,1,27.266666666666666,5,12,0.417,2,5,0.4,0,0,,0,8,8,4,1,0,1,4,12,9.2,-5.0,Marcus Morris,3,7,0.42857142857142855
3727,10/31/2022,33.16164383561644,W,1,37.13333333333333,5,14,0.357,1,7,0.143,0,0,,1,2,3,3,0,1,1,0,11,6.3,7.0,Marcus Morris,4,7,0.5714285714285714
3728,11/2/2022,33.16712328767123,W,1,34.9,8,14,0.571,4,8,0.5,1,1,1.0,1,9,10,2,2,0,1,0,21,20.2,15.0,Marcus Morris,4,6,0.6666666666666666
3729,11/4/2022,33.172602739726024,W,1,34.916666666666664,4,12,0.333,3,6,0.5,0,0,,0,8,8,4,1,0,1,5,11,7.4,14.0,Marcus Morris,1,6,0.16666666666666666
3730,11/6/2022,33.178082191780824,L,1,37.56666666666667,8,16,0.5,1,7,0.143,1,1,1.0,0,3,3,3,1,0,4,3,18,8.8,-19.0,Marcus Morris,7,9,0.7777777777777778
3731,11/7/2022,33.18082191780822,W,1,37.9,7,16,0.438,4,11,0.364,2,2,1.0,0,6,6,1,0,1,0,2,20,14.0,4.0,Marcus Morris,3,5,0.6
3732,11/9/2022,33.18630136986302,W,1,32.333333333333336,4,9,0.444,3,5,0.6,0,0,,0,8,8,1,2,2,1,4,11,10.2,12.0,Marcus Morris,1,4,0.25
3733,11/12/2022,33.1945205479452,L,1,28.233333333333334,5,9,0.556,3,5,0.6,0,0,,2,4,6,2,0,0,1,2,13,10.9,-13.0,Marcus Morris,2,4,0.5
3734,11/14/2022,33.2,W,1,24.95,6,9,0.667,3,4,0.75,0,0,,0,5,5,2,0,0,1,3,15,11.8,10.0,Marcus Morris,3,5,0.6
3735,11/15/2022,33.202739726027396,L,1,36.56666666666667,7,11,0.636,1,5,0.2,3,4,0.75,0,3,3,4,2,0,0,1,18,18.0,0.0,Marcus Morris,6,6,1.0
3736,11/17/2022,33.20821917808219,W,1,35.65,6,15,0.4,3,8,0.375,1,2,0.5,1,5,6,1,0,0,0,2,16,9.6,12.0,Marcus Morris,3,7,0.42857142857142855
3737,11/19/2022,33.21369863013699,W,1,25.366666666666667,4,9,0.444,3,7,0.429,0,0,,0,2,2,3,0,0,2,1,11,6.6,20.0,Marcus Morris,1,2,0.5
3738,11/21/2022,33.21917808219178,W,1,27.3,3,10,0.3,0,1,0.0,2,2,1.0,0,2,2,1,0,1,1,2,8,2.4,-16.0,Marcus Morris,3,9,0.3333333333333333
3739,11/23/2022,33.224657534246575,L,1,28.466666666666665,6,15,0.4,3,6,0.5,4,5,0.8,1,4,5,0,2,0,0,2,19,13.6,-10.0,Marcus Morris,3,9,0.3333333333333333
3740,11/25/2022,33.23013698630137,L,1,26.9,7,12,0.583,1,3,0.333,0,2,0.0,0,2,2,0,0,0,2,4,15,5.6,-18.0,Marcus Morris,6,9,0.6666666666666666
3741,11/27/2022,33.23561643835617,W,1,28.783333333333335,5,14,0.357,2,8,0.25,1,2,0.5,0,4,4,3,2,0,1,2,13,8.3,9.0,Marcus Morris,3,6,0.5
3742,10/22/2022,25.34794520547945,W,0,4.566666666666666,1,1,1.0,0,0,,1,2,0.5,0,1,1,0,0,0,1,0,3,1.6,0.0,Amir Coffey,1,1,1.0
3743,10/23/2022,25.350684931506848,L,0,2.8833333333333333,0,1,0.0,0,0,,0,0,,0,0,0,1,1,0,0,0,0,1.0,-2.0,Amir Coffey,0,1,0.0
3744,10/25/2022,25.356164383561644,L,0,26.433333333333334,1,5,0.2,0,1,0.0,6,6,1.0,0,2,2,2,0,1,0,2,8,6.8,13.0,Amir Coffey,1,4,0.25
3745,10/27/2022,25.361643835616437,L,0,5.733333333333333,0,3,0.0,0,1,0.0,0,0,,0,0,0,0,0,0,0,1,0,-2.5,9.0,Amir Coffey,0,2,0.0
3746,10/30/2022,25.36986301369863,L,0,13.933333333333334,2,2,1.0,0,0,,0,0,,0,1,1,2,0,0,1,0,4,4.1,-2.0,Amir Coffey,2,2,1.0
3747,10/31/2022,25.372602739726027,W,0,12.266666666666667,0,1,0.0,0,0,,3,4,0.75,2,1,3,0,0,0,0,2,3,2.8,-8.0,Amir Coffey,0,1,0.0
3748,11/2/2022,25.378082191780823,W,0,6.666666666666667,0,0,,0,0,,0,0,,0,1,1,0,0,0,0,0,0,0.3,-11.0,Amir Coffey,0,0,
3749,11/4/2022,25.383561643835616,W,0,11.583333333333334,1,2,0.5,1,2,0.5,3,4,0.75,0,0,0,0,2,0,0,1,6,6.2,-4.0,Amir Coffey,0,0,
3750,11/6/2022,25.389041095890413,L,0,0.9666666666666667,0,0,,0,0,,0,0,,0,0,0,0,0,0,0,0,0,0.0,3.0,Amir Coffey,0,0,
3751,11/9/2022,25.397260273972602,W,0,0.7166666666666667,0,0,,0,0,,0,0,,0,0,0,0,0,0,0,0,0,0.0,2.0,Amir Coffey,0,0,
3752,11/12/2022,25.405479452054795,L,0,2.35,1,2,0.5,0,0,,0,0,,0,0,0,0,0,0,0,0,2,1.0,1.0,Amir Coffey,1,2,0.5
3753,11/14/2022,25.410958904109588,W,0,18.916666666666668,0,2,0.0,0,0,,0,0,,1,0,1,2,0,0,1,1,0,-0.7,8.0,Amir Coffey,0,2,0.0
3754,11/15/2022,25.413698630136988,L,0,10.35,0,0,,0,0,,2,2,1.0,0,0,0,1,0,0,1,5,2,-0.3,0.0,Amir Coffey,0,0,
3755,11/19/2022,25.424657534246574,W,0,7.933333333333334,1,3,0.333,0,0,,1,2,0.5,1,0,1,0,0,0,0,1,3,1.2,-5.0,Amir Coffey,1,3,0.3333333333333333
3756,11/21/2022,25.43013698630137,W,0,21.866666666666667,3,7,0.429,0,1,0.0,2,2,1.0,3,2,5,0,1,0,0,2,8,7.2,14.0,Amir Coffey,3,6,0.5
3757,11/23/2022,25.435616438356163,L,1,35.916666666666664,5,7,0.714,0,1,0.0,3,4,0.75,1,2,3,7,0,0,2,2,13,13.1,-5.0,Amir Coffey,5,6,0.8333333333333334
3758,11/25/2022,25.44109589041096,L,1,24.8,3,6,0.5,2,4,0.5,1,2,0.5,1,1,2,3,0,0,1,2,9,6.9,-7.0,Amir Coffey,1,2,0.5
3759,11/27/2022,25.446575342465753,W,1,28.05,3,8,0.375,0,2,0.0,2,2,1.0,0,0,0,5,1,0,1,1,8,6.7,7.0,Amir Coffey,3,6,0.5
3760,10/20/2022,32.12054794520548,W,0,24.533333333333335,7,15,0.467,0,4,0.0,1,3,0.333,0,4,4,3,1,0,3,3,15,6.6,-3.0,John Wall,7,11,0.6363636363636364
3761,10/23/2022,32.12876712328767,L,0,21.366666666666667,7,12,0.583,2,4,0.5,1,5,0.2,0,0,0,4,1,0,0,1,17,13.2,-1.0,John Wall,5,8,0.625
3762,10/25/2022,32.134246575342466,L,0,19.5,4,9,0.444,1,3,0.333,3,4,0.75,1,2,3,4,2,0,4,2,12,8.2,2.0,John Wall,3,6,0.5
3763,10/27/2022,32.13972602739726,L,0,20.95,6,12,0.5,1,3,0.333,4,5,0.8,1,3,4,6,0,0,1,1,17,15.0,7.0,John Wall,5,9,0.5555555555555556
3764,10/30/2022,32.14794520547945,L,0,21.25,2,5,0.4,0,1,0.0,4,4,1.0,0,0,0,6,0,2,1,1,8,9.5,-19.0,John Wall,2,4,0.5
3765,11/2/2022,32.156164383561645,W,0,14.666666666666666,3,10,0.3,0,3,0.0,0,0,,1,0,1,4,2,0,2,0,6,3.7,-3.0,John Wall,3,7,0.42857142857142855
3766,11/4/2022,32.16164383561644,W,0,27.4,6,14,0.429,2,6,0.333,1,2,0.5,0,3,3,6,0,0,0,3,15,11.1,6.0,John Wall,4,8,0.5
3767,11/6/2022,32.16712328767123,L,0,28.316666666666666,6,15,0.4,0,4,0.0,0,4,0.0,0,3,3,6,2,0,1,3,12,7.2,-11.0,John Wall,6,11,0.5454545454545454
3768,11/9/2022,32.175342465753424,W,0,23.233333333333334,3,10,0.3,1,5,0.2,3,3,1.0,1,3,4,6,2,1,0,1,10,12.3,9.0,John Wall,2,5,0.4
3769,11/12/2022,32.18356164383562,L,0,24.416666666666668,5,11,0.455,2,4,0.5,2,3,0.667,0,1,1,6,1,0,3,2,14,9.6,-12.0,John Wall,3,7,0.42857142857142855
3770,11/15/2022,32.19178082191781,L,0,26.35,6,11,0.545,1,3,0.333,4,6,0.667,0,6,6,4,1,0,3,4,17,11.9,11.0,John Wall,5,8,0.625
3771,11/17/2022,32.1972602739726,W,0,13.4,1,4,0.25,1,2,0.5,0,0,,0,1,1,4,0,0,6,1,3,-2.7,-4.0,John Wall,0,2,0.0
3772,11/19/2022,32.202739726027396,W,0,23.766666666666666,2,8,0.25,0,3,0.0,1,2,0.5,0,4,4,15,4,0,1,1,5,14.1,21.0,John Wall,2,5,0.4
3773,11/21/2022,32.20821917808219,W,0,22.25,5,10,0.5,2,4,0.5,1,1,1.0,2,3,5,8,0,1,8,1,13,8.2,0.0,John Wall,3,6,0.5
3774,11/23/2022,32.21369863013699,L,0,20.633333333333333,2,7,0.286,0,3,0.0,5,8,0.625,0,4,4,3,0,0,3,0,9,4.0,-25.0,John Wall,2,4,0.5
3775,11/25/2022,32.21917808219178,L,0,23.866666666666667,8,10,0.8,2,2,1.0,5,8,0.625,0,0,0,2,1,0,1,4,23,17.8,-14.0,John Wall,6,8,0.75
3776,11/27/2022,32.224657534246575,W,0,22.266666666666666,3,6,0.5,1,3,0.333,3,5,0.6,0,2,2,8,0,0,3,1,10,9.0,7.0,John Wall,2,3,0.6666666666666666
3777,10/20/2022,32.46849315068493,W,1,36.18333333333333,4,12,0.333,2,7,0.286,5,6,0.833,1,9,10,4,2,0,5,5,15,9.0,16.0,Paul George,2,5,0.4
3778,10/22/2022,32.47397260273973,W,1,38.583333333333336,16,31,0.516,3,10,0.3,5,5,1.0,2,4,6,6,2,1,4,2,40,29.4,-4.0,Paul George,13,21,0.6190476190476191
3779,10/23/2022,32.47671232876712,L,1,33.666666666666664,4,11,0.364,2,6,0.333,6,6,1.0,0,7,7,4,2,0,2,2,16,14.0,-7.0,Paul George,2,5,0.4
3780,10/27/2022,32.487671232876714,L,1,30.983333333333334,4,12,0.333,0,4,0.0,2,2,1.0,0,7,7,3,0,0,3,1,10,4.0,-25.0,Paul George,4,8,0.5
3781,10/30/2022,32.49589041095891,L,1,27.766666666666666,5,19,0.263,2,8,0.25,2,2,1.0,1,2,3,3,1,0,4,3,14,1.9,-10.0,Paul George,3,11,0.2727272727272727
3782,10/31/2022,32.4986301369863,W,1,37.96666666666667,15,26,0.577,5,10,0.5,0,1,0.0,0,9,9,8,6,2,3,3,35,33.9,16.0,Paul George,10,16,0.625
3783,11/2/2022,32.50410958904109,W,1,36.85,10,20,0.5,3,8,0.375,5,6,0.833,1,3,4,5,1,0,5,1,28,18.3,14.0,Paul George,7,12,0.5833333333333334
3784,11/4/2022,32.50958904109589,W,1,37.516666666666666,11,16,0.688,4,6,0.667,6,7,0.857,0,2,2,6,1,0,5,2,32,24.8,16.0,Paul George,7,10,0.7
3785,11/6/2022,32.515068493150686,L,1,38.03333333333333,11,22,0.5,5,14,0.357,7,8,0.875,0,8,8,4,1,0,5,5,34,21.8,1.0,Paul George,6,8,0.75
3786,11/7/2022,32.51780821917808,W,1,39.68333333333333,10,20,0.5,5,11,0.455,1,3,0.333,0,5,5,3,1,0,1,2,26,18.0,-4.0,Paul George,5,9,0.5555555555555556
3787,11/9/2022,32.52328767123288,W,1,36.266666666666666,10,17,0.588,2,7,0.286,7,9,0.778,0,6,6,4,1,2,4,3,29,22.1,16.0,Paul George,8,10,0.8
3788,11/12/2022,32.53150684931507,L,1,34.1,5,21,0.238,1,6,0.167,6,7,0.857,0,4,4,4,0,2,2,3,17,6.1,-19.0,Paul George,4,15,0.26666666666666666
3789,11/14/2022,32.536986301369865,W,1,29.083333333333332,7,18,0.389,2,7,0.286,6,8,0.75,1,7,8,5,2,0,1,2,22,17.9,8.0,Paul George,5,11,0.45454545454545453
3790,11/15/2022,32.53972602739726,L,1,41.46666666666667,7,13,0.538,1,3,0.333,8,8,1.0,0,7,7,6,2,0,10,4,23,13.4,2.0,Paul George,6,10,0.6
3791,11/17/2022,32.54520547945206,W,1,35.81666666666667,5,18,0.278,3,6,0.5,3,3,1.0,2,7,9,3,1,0,4,5,16,6.0,4.0,Paul George,2,12,0.16666666666666666
3792,11/19/2022,32.55068493150685,W,1,14.816666666666666,8,12,0.667,5,8,0.625,0,0,,0,1,1,1,2,0,0,0,21,18.8,25.0,Paul George,3,4,0.75
3793,10/20/2022,26.323287671232876,W,0,24.066666666666666,4,6,0.667,3,3,1.0,0,0,,0,1,1,1,0,0,0,3,11,8.2,-1.0,Luke Kennard,1,3,0.3333333333333333
3794,10/22/2022,26.328767123287673,W,0,27.9,4,11,0.364,1,4,0.25,2,2,1.0,0,1,1,0,0,0,0,0,11,5.2,15.0,Luke Kennard,3,7,0.42857142857142855
3795,10/23/2022,26.33150684931507,L,0,17.8,1,4,0.25,0,1,0.0,0,0,,0,3,3,0,0,0,3,3,2,-3.7,-4.0,Luke Kennard,1,3,0.3333333333333333
3796,10/25/2022,26.336986301369862,L,0,28.966666666666665,6,13,0.462,3,7,0.429,0,0,,0,4,4,2,1,0,1,1,15,10.5,2.0,Luke Kennard,3,6,0.5
3797,10/27/2022,26.34246575342466,L,0,17.05,4,5,0.8,2,3,0.667,0,0,,1,0,1,0,1,0,4,1,10,5.4,-2.0,Luke Kennard,2,2,1.0
3798,10/30/2022,26.350684931506848,L,0,22.733333333333334,3,5,0.6,1,3,0.333,0,0,,1,5,6,0,0,0,0,1,7,6.5,-15.0,Luke Kennard,2,2,1.0
3799,10/31/2022,26.353424657534248,W,1,34.21666666666667,3,8,0.375,2,6,0.333,0,0,,1,9,10,2,0,0,2,3,8,5.2,3.0,Luke Kennard,1,2,0.5
3800,11/2/2022,26.35890410958904,W,1,23.6,2,3,0.667,2,3,0.667,0,0,,1,5,6,0,1,0,1,1,6,6.5,16.0,Luke Kennard,0,0,
3801,11/4/2022,26.364383561643837,W,1,9.366666666666667,1,1,1.0,0,0,,0,0,,0,1,1,0,0,0,0,1,2,1.6,12.0,Luke Kennard,1,1,1.0
3802,11/7/2022,26.372602739726027,W,0,12.65,2,4,0.5,2,4,0.5,0,0,,0,0,0,0,2,0,0,1,6,5.6,-3.0,Luke Kennard,0,0,
3803,11/9/2022,26.378082191780823,W,1,24.916666666666668,5,9,0.556,3,6,0.5,0,0,,0,3,3,2,1,0,0,1,13,11.6,9.0,Luke Kennard,2,3,0.6666666666666666
3804,11/12/2022,26.386301369863013,L,1,24.25,3,5,0.6,2,4,0.5,1,1,1.0,0,3,3,0,0,0,2,2,9,4.8,-16.0,Luke Kennard,1,1,1.0
3805,11/14/2022,26.39178082191781,W,1,27.566666666666666,3,6,0.5,2,4,0.5,0,0,,0,1,1,1,1,0,2,1,8,4.6,7.0,Luke Kennard,1,2,0.5
3806,11/15/2022,26.394520547945206,L,1,2.8833333333333333,0,0,,0,0,,0,0,,0,1,1,0,1,0,0,1,0,0.9,1.0,Luke Kennard,0,0,
3807,10/23/2022,23.027397260273972,L,0,2.8833333333333333,1,1,1.0,0,0,,0,0,,0,0,0,0,0,0,0,1,2,1.3,-2.0,Moses Brown,1,1,1.0
3808,10/25/2022,23.03287671232877,L,0,2.65,0,1,0.0,0,0,,0,0,,0,2,2,0,0,1,0,0,0,0.6,2.0,Moses Brown,0,1,0.0
3809,10/27/2022,23.03835616438356,L,0,1.7833333333333332,1,1,1.0,0,0,,1,2,0.5,0,0,0,0,0,1,0,0,3,3.0,6.0,Moses Brown,1,1,1.0
3810,10/30/2022,23.046575342465754,L,0,4.516666666666667,0,0,,0,0,,0,0,,0,0,0,0,0,0,0,0,0,0.0,-3.0,Moses Brown,0,0,
3811,11/2/2022,23.054794520547944,W,0,12.2,6,8,0.75,0,0,,1,3,0.333,3,4,7,0,0,1,0,3,13,11.8,6.0,Moses Brown,6,8,0.75
3812,11/9/2022,23.073972602739726,W,0,0.7166666666666667,0,0,,0,0,,0,0,,0,1,1,0,0,0,0,0,0,0.3,2.0,Moses Brown,0,0,
3813,11/12/2022,23.08219178082192,L,0,2.35,0,0,,0,0,,0,0,,0,0,0,0,0,0,0,0,0,0.0,1.0,Moses Brown,0,0,
3814,11/14/2022,23.087671232876712,W,0,5.083333333333333,2,2,1.0,0,0,,2,2,1.0,2,1,3,0,0,1,0,0,6,7.8,-3.0,Moses Brown,2,2,1.0
3815,11/17/2022,23.095890410958905,W,0,5.15,2,2,1.0,0,0,,0,0,,1,1,2,0,0,0,1,1,4,3.0,1.0,Moses Brown,2,2,1.0
3816,11/19/2022,23.101369863013698,W,0,9.65,2,2,1.0,0,0,,2,4,0.5,0,2,2,0,0,0,0,5,6,3.2,-5.0,Moses Brown,2,2,1.0
3817,11/23/2022,23.112328767123287,L,0,12.35,4,7,0.571,0,0,,2,6,0.333,3,3,6,0,0,0,0,1,10,7.7,4.0,Moses Brown,4,7,0.5714285714285714
3818,11/25/2022,23.117808219178084,L,0,5.866666666666667,1,1,1.0,0,0,,1,6,0.167,0,1,1,0,0,0,0,0,3,1.0,9.0,Moses Brown,1,1,1.0
3819,11/27/2022,23.123287671232877,W,0,11.0,1,2,0.5,0,0,,8,12,0.667,2,1,3,1,0,0,2,2,10,7.0,-1.0,Moses Brown,1,2,0.5
3820,10/20/2022,31.84931506849315,W,0,14.483333333333333,0,3,0.0,0,2,0.0,2,2,1.0,0,4,4,2,0,2,0,2,2,3.1,-3.0,Robert Covington,0,1,0.0
3821,10/22/2022,31.854794520547944,W,0,22.066666666666666,2,3,0.667,0,1,0.0,4,4,1.0,0,7,7,2,2,0,1,2,8,10.4,-3.0,Robert Covington,2,2,1.0
3822,10/23/2022,31.85753424657534,L,0,14.25,1,5,0.2,1,4,0.25,0,0,,1,3,4,0,0,0,0,2,3,0.7,-5.0,Robert Covington,0,1,0.0
3823,10/25/2022,31.863013698630137,L,0,20.883333333333333,4,6,0.667,2,4,0.5,0,0,,0,4,4,2,1,3,1,4,10,10.5,-2.0,Robert Covington,2,2,1.0
3824,10/27/2022,31.86849315068493,L,0,15.0,1,2,0.5,1,2,0.5,0,0,,0,4,4,1,0,0,1,2,3,2.1,6.0,Robert Covington,0,0,
3825,11/6/2022,31.895890410958906,L,0,6.416666666666667,0,0,,0,0,,0,0,,0,0,0,1,0,0,0,2,0,-0.1,-10.0,Robert Covington,0,0,
3826,11/7/2022,31.898630136986302,W,0,7.333333333333333,1,2,0.5,1,1,1.0,0,0,,0,0,0,0,0,0,1,2,3,0.2,1.0,Robert Covington,0,1,0.0
3827,11/14/2022,31.91780821917808,W,0,18.566666666666666,1,4,0.25,1,3,0.333,1,2,0.5,1,3,4,1,0,1,1,3,4,2.0,6.0,Robert Covington,0,1,0.0
3828,11/15/2022,31.92054794520548,L,0,5.433333333333334,1,2,0.5,1,2,0.5,0,0,,0,2,2,0,0,0,2,1,3,0.2,-1.0,Robert Covington,0,0,
3829,11/19/2022,31.931506849315067,W,0,6.816666666666666,0,3,0.0,0,2,0.0,0,0,,0,3,3,0,0,0,0,0,0,-1.2,-5.0,Robert Covington,0,1,0.0
3830,11/23/2022,31.942465753424656,L,0,21.216666666666665,1,7,0.143,1,4,0.25,0,0,,0,6,6,1,0,0,1,0,3,0.0,0.0,Robert Covington,0,3,0.0
3831,11/25/2022,31.947945205479453,L,0,19.8,2,3,0.667,2,2,1.0,6,7,0.857,0,6,6,2,0,2,2,2,12,12.1,3.0,Robert Covington,0,1,0.0
3832,10/20/2022,31.30958904109589,W,0,21.283333333333335,6,12,0.5,1,4,0.25,1,2,0.5,1,6,7,2,1,0,2,3,14,9.3,5.0,Kawhi Leonard,5,8,0.625
3833,10/23/2022,31.317808219178083,L,0,20.7,2,6,0.333,0,2,0.0,7,7,1.0,3,3,6,2,2,0,2,2,11,11.2,1.0,Kawhi Leonard,2,4,0.5
3834,11/17/2022,31.386301369863013,W,1,24.516666666666666,2,8,0.25,0,3,0.0,2,4,0.5,0,5,5,4,0,0,0,2,6,3.9,26.0,Kawhi Leonard,2,5,0.4
3835,11/19/2022,31.39178082191781,W,1,22.133333333333333,5,8,0.625,1,3,0.333,0,0,,0,1,1,4,0,0,1,0,11,9.5,0.0,Kawhi Leonard,4,5,0.8
3836,11/21/2022,31.397260273972602,W,1,23.1,4,11,0.364,0,3,0.0,0,0,,0,1,1,5,0,1,0,0,8,6.4,12.0,Kawhi Leonard,4,8,0.5
3837,10/23/2022,20.9013698630137,L,0,2.8833333333333333,0,1,0.0,0,1,0.0,0,0,,0,0,0,0,0,0,0,0,0,-0.7,-2.0,Brandon Boston Jr.,0,0,
3838,10/25/2022,20.90684931506849,L,0,2.65,3,4,0.75,0,0,,0,0,,0,0,0,0,0,0,0,0,6,4.4,2.0,Brandon Boston Jr.,3,4,0.75
3839,10/27/2022,20.912328767123288,L,0,1.7833333333333332,0,0,,0,0,,0,0,,0,0,0,0,0,0,0,0,0,0.0,6.0,Brandon Boston Jr.,0,0,
3840,10/30/2022,20.92054794520548,L,0,4.516666666666667,2,4,0.5,2,2,1.0,0,0,,0,0,0,0,0,0,0,0,6,4.0,-3.0,Brandon Boston Jr.,0,2,0.0
3841,10/31/2022,20.923287671232877,W,0,4.55,0,1,0.0,0,0,,1,2,0.5,1,1,2,0,0,0,0,1,1,0.5,-1.0,Brandon Boston Jr.,0,1,0.0
3842,10/27/2022,20.764383561643836,L,0,1.7833333333333332,1,1,1.0,0,0,,1,1,1.0,0,2,2,1,1,0,0,0,3,5.0,6.0,Moussa Diabaté,1,1,1.0
3843,10/30/2022,20.77260273972603,L,0,4.516666666666667,0,0,,0,0,,0,0,,0,0,0,0,0,0,0,0,0,0.0,-3.0,Moussa Diabaté,0,0,
3844,10/23/2022,23.202739726027396,L,0,2.8833333333333333,0,1,0.0,0,1,0.0,0,2,0.0,0,0,0,0,0,0,0,0,0,-1.5,-2.0,Jason Preston,0,0,
3845,10/18/2022,23.33150684931507,W,0,28.183333333333334,4,15,0.267,2,9,0.222,2,2,1.0,0,2,2,7,2,0,4,2,12,5.8,1.0,Jordan Poole,2,6,0.3333333333333333
3846,10/21/2022,23.339726027397262,L,0,27.333333333333332,2,5,0.4,0,2,0.0,3,4,0.75,0,1,1,7,3,0,4,0,7,8.1,-20.0,Jordan Poole,2,3,0.6666666666666666
3847,10/23/2022,23.345205479452055,W,0,27.05,7,14,0.5,3,5,0.6,7,9,0.778,0,0,0,4,1,0,1,2,24,18.2,-18.0,Jordan Poole,4,9,0.4444444444444444
3848,10/25/2022,23.350684931506848,L,0,27.083333333333332,6,12,0.5,2,5,0.4,3,4,0.75,0,2,2,5,0,0,1,5,17,11.7,-15.0,Jordan Poole,4,7,0.5714285714285714
3849,10/27/2022,23.356164383561644,W,0,21.35,4,7,0.571,1,4,0.25,2,2,1.0,0,1,1,7,1,0,2,2,11,11.1,-1.0,Jordan Poole,3,3,1.0
3850,10/29/2022,23.361643835616437,L,0,36.5,10,20,0.5,4,11,0.364,0,0,,0,2,2,4,2,1,3,4,24,15.5,2.0,Jordan Poole,6,9,0.6666666666666666
3851,10/30/2022,23.364383561643837,L,1,36.03333333333333,10,21,0.476,5,13,0.385,5,5,1.0,1,2,3,4,2,0,3,4,30,20.8,-1.0,Jordan Poole,5,8,0.625
3852,11/1/2022,23.36986301369863,L,0,28.883333333333333,3,10,0.3,1,7,0.143,2,4,0.5,0,2,2,2,0,0,5,2,9,-1.4,-23.0,Jordan Poole,2,3,0.6666666666666666
3853,11/3/2022,23.375342465753423,L,0,24.316666666666666,4,12,0.333,1,5,0.2,2,3,0.667,1,1,2,2,0,0,4,2,11,1.4,-10.0,Jordan Poole,3,7,0.42857142857142855
3854,11/4/2022,23.378082191780823,L,1,38.4,5,18,0.278,3,10,0.3,7,7,1.0,0,0,0,9,2,0,5,2,20,11.9,-1.0,Jordan Poole,2,8,0.25
3855,11/7/2022,23.386301369863013,W,0,21.816666666666666,1,4,0.25,0,2,0.0,0,1,0.0,1,0,1,3,0,0,3,2,2,-1.8,-11.0,Jordan Poole,1,2,0.5
3856,11/11/2022,23.397260273972602,W,0,33.5,6,13,0.462,4,8,0.5,2,2,1.0,0,4,4,3,0,0,3,2,18,10.8,1.0,Jordan Poole,2,5,0.4
3857,11/13/2022,23.4027397260274,L,0,20.35,6,14,0.429,3,7,0.429,3,3,1.0,0,3,3,1,1,0,4,3,18,8.0,-1.0,Jordan Poole,3,7,0.42857142857142855
3858,11/14/2022,23.405479452054795,W,1,29.133333333333333,13,20,0.65,5,10,0.5,5,6,0.833,0,2,2,2,3,1,0,1,36,32.1,33.0,Jordan Poole,8,10,0.8
3859,11/16/2022,23.410958904109588,L,0,26.75,0,5,0.0,0,3,0.0,2,2,1.0,1,1,2,8,0,1,1,2,2,4.0,-2.0,Jordan Poole,0,2,0.0
3860,11/18/2022,23.416438356164385,W,0,26.15,5,17,0.294,3,8,0.375,0,0,,1,2,3,4,0,1,3,3,13,3.7,-15.0,Jordan Poole,2,9,0.2222222222222222
3861,11/20/2022,23.421917808219177,W,0,24.55,3,8,0.375,1,2,0.5,3,3,1.0,0,2,2,4,0,1,1,0,10,8.7,-6.0,Jordan Poole,2,6,0.3333333333333333
3862,11/21/2022,23.424657534246574,L,1,26.933333333333334,9,18,0.5,2,9,0.222,6,7,0.857,0,0,0,0,1,1,4,1,26,13.9,-25.0,Jordan Poole,7,9,0.7777777777777778
3863,11/23/2022,23.43013698630137,W,0,21.633333333333333,3,15,0.2,0,8,0.0,2,3,0.667,0,1,1,5,0,1,2,3,8,-0.4,19.0,Jordan Poole,3,7,0.42857142857142855
3864,11/25/2022,23.435616438356163,W,0,25.55,7,15,0.467,2,8,0.25,3,3,1.0,0,4,4,6,0,0,3,1,19,13.3,4.0,Jordan Poole,5,7,0.7142857142857143
3865,11/27/2022,23.44109589041096,W,0,26.866666666666667,9,17,0.529,3,9,0.333,3,4,0.75,1,3,4,6,0,0,4,4,24,15.5,9.0,Jordan Poole,6,8,0.75
3866,10/18/2022,26.695890410958903,W,1,21.133333333333333,3,4,0.75,0,0,,1,1,1.0,2,4,6,2,1,0,0,2,7,9.6,30.0,Kevon Looney,3,4,0.75
3867,10/21/2022,26.704109589041096,L,1,18.75,2,4,0.5,0,0,,0,0,,0,1,1,4,0,0,0,3,4,3.9,3.0,Kevon Looney,2,4,0.5
3868,10/23/2022,26.70958904109589,W,1,24.766666666666666,3,4,0.75,0,0,,0,2,0.0,2,6,8,6,0,1,0,3,6,10.5,18.0,Kevon Looney,3,4,0.75
3869,10/25/2022,26.715068493150685,L,1,17.116666666666667,3,3,1.0,0,0,,0,0,,2,2,4,3,0,0,1,4,6,6.6,-4.0,Kevon Looney,3,3,1.0
3870,10/27/2022,26.720547945205478,W,1,29.2,3,5,0.6,0,0,,1,2,0.5,2,6,8,4,0,0,1,2,7,8.5,12.0,Kevon Looney,3,5,0.6
3871,10/29/2022,26.726027397260275,L,1,27.766666666666666,3,6,0.5,0,0,,4,6,0.667,4,5,9,4,0,1,0,2,10,13.2,-3.0,Kevon Looney,3,6,0.5
3872,10/30/2022,26.72876712328767,L,1,21.533333333333335,1,4,0.25,0,0,,0,0,,6,3,9,2,0,0,0,2,2,5.3,-17.0,Kevon Looney,1,4,0.25
3873,11/1/2022,26.734246575342464,L,1,23.85,2,2,1.0,0,0,,0,0,,0,3,3,2,1,0,0,3,4,5.5,11.0,Kevon Looney,2,2,1.0
3874,11/3/2022,26.73972602739726,L,1,29.366666666666667,8,11,0.727,0,0,,1,1,1.0,2,5,7,3,1,0,0,5,17,16.5,10.0,Kevon Looney,8,11,0.7272727272727273
3875,11/4/2022,26.742465753424657,L,1,24.583333333333332,2,3,0.667,0,0,,1,1,1.0,1,4,5,2,0,0,0,5,5,5.0,-7.0,Kevon Looney,2,3,0.6666666666666666
3876,11/7/2022,26.75068493150685,W,1,20.716666666666665,1,4,0.25,0,0,,0,0,,3,10,13,4,1,1,0,4,2,7.6,8.0,Kevon Looney,1,4,0.25
3877,11/11/2022,26.76164383561644,W,1,30.416666666666668,3,4,0.75,0,0,,1,1,1.0,1,8,9,3,0,2,2,4,7,8.4,7.0,Kevon Looney,3,4,0.75
3878,11/13/2022,26.767123287671232,L,1,29.35,4,7,0.571,0,0,,0,0,,6,4,10,2,0,2,3,4,8,8.3,-4.0,Kevon Looney,4,7,0.5714285714285714
3879,11/14/2022,26.76986301369863,W,1,17.55,1,3,0.333,0,0,,0,0,,1,3,4,4,1,0,0,0,2,5.7,17.0,Kevon Looney,1,3,0.3333333333333333
3880,11/16/2022,26.775342465753425,L,1,20.416666666666668,5,6,0.833,0,0,,0,0,,2,6,8,2,0,1,0,2,10,12.3,-11.0,Kevon Looney,5,6,0.8333333333333334
3881,11/18/2022,26.78082191780822,W,1,23.85,1,2,0.5,0,0,,3,4,0.75,3,5,8,3,1,0,0,4,5,8.7,20.0,Kevon Looney,1,2,0.5
3882,11/20/2022,26.786301369863015,W,1,28.766666666666666,1,2,0.5,0,0,,1,2,0.5,2,5,7,5,0,1,0,6,3,6.3,0.0,Kevon Looney,1,2,0.5
3883,11/21/2022,26.78904109589041,L,1,5.383333333333334,0,0,,0,0,,0,0,,0,3,3,0,0,0,1,1,0,-0.5,-8.0,Kevon Looney,0,0,
3884,11/23/2022,26.794520547945204,W,1,16.516666666666666,4,4,1.0,0,0,,1,3,0.333,0,3,3,2,2,2,0,5,9,10.7,7.0,Kevon Looney,4,4,1.0
3885,11/25/2022,26.8,W,1,27.933333333333334,5,8,0.625,0,0,,0,1,0.0,7,5,12,4,0,0,2,1,10,12.8,2.0,Kevon Looney,5,8,0.625
3886,11/27/2022,26.805479452054794,W,1,22.116666666666667,1,1,1.0,0,0,,0,0,,2,5,7,4,1,0,0,2,2,7.6,23.0,Kevon Looney,1,1,1.0
3887,10/18/2022,34.5972602739726,W,1,32.8,10,22,0.455,4,13,0.308,9,9,1.0,1,5,6,7,4,1,4,1,33,29.0,20.0,Stephen Curry,6,9,0.6666666666666666
3888,10/21/2022,34.605479452054794,L,1,35.916666666666664,10,22,0.455,5,11,0.455,9,9,1.0,1,4,5,4,0,0,3,2,34,23.5,9.0,Stephen Curry,5,11,0.45454545454545453
3889,10/23/2022,34.61095890410959,W,1,31.35,11,22,0.5,7,12,0.583,4,4,1.0,0,5,5,2,1,0,2,3,33,22.7,19.0,Stephen Curry,4,10,0.4
3890,10/25/2022,34.61643835616438,L,1,29.916666666666668,7,17,0.412,4,9,0.444,3,5,0.6,0,7,7,8,1,0,1,1,21,18.4,-17.0,Stephen Curry,3,8,0.375
3891,10/27/2022,34.62191780821918,W,1,36.95,13,22,0.591,7,14,0.5,0,0,,1,6,7,9,1,0,3,0,33,29.6,13.0,Stephen Curry,6,8,0.75
3892,10/29/2022,34.62739726027397,L,1,38.9,10,22,0.455,3,13,0.231,8,8,1.0,0,11,11,6,1,0,2,5,31,24.1,-6.0,Stephen Curry,7,9,0.7777777777777778
3893,10/30/2022,34.63013698630137,L,1,34.96666666666667,10,24,0.417,4,14,0.286,8,9,0.889,0,6,6,3,2,0,1,1,32,23.3,-12.0,Stephen Curry,6,10,0.6
3894,11/1/2022,34.635616438356166,L,1,34.5,7,14,0.5,4,10,0.4,5,5,1.0,4,9,13,13,1,0,5,3,23,25.4,3.0,Stephen Curry,3,4,0.75
3895,11/3/2022,34.64109589041096,L,1,38.333333333333336,13,22,0.591,8,15,0.533,5,5,1.0,1,2,3,9,0,0,5,3,39,30.2,4.0,Stephen Curry,5,7,0.7142857142857143
3896,11/7/2022,34.652054794520545,W,1,37.71666666666667,17,24,0.708,7,12,0.583,6,7,0.857,0,8,8,8,0,0,0,2,47,43.8,20.0,Stephen Curry,10,12,0.8333333333333334
3897,11/11/2022,34.66301369863014,W,1,34.0,15,23,0.652,6,11,0.545,4,6,0.667,0,4,4,5,1,0,2,4,40,31.2,7.0,Stephen Curry,9,12,0.75
3898,11/13/2022,34.66849315068493,L,1,36.85,9,17,0.529,3,9,0.333,6,6,1.0,0,6,6,4,1,0,4,0,27,20.3,0.0,Stephen Curry,6,8,0.75
3899,11/14/2022,34.67123287671233,W,1,27.016666666666666,5,11,0.455,3,7,0.429,3,3,1.0,1,4,5,5,1,0,1,1,16,15.3,17.0,Stephen Curry,2,4,0.5
3900,11/16/2022,34.676712328767124,L,1,36.233333333333334,17,28,0.607,7,11,0.636,9,9,1.0,0,9,9,6,0,1,3,2,50,41.0,-14.0,Stephen Curry,10,17,0.5882352941176471
3901,11/18/2022,34.68219178082192,W,1,33.833333333333336,9,19,0.474,5,13,0.385,1,3,0.333,0,6,6,10,2,0,5,2,24,18.5,18.0,Stephen Curry,4,6,0.6666666666666666
3902,11/20/2022,34.68767123287671,W,1,36.983333333333334,11,20,0.55,7,14,0.5,4,5,0.8,0,6,6,15,3,2,1,3,33,37.5,22.0,Stephen Curry,4,6,0.6666666666666666
3903,11/23/2022,34.6958904109589,W,1,31.683333333333334,9,20,0.45,4,10,0.4,0,0,,1,5,6,9,0,0,1,0,22,19.1,18.0,Stephen Curry,5,10,0.5
3904,11/25/2022,34.701369863013696,W,1,35.71666666666667,13,23,0.565,6,13,0.462,1,1,1.0,0,5,5,4,2,0,5,4,33,21.8,19.0,Stephen Curry,7,10,0.7
3905,11/27/2022,34.706849315068496,W,1,32.61666666666667,7,17,0.412,4,11,0.364,7,7,1.0,1,10,11,8,1,0,7,1,25,18.8,22.0,Stephen Curry,3,6,0.5
3906,10/18/2022,27.649315068493152,W,1,29.466666666666665,8,14,0.571,4,7,0.571,0,0,,1,5,6,4,1,1,1,5,20,17.1,25.0,Andrew Wiggins,4,7,0.5714285714285714
3907,10/21/2022,27.65753424657534,L,1,37.416666666666664,8,17,0.471,2,8,0.25,5,7,0.714,3,5,8,3,3,1,0,2,23,22.1,7.0,Andrew Wiggins,6,9,0.6666666666666666
3908,10/23/2022,27.663013698630138,W,1,31.5,10,19,0.526,2,6,0.333,2,3,0.667,1,4,5,1,3,2,0,2,24,20.5,14.0,Andrew Wiggins,8,13,0.6153846153846154
3909,10/25/2022,27.66849315068493,L,1,31.333333333333332,7,17,0.412,2,7,0.286,0,0,,2,4,6,3,1,1,0,4,16,11.7,-25.0,Andrew Wiggins,5,10,0.5
3910,10/27/2022,27.673972602739727,W,1,36.68333333333333,5,10,0.5,2,5,0.4,6,6,1.0,3,7,10,2,1,1,2,4,18,16.7,17.0,Andrew Wiggins,3,5,0.6
3911,10/29/2022,27.67945205479452,L,1,40.86666666666667,4,13,0.308,2,6,0.333,0,0,,2,4,6,4,1,0,0,2,10,8.1,-3.0,Andrew Wiggins,2,7,0.2857142857142857
3912,10/30/2022,27.682191780821917,L,1,25.1,4,15,0.267,1,3,0.333,1,1,1.0,2,1,3,1,1,1,1,2,10,3.4,-25.0,Andrew Wiggins,3,12,0.25
3913,11/1/2022,27.687671232876713,L,1,34.65,8,12,0.667,4,7,0.571,1,2,0.5,1,3,4,5,0,2,1,3,21,19.7,8.0,Andrew Wiggins,4,5,0.8
3914,11/3/2022,27.693150684931506,L,1,32.95,6,12,0.5,2,5,0.4,1,3,0.333,1,2,3,3,0,2,3,3,15,8.8,3.0,Andrew Wiggins,4,7,0.5714285714285714
3915,11/7/2022,27.704109589041096,W,1,40.233333333333334,10,17,0.588,4,8,0.5,1,2,0.5,1,9,10,2,2,1,4,2,25,19.4,16.0,Andrew Wiggins,6,9,0.6666666666666666
3916,11/11/2022,27.715068493150685,W,1,36.63333333333333,8,13,0.615,1,4,0.25,3,3,1.0,1,5,6,0,2,1,3,4,20,14.4,-3.0,Andrew Wiggins,7,9,0.7777777777777778
3917,11/13/2022,27.720547945205478,L,1,34.31666666666667,10,18,0.556,3,9,0.333,3,4,0.75,2,2,4,2,2,0,0,3,26,21.2,-15.0,Andrew Wiggins,7,9,0.7777777777777778
3918,11/14/2022,27.723287671232878,W,1,23.333333333333332,4,10,0.4,2,5,0.4,0,0,,1,3,4,1,1,0,2,1,10,5.5,13.0,Andrew Wiggins,2,5,0.4
3919,11/16/2022,27.72876712328767,L,1,31.85,5,11,0.455,4,6,0.667,0,0,,0,2,2,1,0,0,3,4,14,5.0,-13.0,Andrew Wiggins,1,5,0.2
3920,11/18/2022,27.734246575342464,W,1,30.3,8,15,0.533,3,8,0.375,1,4,0.25,3,4,7,2,0,0,1,4,20,13.6,20.0,Andrew Wiggins,5,7,0.7142857142857143
3921,11/20/2022,27.73972602739726,W,1,36.53333333333333,8,16,0.5,6,11,0.545,0,0,,0,5,5,0,2,0,2,3,22,14.3,8.0,Andrew Wiggins,2,5,0.4
3922,11/23/2022,27.747945205479454,W,1,32.06666666666667,12,18,0.667,6,10,0.6,1,1,1.0,1,3,4,2,3,1,0,3,31,28.7,28.0,Andrew Wiggins,6,8,0.75
3923,11/25/2022,27.753424657534246,W,1,34.21666666666667,8,20,0.4,3,6,0.5,1,1,1.0,5,4,9,5,3,1,2,4,20,17.5,11.0,Andrew Wiggins,5,14,0.35714285714285715
3924,11/27/2022,27.75890410958904,W,1,31.383333333333333,7,12,0.583,3,6,0.5,0,0,,1,2,3,2,2,0,2,4,17,12.5,14.0,Andrew Wiggins,4,6,0.6666666666666666
3925,10/18/2022,32.62465753424657,W,1,24.683333333333334,2,5,0.4,0,0,,0,0,,0,5,5,5,0,0,1,1,4,4.9,12.0,Draymond Green,2,5,0.4
3926,10/21/2022,32.632876712328766,L,1,26.633333333333333,4,6,0.667,1,3,0.333,4,4,1.0,0,3,3,9,2,2,1,6,13,17.6,11.0,Draymond Green,3,3,1.0
3927,10/23/2022,32.63835616438356,W,1,28.35,3,4,0.75,0,0,,1,2,0.5,1,3,4,4,0,0,2,2,7,6.6,17.0,Draymond Green,3,4,0.75
3928,10/25/2022,32.64383561643836,L,1,29.183333333333334,7,10,0.7,0,1,0.0,0,0,,2,6,8,5,3,0,5,4,14,12.9,-17.0,Draymond Green,7,9,0.7777777777777778
3929,10/27/2022,32.64931506849315,W,1,30.083333333333332,5,10,0.5,0,1,0.0,0,1,0.0,2,5,7,4,0,0,5,1,10,4.9,9.0,Draymond Green,5,9,0.5555555555555556
3930,10/29/2022,32.654794520547945,L,1,34.93333333333333,6,9,0.667,0,1,0.0,0,2,0.0,2,6,8,6,1,3,3,6,12,12.4,-13.0,Draymond Green,6,8,0.75
3931,10/30/2022,32.657534246575345,L,1,26.0,2,5,0.4,1,2,0.5,2,2,1.0,0,7,7,7,0,1,4,4,7,6.4,-11.0,Draymond Green,1,3,0.3333333333333333
3932,11/1/2022,32.66301369863014,L,1,32.166666666666664,2,3,0.667,1,2,0.5,0,0,,0,6,6,3,3,0,1,4,5,8.0,7.0,Draymond Green,1,1,1.0
3933,11/3/2022,32.66849315068493,L,1,29.85,4,5,0.8,0,0,,0,1,0.0,0,5,5,7,1,0,0,6,8,10.7,5.0,Draymond Green,4,5,0.8
3934,11/7/2022,32.679452054794524,W,1,36.35,4,7,0.571,0,0,,3,5,0.6,0,8,8,6,0,0,5,1,11,8.1,19.0,Draymond Green,4,7,0.5714285714285714
3935,11/11/2022,32.69041095890411,W,1,32.4,1,5,0.2,0,0,,0,0,,1,8,9,13,1,0,0,5,2,10.1,2.0,Draymond Green,1,5,0.2
3936,11/13/2022,32.6958904109589,L,1,34.11666666666667,3,7,0.429,0,2,0.0,0,0,,0,7,7,11,0,1,3,3,6,8.6,-3.0,Draymond Green,3,5,0.6
3937,11/14/2022,32.6986301369863,W,1,25.483333333333334,1,6,0.167,0,2,0.0,2,2,1.0,1,6,7,6,1,0,1,2,4,6.1,13.0,Draymond Green,1,4,0.25
3938,11/16/2022,32.704109589041096,L,1,29.316666666666666,3,3,1.0,1,1,1.0,2,2,1.0,0,2,2,8,3,0,3,2,9,13.5,-19.0,Draymond Green,2,2,1.0
3939,11/18/2022,32.70958904109589,W,1,31.916666666666668,3,4,0.75,1,1,1.0,3,4,0.75,0,9,9,7,0,2,2,5,10,13.0,24.0,Draymond Green,2,3,0.6666666666666666
3940,11/20/2022,32.71506849315068,W,1,31.766666666666666,2,4,0.5,0,1,0.0,0,0,,0,6,6,8,0,0,4,5,4,3.4,18.0,Draymond Green,2,3,0.6666666666666666
3941,11/23/2022,32.723287671232875,W,1,33.0,4,4,1.0,1,1,1.0,0,0,,1,6,7,12,2,0,3,3,9,16.5,21.0,Draymond Green,3,3,1.0
3942,11/25/2022,32.728767123287675,W,1,30.95,6,9,0.667,1,2,0.5,0,0,,1,2,3,5,1,2,2,3,13,13.1,9.0,Draymond Green,5,7,0.7142857142857143
3943,11/27/2022,32.73424657534247,W,1,32.63333333333333,6,7,0.857,1,2,0.5,6,8,0.75,1,3,4,11,0,2,0,2,19,25.6,17.0,Draymond Green,5,5,1.0
3944,10/18/2022,32.326027397260276,W,0,23.433333333333334,3,6,0.5,2,3,0.667,0,0,,5,2,7,0,1,0,0,1,8,9.7,-3.0,JaMychal Green,1,3,0.3333333333333333
3945,10/21/2022,32.33424657534247,L,0,23.95,2,5,0.4,1,3,0.333,0,0,,1,4,5,2,1,0,2,3,5,3.4,-10.0,JaMychal Green,1,2,0.5
3946,10/23/2022,32.33972602739726,W,0,12.95,1,2,0.5,0,1,0.0,1,2,0.5,2,2,4,0,2,1,0,2,3,5.5,-5.0,JaMychal Green,1,1,1.0
3947,10/25/2022,32.345205479452055,L,0,16.65,0,2,0.0,0,2,0.0,0,0,,0,3,3,0,1,0,2,1,0,-1.9,-10.0,JaMychal Green,0,0,
3948,10/27/2022,32.35068493150685,W,0,17.916666666666668,2,3,0.667,0,1,0.0,2,2,1.0,4,1,5,2,1,1,1,1,6,9.5,4.0,JaMychal Green,2,2,1.0
3949,10/29/2022,32.35616438356164,L,0,16.883333333333333,0,2,0.0,0,1,0.0,0,0,,1,4,5,1,1,0,1,2,0,0.4,5.0,JaMychal Green,0,1,0.0
3950,10/30/2022,32.35890410958904,L,0,15.866666666666667,3,6,0.5,0,2,0.0,0,0,,0,2,2,0,2,1,1,3,6,4.1,2.0,JaMychal Green,3,4,0.75
3951,11/1/2022,32.364383561643834,L,0,17.683333333333334,4,11,0.364,0,2,0.0,1,1,1.0,5,4,9,1,1,1,1,1,9,8.6,-22.0,JaMychal Green,4,9,0.4444444444444444
3952,11/3/2022,32.36986301369863,L,0,16.333333333333332,3,5,0.6,1,1,1.0,0,0,,2,4,6,0,0,1,1,5,7,5.0,-15.0,JaMychal Green,2,4,0.5
3953,11/4/2022,32.37260273972603,L,0,9.466666666666667,1,2,0.5,0,1,0.0,0,0,,0,1,1,0,0,0,1,2,2,-0.5,-11.0,JaMychal Green,1,1,1.0
3954,11/14/2022,32.4,W,0,15.416666666666666,3,5,0.6,1,3,0.333,2,2,1.0,0,5,5,2,0,2,1,3,9,8.8,18.0,JaMychal Green,2,2,1.0
3955,11/16/2022,32.40547945205479,L,0,17.016666666666666,1,7,0.143,0,2,0.0,0,0,,1,1,2,0,0,0,1,4,2,-4.1,7.0,JaMychal Green,1,5,0.2
3956,11/18/2022,32.41095890410959,W,0,16.85,5,8,0.625,0,1,0.0,2,3,0.667,1,2,3,2,1,0,1,2,12,9.9,8.0,JaMychal Green,5,7,0.7142857142857143
3957,11/20/2022,32.416438356164385,W,0,14.75,4,5,0.8,0,1,0.0,0,0,,1,2,3,1,0,0,2,1,8,5.7,-3.0,JaMychal Green,4,4,1.0
3958,11/21/2022,32.41917808219178,L,0,23.183333333333334,4,6,0.667,0,2,0.0,2,2,1.0,2,6,8,1,0,1,3,3,10,7.8,-21.0,JaMychal Green,4,4,1.0
3959,11/23/2022,32.42465753424658,W,0,11.8,2,5,0.4,1,2,0.5,0,0,,3,3,6,0,0,0,1,3,5,3.1,0.0,JaMychal Green,1,3,0.3333333333333333
3960,11/25/2022,32.43013698630137,W,0,9.633333333333333,4,6,0.667,0,1,0.0,0,0,,1,1,2,1,0,0,1,0,8,6.1,7.0,JaMychal Green,4,5,0.8
3961,11/27/2022,32.43561643835616,W,0,14.4,3,4,0.75,0,1,0.0,0,0,,0,2,2,1,0,0,0,2,6,4.9,9.0,JaMychal Green,3,3,1.0
3962,10/18/2022,20.383561643835616,W,0,7.583333333333333,2,4,0.5,1,3,0.333,0,0,,0,1,1,0,0,0,0,0,5,3.3,1.0,Moses Moody,1,1,1.0
3963,10/21/2022,20.39178082191781,L,0,13.0,1,5,0.2,1,4,0.25,0,0,,0,1,1,1,1,0,1,0,3,0.9,3.0,Moses Moody,0,1,0.0
3964,10/23/2022,20.397260273972602,W,0,18.15,0,1,0.0,0,1,0.0,3,4,0.75,0,1,1,0,0,1,2,1,3,0.5,-8.0,Moses Moody,0,0,
3965,10/25/2022,20.4027397260274,L,0,24.5,4,9,0.444,2,4,0.5,3,4,0.75,1,2,3,0,1,3,2,1,13,9.9,-5.0,Moses Moody,2,5,0.4
3966,10/27/2022,20.40821917808219,W,0,17.366666666666667,2,6,0.333,2,5,0.4,0,0,,1,3,4,1,0,0,2,0,6,2.9,0.0,Moses Moody,0,1,0.0
3967,10/29/2022,20.413698630136988,L,0,14.083333333333334,3,6,0.5,2,4,0.5,0,0,,0,3,3,0,0,0,0,4,8,4.3,0.0,Moses Moody,1,2,0.5
3968,10/30/2022,20.416438356164385,L,0,23.833333333333332,3,7,0.429,1,4,0.25,0,0,,2,2,4,0,1,1,2,1,7,4.6,-2.0,Moses Moody,2,3,0.6666666666666666
3969,11/1/2022,20.421917808219177,L,0,14.75,2,5,0.4,2,5,0.4,0,0,,0,0,0,2,1,0,2,0,6,3.7,-8.0,Moses Moody,0,0,
3970,11/3/2022,20.427397260273974,L,0,11.5,0,1,0.0,0,1,0.0,1,2,0.5,0,2,2,0,1,0,0,2,1,0.7,-9.0,Moses Moody,0,0,
3971,11/4/2022,20.43013698630137,L,1,32.05,4,9,0.444,1,3,0.333,5,5,1.0,0,4,4,1,0,0,4,2,14,6.4,10.0,Moses Moody,3,6,0.5
3972,11/7/2022,20.438356164383563,W,0,8.816666666666666,1,1,1.0,0,0,,0,0,,1,0,1,0,0,0,0,2,2,1.6,-1.0,Moses Moody,1,1,1.0
3973,11/14/2022,20.457534246575342,W,0,26.716666666666665,4,9,0.444,2,5,0.4,1,1,1.0,0,2,2,4,1,0,0,0,11,10.7,14.0,Moses Moody,2,4,0.5
3974,11/16/2022,20.463013698630135,L,0,6.033333333333333,0,1,0.0,0,1,0.0,0,0,,0,1,1,0,0,0,0,0,0,-0.4,6.0,Moses Moody,0,0,
3975,11/18/2022,20.46849315068493,W,0,2.65,0,0,,0,0,,0,0,,0,0,0,0,0,0,0,0,0,0.0,-8.0,Moses Moody,0,0,
3976,11/20/2022,20.473972602739725,W,0,4.65,0,0,,0,0,,0,0,,0,0,0,0,0,0,1,0,0,-1.0,8.0,Moses Moody,0,0,
3977,11/21/2022,20.476712328767125,L,0,32.86666666666667,2,6,0.333,1,5,0.2,5,6,0.833,0,4,4,1,1,0,3,0,10,6.1,-29.0,Moses Moody,1,1,1.0
3978,11/23/2022,20.482191780821918,W,0,5.033333333333333,0,1,0.0,0,1,0.0,0,0,,0,0,0,0,0,0,0,0,0,-0.7,-10.0,Moses Moody,0,0,
3979,11/27/2022,20.493150684931507,W,0,3.4166666666666665,0,0,,0,0,,0,0,,0,2,2,0,0,0,0,0,0,0.6,4.0,Moses Moody,0,0,
3980,10/18/2022,32.69041095890411,W,1,19.65,6,13,0.462,2,6,0.333,4,5,0.8,0,2,2,3,1,0,2,3,18,11.4,11.0,Klay Thompson,4,7,0.5714285714285714
3981,10/21/2022,32.6986301369863,L,1,23.566666666666666,6,14,0.429,4,10,0.4,0,0,,1,3,4,3,0,0,4,0,16,8.3,9.0,Klay Thompson,2,4,0.5
3982,10/23/2022,32.704109589041096,W,1,27.05,3,10,0.3,2,7,0.286,0,0,,0,4,4,3,0,0,1,1,8,4.1,15.0,Klay Thompson,1,3,0.3333333333333333
3983,10/25/2022,32.70958904109589,L,1,18.533333333333335,1,8,0.125,0,5,0.0,0,0,,0,0,0,2,0,1,0,3,2,-2.3,-12.0,Klay Thompson,1,3,0.3333333333333333
3984,10/27/2022,32.71506849315068,W,1,29.033333333333335,6,19,0.316,5,14,0.357,2,2,1.0,0,2,2,1,0,0,1,1,19,8.0,7.0,Klay Thompson,1,5,0.2
3985,10/29/2022,32.72054794520548,L,1,31.816666666666666,5,14,0.357,1,7,0.143,0,0,,0,4,4,3,0,0,0,1,11,6.1,-16.0,Klay Thompson,4,7,0.5714285714285714
3986,11/1/2022,32.728767123287675,L,1,30.616666666666667,7,19,0.368,4,12,0.333,1,1,1.0,0,3,3,2,1,1,4,1,19,8.1,6.0,Klay Thompson,3,7,0.42857142857142855
3987,11/3/2022,32.73424657534247,L,1,34.016666666666666,10,24,0.417,7,15,0.467,0,0,,1,3,4,3,1,0,0,2,27,18.1,13.0,Klay Thompson,3,9,0.3333333333333333
3988,11/7/2022,32.74520547945205,W,1,37.95,6,18,0.333,3,10,0.3,1,2,0.5,0,2,2,3,1,2,3,4,16,5.9,10.0,Klay Thompson,3,8,0.375
3989,11/11/2022,32.75616438356165,W,1,29.45,3,13,0.231,2,7,0.286,1,2,0.5,1,4,5,1,1,0,1,2,9,2.5,3.0,Klay Thompson,1,6,0.16666666666666666
3990,11/13/2022,32.76164383561644,L,1,32.46666666666667,6,16,0.375,5,13,0.385,0,0,,0,7,7,3,1,1,2,1,17,11.7,-1.0,Klay Thompson,1,3,0.3333333333333333
3991,11/16/2022,32.76986301369863,L,1,29.566666666666666,6,17,0.353,3,9,0.333,4,4,1.0,0,5,5,2,0,0,3,5,19,7.4,-8.0,Klay Thompson,3,8,0.375
3992,11/18/2022,32.775342465753425,W,1,31.4,8,16,0.5,4,10,0.4,0,0,,1,2,3,2,0,0,1,2,20,12.9,18.0,Klay Thompson,4,6,0.6666666666666666
3993,11/20/2022,32.78082191780822,W,1,35.56666666666667,14,23,0.609,10,13,0.769,3,4,0.75,2,2,4,3,2,0,2,1,41,33.8,14.0,Klay Thompson,4,10,0.4
3994,11/23/2022,32.78904109589041,W,1,27.216666666666665,5,10,0.5,3,7,0.429,5,6,0.833,0,0,0,0,2,0,4,1,18,10.2,11.0,Klay Thompson,2,3,0.6666666666666666
3995,11/25/2022,32.794520547945204,W,1,35.11666666666667,7,16,0.438,6,12,0.5,0,0,,1,5,6,1,0,0,1,1,20,13.1,9.0,Klay Thompson,1,4,0.25
3996,11/27/2022,32.8,W,1,29.933333333333334,8,13,0.615,5,8,0.625,0,0,,0,2,2,2,2,1,1,2,21,18.0,31.0,Klay Thompson,3,5,0.6
3997,10/18/2022,20.03287671232877,W,0,13.066666666666666,0,3,0.0,0,2,0.0,0,0,,1,2,3,0,0,1,2,2,0,-2.9,-8.0,Jonathan Kuminga,0,1,0.0
3998,10/21/2022,20.041095890410958,L,0,7.566666666666666,2,2,1.0,0,0,,0,0,,0,2,2,0,0,0,2,1,4,1.6,-10.0,Jonathan Kuminga,2,2,1.0
3999,10/23/2022,20.046575342465754,W,0,7.366666666666666,1,2,0.5,0,0,,2,2,1.0,0,0,0,0,0,0,1,2,4,1.2,-11.0,Jonathan Kuminga,1,2,0.5
4000,10/25/2022,20.052054794520547,L,0,15.15,1,4,0.25,0,1,0.0,2,2,1.0,1,2,3,0,0,0,1,2,4,1.1,-13.0,Jonathan Kuminga,1,3,0.3333333333333333
4001,10/29/2022,20.063013698630137,L,0,2.8166666666666664,0,1,0.0,0,0,,0,0,,1,0,1,0,1,0,0,1,0,0.6,0.0,Jonathan Kuminga,0,1,0.0
4002,10/30/2022,20.065753424657533,L,0,19.183333333333334,1,3,0.333,0,1,0.0,2,2,1.0,1,1,2,3,0,0,1,2,4,3.6,-2.0,Jonathan Kuminga,1,2,0.5
4003,11/4/2022,20.07945205479452,L,1,37.75,7,12,0.583,1,3,0.333,3,4,0.75,0,4,4,2,2,1,3,4,18,12.7,2.0,Jonathan Kuminga,6,9,0.6666666666666666
4004,11/7/2022,20.087671232876712,W,0,8.95,2,5,0.4,0,2,0.0,1,2,0.5,0,0,0,0,0,0,0,0,5,1.9,-17.0,Jonathan Kuminga,2,3,0.6666666666666666
4005,11/11/2022,20.0986301369863,W,0,4.316666666666666,0,3,0.0,0,0,,0,0,,2,0,2,0,0,0,2,0,0,-2.7,-1.0,Jonathan Kuminga,0,3,0.0
4006,11/13/2022,20.104109589041094,L,0,14.4,1,4,0.25,0,2,0.0,1,1,1.0,0,0,0,1,0,1,0,4,3,0.4,-4.0,Jonathan Kuminga,1,2,0.5
4007,11/14/2022,20.106849315068494,W,0,24.666666666666668,5,8,0.625,3,4,0.75,2,2,1.0,0,3,3,2,0,0,1,2,15,11.9,24.0,Jonathan Kuminga,2,4,0.5
4008,11/18/2022,20.117808219178084,W,0,8.9,0,2,0.0,0,1,0.0,1,2,0.5,1,4,5,0,1,0,0,0,1,2.1,-7.0,Jonathan Kuminga,0,1,0.0
4009,11/20/2022,20.123287671232877,W,0,6.45,1,3,0.333,0,2,0.0,0,0,,2,0,2,0,0,0,1,2,2,-0.1,-12.0,Jonathan Kuminga,1,1,1.0
4010,11/21/2022,20.126027397260273,L,1,39.5,6,20,0.3,4,12,0.333,2,2,1.0,1,2,3,2,1,2,3,4,18,6.9,-38.0,Jonathan Kuminga,2,8,0.25
4011,11/23/2022,20.13150684931507,W,0,13.766666666666667,3,7,0.429,0,3,0.0,0,0,,3,1,4,2,1,1,1,2,6,6.0,-7.0,Jonathan Kuminga,3,4,0.75
4012,11/25/2022,20.136986301369863,W,0,13.0,0,0,,0,0,,0,0,,0,3,3,1,0,0,2,0,0,-0.4,2.0,Jonathan Kuminga,0,0,
4013,11/27/2022,20.14246575342466,W,0,19.833333333333332,3,5,0.6,0,2,0.0,1,1,1.0,0,6,6,1,0,2,2,2,7,5.8,8.0,Jonathan Kuminga,3,3,1.0
4014,10/30/2022,24.775342465753425,L,0,8.566666666666666,1,1,1.0,0,0,,0,0,,0,2,2,1,0,0,0,2,2,2.2,-8.0,Anthony Lamb,1,1,1.0
4015,11/4/2022,24.78904109589041,L,1,36.666666666666664,6,9,0.667,4,6,0.667,0,0,,0,3,3,2,3,0,3,4,16,12.8,5.0,Anthony Lamb,2,3,0.6666666666666666
4016,11/7/2022,24.797260273972604,W,0,15.883333333333333,2,6,0.333,0,3,0.0,0,0,,2,3,5,1,1,0,0,3,4,3.4,-7.0,Anthony Lamb,2,3,0.6666666666666666
4017,11/11/2022,24.80821917808219,W,0,23.666666666666668,4,7,0.571,2,5,0.4,0,0,,2,2,4,1,0,0,0,3,10,8.2,6.0,Anthony Lamb,2,2,1.0
4018,11/13/2022,24.813698630136987,L,0,13.883333333333333,2,4,0.5,1,2,0.5,0,0,,0,1,1,1,0,0,1,1,5,2.6,-7.0,Anthony Lamb,1,2,0.5
4019,11/14/2022,24.816438356164383,W,0,24.166666666666668,6,7,0.857,5,6,0.833,0,0,,0,4,4,4,0,0,1,2,17,16.7,26.0,Anthony Lamb,1,1,1.0
4020,11/16/2022,24.82191780821918,L,0,24.3,3,7,0.429,1,4,0.25,0,0,,2,5,7,1,2,0,3,1,7,5.5,-3.0,Anthony Lamb,2,3,0.6666666666666666
4021,11/18/2022,24.827397260273973,W,0,14.383333333333333,0,3,0.0,0,3,0.0,0,0,,1,1,2,1,2,0,2,3,0,-1.6,-17.0,Anthony Lamb,0,0,
4022,11/20/2022,24.832876712328765,W,0,4.45,0,0,,0,0,,0,0,,0,1,1,1,0,0,2,0,0,-1.0,-7.0,Anthony Lamb,0,0,
4023,11/21/2022,24.835616438356166,L,1,34.4,1,5,0.2,0,4,0.0,0,0,,1,5,6,5,1,1,2,4,2,2.7,-31.0,Anthony Lamb,1,1,1.0
4024,11/23/2022,24.84109589041096,W,0,21.0,3,4,0.75,1,1,1.0,0,0,,1,6,7,2,0,0,1,4,7,6.7,14.0,Anthony Lamb,2,3,0.6666666666666666
4025,11/25/2022,24.846575342465755,W,0,8.416666666666666,1,1,1.0,1,1,1.0,0,0,,1,1,2,1,0,0,0,0,3,4.4,-7.0,Anthony Lamb,0,0,
4026,11/27/2022,24.852054794520548,W,0,8.733333333333333,1,1,1.0,0,0,,0,0,,0,0,0,0,0,0,0,4,2,0.1,-14.0,Anthony Lamb,1,1,1.0
4027,10/18/2022,25.71232876712329,W,0,21.616666666666667,3,6,0.5,1,2,0.5,1,2,0.5,0,2,2,2,1,0,4,2,8,2.8,-5.0,Donte DiVincenzo,2,4,0.5
4028,10/21/2022,25.720547945205478,L,0,9.666666666666666,1,3,0.333,1,3,0.333,0,0,,0,0,0,0,0,0,0,2,3,0.5,-13.0,Donte DiVincenzo,0,0,
4029,10/23/2022,25.726027397260275,W,0,10.7,1,2,0.5,0,1,0.0,2,2,1.0,0,0,0,1,0,0,2,0,4,1.7,-1.0,Donte DiVincenzo,1,1,1.0
4030,11/11/2022,25.778082191780822,W,0,15.6,0,1,0.0,0,1,0.0,0,0,,0,1,1,3,0,0,1,3,0,-0.5,3.0,Donte DiVincenzo,0,0,
4031,11/13/2022,25.783561643835615,L,0,24.266666666666666,1,3,0.333,1,3,0.333,2,2,1.0,0,5,5,2,0,0,1,1,5,4.8,0.0,Donte DiVincenzo,0,0,
4032,11/14/2022,25.786301369863015,W,0,8.633333333333333,2,3,0.667,1,2,0.5,0,0,,0,0,0,2,1,0,3,3,5,1.9,10.0,Donte DiVincenzo,1,1,1.0
4033,11/16/2022,25.791780821917808,L,0,18.516666666666666,2,7,0.286,2,5,0.4,0,0,,0,2,2,2,0,0,0,1,6,3.5,2.0,Donte DiVincenzo,0,2,0.0
4034,11/18/2022,25.797260273972604,W,0,19.766666666666666,2,5,0.4,2,5,0.4,0,0,,1,4,5,1,1,0,1,1,6,5.5,-11.0,Donte DiVincenzo,0,0,
4035,11/20/2022,25.802739726027397,W,0,15.5,2,5,0.4,0,3,0.0,0,1,0.0,1,3,4,1,1,1,1,1,4,3.5,-7.0,Donte DiVincenzo,2,2,1.0
4036,11/21/2022,25.805479452054794,L,1,19.15,0,5,0.0,0,3,0.0,0,0,,0,1,1,5,2,0,2,1,0,-0.1,-26.0,Donte DiVincenzo,0,2,0.0
4037,11/23/2022,25.81095890410959,W,0,17.383333333333333,2,3,0.667,2,3,0.667,0,0,,1,4,5,1,1,0,0,2,6,7.5,6.0,Donte DiVincenzo,0,0,
4038,11/25/2022,25.816438356164383,W,0,19.466666666666665,1,3,0.333,1,2,0.5,0,0,,0,3,3,5,2,0,1,1,3,6.3,-1.0,Donte DiVincenzo,0,1,0.0
4039,11/27/2022,25.82191780821918,W,0,18.066666666666666,5,10,0.5,4,8,0.5,0,0,,2,4,6,1,1,1,0,3,14,12.8,-8.0,Donte DiVincenzo,1,2,0.5
4040,10/18/2022,21.55068493150685,W,0,16.516666666666666,4,6,0.667,0,0,,0,4,0.0,1,6,7,0,0,1,0,2,8,6.2,-11.0,James Wiseman,4,6,0.6666666666666666
4041,10/21/2022,21.55890410958904,L,0,16.2,4,5,0.8,0,0,,3,3,1.0,1,4,5,1,0,0,1,4,11,9.1,-14.0,James Wiseman,4,5,0.8
4042,10/23/2022,21.564383561643837,W,0,19.783333333333335,5,7,0.714,0,0,,4,6,0.667,0,6,6,3,0,0,2,3,14,11.0,-10.0,James Wiseman,5,7,0.7142857142857143
4043,10/25/2022,21.56986301369863,L,0,18.066666666666666,5,8,0.625,0,0,,2,2,1.0,2,1,3,0,0,2,0,1,12,11.1,-19.0,James Wiseman,5,8,0.625
4044,10/27/2022,21.575342465753426,W,0,13.866666666666667,5,8,0.625,0,0,,0,0,,3,3,6,0,0,0,2,2,10,6.6,2.0,James Wiseman,5,8,0.625
4045,10/29/2022,21.58082191780822,L,0,4.733333333333333,0,2,0.0,0,0,,0,0,,0,0,0,1,0,0,0,3,0,-1.9,-5.0,James Wiseman,0,2,0.0
4046,10/30/2022,21.583561643835615,L,0,13.066666666666666,2,4,0.5,0,0,,2,2,1.0,1,3,4,1,0,0,0,2,6,5.5,9.0,James Wiseman,2,4,0.5
4047,11/1/2022,21.589041095890412,L,0,9.45,2,4,0.5,0,0,,1,2,0.5,0,0,0,0,0,1,1,3,5,1.1,-9.0,James Wiseman,2,4,0.5
4048,11/3/2022,21.594520547945205,L,0,9.566666666666666,1,3,0.333,0,0,,0,0,,1,2,3,1,1,0,0,3,2,2.1,-9.0,James Wiseman,1,3,0.3333333333333333
4049,11/4/2022,21.5972602739726,L,0,16.6,1,1,1.0,0,0,,3,4,0.75,1,5,6,2,0,0,2,3,5,4.7,-3.0,James Wiseman,1,1,1.0
4050,11/14/2022,21.624657534246577,W,0,9.233333333333333,1,3,0.333,0,0,,0,0,,1,1,2,2,0,0,0,0,2,2.7,-4.0,James Wiseman,1,3,0.3333333333333333
4051,10/25/2022,25.2986301369863,L,0,12.466666666666667,0,1,0.0,0,1,0.0,0,0,,0,1,1,2,0,0,0,2,0,0.2,-8.0,Ty Jerome,0,0,
4052,10/27/2022,25.304109589041097,W,0,7.55,1,2,0.5,1,2,0.5,0,0,,0,0,0,0,0,0,0,0,3,2.0,2.0,Ty Jerome,0,0,
4053,10/29/2022,25.30958904109589,L,0,15.7,3,5,0.6,1,1,1.0,0,0,,0,0,0,2,1,1,1,1,7,6.4,4.0,Ty Jerome,2,4,0.5
4054,10/30/2022,25.312328767123287,L,0,14.316666666666666,2,2,1.0,0,0,,4,4,1.0,0,0,0,1,0,0,0,1,8,7.7,-3.0,Ty Jerome,2,2,1.0
4055,11/1/2022,25.317808219178083,L,0,13.45,2,4,0.5,2,4,0.5,2,2,1.0,0,1,1,1,0,0,0,2,8,6.2,-8.0,Ty Jerome,0,0,
4056,11/3/2022,25.323287671232876,L,0,13.766666666666667,1,2,0.5,0,1,0.0,0,0,,0,0,0,3,0,0,1,1,2,1.7,3.0,Ty Jerome,1,1,1.0
4057,11/4/2022,25.326027397260273,L,0,31.5,7,12,0.583,2,6,0.333,2,2,1.0,1,5,6,5,0,0,0,1,18,17.7,-7.0,Ty Jerome,5,6,0.8333333333333334
4058,11/7/2022,25.334246575342465,W,0,11.55,0,2,0.0,0,1,0.0,2,2,1.0,0,0,0,1,0,0,0,1,2,0.9,-22.0,Ty Jerome,0,1,0.0
4059,11/21/2022,25.372602739726027,L,0,26.316666666666666,2,4,0.5,1,1,1.0,2,2,1.0,0,1,1,3,0,0,2,3,7,4.2,-26.0,Ty Jerome,1,3,0.3333333333333333
4060,10/18/2022,20.293150684931508,W,0,1.8666666666666667,0,1,0.0,0,0,,0,0,,0,1,1,1,0,0,0,2,0,-0.5,-3.0,Ryan Rollins,0,1,0.0
4061,10/23/2022,20.306849315068494,W,0,0.9833333333333333,0,0,,0,0,,0,0,,0,0,0,0,0,0,0,0,0,0.0,-5.0,Ryan Rollins,0,0,
4062,10/30/2022,20.326027397260273,L,0,0.7666666666666667,0,0,,0,0,,0,0,,0,0,0,0,0,0,1,0,0,-1.0,0.0,Ryan Rollins,0,0,
4063,11/4/2022,20.339726027397262,L,0,9.083333333333334,2,4,0.5,1,2,0.5,2,2,1.0,0,0,0,0,0,0,4,2,7,0.2,-20.0,Ryan Rollins,1,2,0.5
4064,11/14/2022,20.367123287671234,W,0,8.066666666666666,2,3,0.667,1,1,1.0,0,0,,0,2,2,1,0,0,2,2,5,2.2,4.0,Ryan Rollins,1,2,0.5
4065,11/21/2022,20.386301369863013,L,0,16.75,1,4,0.25,1,3,0.333,0,0,,0,3,3,0,0,0,5,3,3,-4.7,-3.0,Ryan Rollins,0,1,0.0
4066,11/23/2022,20.39178082191781,W,0,5.033333333333333,0,3,0.0,0,2,0.0,0,0,,1,0,1,1,0,0,0,0,0,-0.7,-10.0,Ryan Rollins,0,1,0.0
4067,10/30/2022,19.947945205479453,L,0,0.7666666666666667,0,0,,0,0,,0,0,,0,0,0,0,0,0,0,0,0,0.0,0.0,Patrick Baldwin Jr.,0,0,
4068,11/4/2022,19.96164383561644,L,0,3.9,0,1,0.0,0,1,0.0,0,0,,0,0,0,0,0,0,0,0,0,-0.7,-13.0,Patrick Baldwin Jr.,0,0,
4069,11/21/2022,20.008219178082193,L,0,15.516666666666667,3,6,0.5,1,4,0.25,0,0,,0,5,5,0,3,0,1,0,7,7.5,-18.0,Patrick Baldwin Jr.,2,2,1.0
4070,11/23/2022,20.013698630136986,W,0,3.8666666666666667,1,3,0.333,1,3,0.333,0,0,,0,1,1,0,0,0,0,0,3,1.6,-12.0,Patrick Baldwin Jr.,0,0,
4071,10/18/2022,24.389041095890413,L,0,16.0,1,3,0.333,0,2,0.0,1,1,1.0,0,0,0,1,0,0,0,1,3,1.6,-6.0,Austin Reaves,1,1,1.0
4072,10/20/2022,24.394520547945206,L,0,21.916666666666668,1,2,0.5,0,1,0.0,2,2,1.0,2,2,4,2,0,0,0,5,4,4.4,0.0,Austin Reaves,1,1,1.0
4073,10/23/2022,24.4027397260274,L,0,18.95,2,5,0.4,2,4,0.5,1,1,1.0,0,0,0,1,1,0,2,1,7,3.6,-6.0,Austin Reaves,0,1,0.0
4074,10/26/2022,24.410958904109588,L,1,26.483333333333334,3,5,0.6,2,3,0.667,0,0,,0,2,2,1,0,0,1,0,8,6.0,-23.0,Austin Reaves,1,2,0.5
4075,10/28/2022,24.416438356164385,L,0,26.583333333333332,4,5,0.8,2,3,0.667,2,2,1.0,1,6,7,3,0,0,2,0,12,12.7,8.0,Austin Reaves,2,2,1.0
4076,10/30/2022,24.421917808219177,W,0,27.6,3,6,0.5,2,4,0.5,2,3,0.667,0,4,4,2,1,1,0,1,10,10.5,15.0,Austin Reaves,1,2,0.5
4077,11/2/2022,24.43013698630137,W,0,34.45,2,6,0.333,0,3,0.0,3,3,1.0,0,0,0,2,2,0,1,1,7,5.6,-11.0,Austin Reaves,2,3,0.6666666666666666
4078,11/4/2022,24.435616438356163,L,0,21.683333333333334,1,1,1.0,1,1,1.0,2,2,1.0,0,2,2,3,1,2,1,1,5,8.4,-4.0,Austin Reaves,0,0,
4079,11/6/2022,24.44109589041096,L,0,25.416666666666668,0,2,0.0,0,1,0.0,1,1,1.0,0,4,4,0,0,1,2,3,1,-1.7,-12.0,Austin Reaves,0,1,0.0
4080,11/7/2022,24.443835616438356,L,1,29.8,2,6,0.333,0,3,0.0,7,7,1.0,0,4,4,1,0,0,0,0,11,9.5,-14.0,Austin Reaves,2,3,0.6666666666666666
4081,11/9/2022,24.44931506849315,L,1,35.266666666666666,3,10,0.3,1,5,0.2,1,3,0.333,4,5,9,1,0,0,1,0,8,5.4,1.0,Austin Reaves,2,5,0.4
4082,11/11/2022,24.454794520547946,L,0,33.06666666666667,7,12,0.583,0,2,0.0,5,5,1.0,2,3,5,1,1,0,3,1,19,14.0,2.0,Austin Reaves,7,10,0.7
4083,11/13/2022,24.46027397260274,W,1,32.6,5,8,0.625,3,4,0.75,2,3,0.667,0,1,1,3,0,0,1,2,15,11.6,20.0,Austin Reaves,2,4,0.5
4084,11/18/2022,24.473972602739725,W,1,36.38333333333333,5,8,0.625,2,4,0.5,4,4,1.0,1,3,4,6,0,1,0,2,16,18.1,14.0,Austin Reaves,3,4,0.75
4085,11/20/2022,24.47945205479452,W,1,27.283333333333335,7,11,0.636,3,4,0.75,4,4,1.0,1,1,2,3,0,0,1,1,21,17.8,19.0,Austin Reaves,4,7,0.5714285714285714
4086,11/22/2022,24.484931506849314,L,1,35.6,3,5,0.6,0,1,0.0,5,5,1.0,1,2,3,4,0,1,1,5,11,10.5,-2.0,Austin Reaves,3,4,0.75
4087,11/25/2022,24.493150684931507,W,0,29.3,3,8,0.375,0,3,0.0,2,2,1.0,1,5,6,2,1,0,2,1,8,5.8,15.0,Austin Reaves,3,5,0.6
4088,11/26/2022,24.495890410958904,W,0,30.833333333333332,6,7,0.857,1,2,0.5,3,3,1.0,0,2,2,2,1,0,2,3,16,13.3,3.0,Austin Reaves,5,5,1.0
4089,10/18/2022,33.93150684931507,L,1,30.683333333333334,7,12,0.583,1,3,0.333,4,5,0.8,1,10,11,3,1,0,4,1,19,15.4,-6.0,Russell Westbrook,6,9,0.6666666666666666
4090,10/20/2022,33.93698630136986,L,1,27.366666666666667,0,11,0.0,0,6,0.0,2,2,1.0,0,3,3,4,5,0,1,3,2,0.8,-6.0,Russell Westbrook,0,5,0.0
4091,10/23/2022,33.945205479452056,L,1,27.5,4,15,0.267,0,3,0.0,2,3,0.667,0,6,6,6,0,0,0,1,10,6.3,-4.0,Russell Westbrook,4,12,0.3333333333333333
4092,10/28/2022,33.95890410958904,L,0,32.65,6,17,0.353,1,4,0.25,5,10,0.5,1,7,8,3,1,1,5,4,18,6.5,0.0,Russell Westbrook,5,13,0.38461538461538464
4093,10/30/2022,33.964383561643835,W,0,31.633333333333333,6,12,0.5,2,4,0.5,4,4,1.0,4,4,8,8,0,0,3,3,18,17.4,18.0,Russell Westbrook,4,8,0.5
4094,11/2/2022,33.97260273972603,W,0,25.25,6,10,0.6,1,4,0.25,0,0,,1,6,7,9,0,1,6,2,13,11.1,4.0,Russell Westbrook,5,6,0.8333333333333334
4095,11/4/2022,33.97808219178082,L,0,29.416666666666668,9,14,0.643,3,5,0.6,5,5,1.0,0,3,3,6,2,0,4,1,26,22.5,-1.0,Russell Westbrook,6,9,0.6666666666666666
4096,11/6/2022,33.983561643835614,L,0,31.816666666666666,6,13,0.462,3,5,0.6,4,5,0.8,1,2,3,10,2,1,7,3,19,14.7,-8.0,Russell Westbrook,3,8,0.375
4097,11/7/2022,33.986301369863014,L,0,24.183333333333334,8,14,0.571,2,3,0.667,4,4,1.0,1,2,3,5,1,1,2,5,22,17.9,-23.0,Russell Westbrook,6,11,0.5454545454545454
4098,11/9/2022,33.99178082191781,L,0,29.566666666666666,6,15,0.4,0,3,0.0,2,2,1.0,1,3,4,9,2,0,4,1,14,11.4,-12.0,Russell Westbrook,6,12,0.5
4099,11/11/2022,33.9972602739726,L,0,34.05,6,17,0.353,4,7,0.571,5,6,0.833,3,1,4,11,0,0,5,5,21,14.2,-13.0,Russell Westbrook,2,10,0.2
4100,11/13/2022,34.0027397260274,W,0,27.8,4,15,0.267,1,6,0.167,5,6,0.833,1,5,6,12,0,1,4,3,14,10.8,-6.0,Russell Westbrook,3,9,0.3333333333333333
4101,11/18/2022,34.016438356164386,W,0,30.133333333333333,4,13,0.308,0,2,0.0,2,3,0.667,1,4,5,12,0,0,4,2,10,7.6,11.0,Russell Westbrook,4,11,0.36363636363636365
4102,11/20/2022,34.02191780821918,W,0,21.55,4,9,0.444,2,5,0.4,0,0,,0,4,4,10,1,0,3,2,10,10.7,14.0,Russell Westbrook,2,4,0.5
4103,11/22/2022,34.02739726027397,L,0,31.366666666666667,8,20,0.4,2,6,0.333,3,7,0.429,1,2,3,5,1,0,1,1,21,13.0,-1.0,Russell Westbrook,6,14,0.42857142857142855
4104,11/25/2022,34.035616438356165,W,0,19.416666666666668,1,7,0.143,0,3,0.0,1,2,0.5,1,3,4,7,2,1,3,3,3,3.1,-2.0,Russell Westbrook,1,4,0.25
4105,11/26/2022,34.038356164383565,W,0,26.5,4,12,0.333,0,3,0.0,3,6,0.5,1,6,7,6,0,1,6,3,11,3.2,-2.0,Russell Westbrook,4,9,0.4444444444444444
4106,10/18/2022,29.605479452054794,L,1,35.6,10,22,0.455,0,3,0.0,7,9,0.778,0,6,6,0,4,1,3,2,27,17.5,-21.0,Anthony Davis,10,19,0.5263157894736842
4107,10/20/2022,29.610958904109587,L,1,31.933333333333334,9,16,0.563,2,4,0.5,5,7,0.714,2,6,8,0,2,0,2,2,25,19.0,5.0,Anthony Davis,7,12,0.5833333333333334
4108,10/23/2022,29.61917808219178,L,1,36.25,9,17,0.529,0,3,0.0,4,4,1.0,5,5,10,3,2,6,1,5,22,24.0,3.0,Anthony Davis,9,14,0.6428571428571429
4109,10/26/2022,29.627397260273973,L,1,36.43333333333333,11,19,0.579,0,1,0.0,0,1,0.0,1,13,14,5,3,2,0,1,22,24.8,-22.0,Anthony Davis,11,18,0.6111111111111112
4110,10/30/2022,29.638356164383563,W,1,36.8,10,18,0.556,0,0,,3,4,0.75,6,9,15,2,1,1,2,3,23,20.8,15.0,Anthony Davis,10,18,0.5555555555555556
4111,11/2/2022,29.646575342465752,W,1,37.2,8,17,0.471,0,0,,4,4,1.0,5,11,16,4,1,4,1,3,20,22.5,9.0,Anthony Davis,8,17,0.47058823529411764
4112,11/4/2022,29.65205479452055,L,1,34.85,9,17,0.529,1,2,0.5,3,3,1.0,3,5,8,2,0,2,1,3,22,17.9,-8.0,Anthony Davis,8,15,0.5333333333333333
4113,11/6/2022,29.65753424657534,L,1,32.75,7,12,0.583,0,0,,5,9,0.556,3,9,12,4,0,1,1,4,19,17.5,-7.0,Anthony Davis,7,12,0.5833333333333334
4114,11/7/2022,29.660273972602738,L,1,29.2,11,18,0.611,1,1,1.0,6,7,0.857,1,3,4,2,1,1,2,2,29,22.3,-9.0,Anthony Davis,10,17,0.5882352941176471
4115,11/9/2022,29.665753424657535,L,1,35.35,9,16,0.563,0,1,0.0,3,4,0.75,1,8,9,3,0,1,3,5,21,13.9,-10.0,Anthony Davis,9,15,0.6
4116,11/11/2022,29.671232876712327,L,1,34.18333333333333,8,17,0.471,0,1,0.0,8,11,0.727,6,8,14,3,2,3,2,2,24,24.1,-7.0,Anthony Davis,8,16,0.5
4117,11/13/2022,29.676712328767124,W,1,33.63333333333333,15,25,0.6,0,0,,7,7,1.0,10,8,18,2,0,0,1,5,37,33.3,15.0,Anthony Davis,15,25,0.6
4118,11/18/2022,29.69041095890411,W,1,34.03333333333333,10,16,0.625,0,1,0.0,18,21,0.857,2,14,16,2,1,4,4,3,38,35.2,4.0,Anthony Davis,10,15,0.6666666666666666
4119,11/20/2022,29.695890410958903,W,1,27.766666666666666,12,19,0.632,0,2,0.0,6,6,1.0,3,15,18,2,3,1,2,1,30,30.8,34.0,Anthony Davis,12,17,0.7058823529411765
4120,11/22/2022,29.7013698630137,L,1,38.38333333333333,11,17,0.647,0,0,,15,16,0.938,3,18,21,2,5,5,6,2,37,39.7,-3.0,Anthony Davis,11,17,0.6470588235294118
4121,11/25/2022,29.70958904109589,W,1,35.06666666666667,10,13,0.769,0,0,,5,7,0.714,4,11,15,4,1,3,3,4,25,26.5,16.0,Anthony Davis,10,13,0.7692307692307693
4122,10/18/2022,23.843835616438355,L,1,29.283333333333335,2,7,0.286,0,3,0.0,1,2,0.5,1,2,3,5,1,1,2,0,5,5.0,-13.0,Lonnie Walker IV,2,4,0.5
4123,10/20/2022,23.84931506849315,L,1,36.56666666666667,9,21,0.429,2,9,0.222,6,6,1.0,1,2,3,3,2,0,1,3,26,18.1,-4.0,Lonnie Walker IV,7,12,0.5833333333333334
4124,10/23/2022,23.85753424657534,L,1,32.416666666666664,7,13,0.538,1,5,0.2,0,1,0.0,2,2,4,1,1,1,2,3,15,9.5,5.0,Lonnie Walker IV,6,8,0.75
4125,10/26/2022,23.865753424657534,L,1,30.483333333333334,6,14,0.429,1,6,0.167,2,3,0.667,0,2,2,1,2,1,1,1,15,9.8,-27.0,Lonnie Walker IV,5,8,0.625
4126,10/28/2022,23.87123287671233,L,1,24.15,3,10,0.3,0,4,0.0,0,0,,1,2,3,3,0,1,2,3,6,1.1,-3.0,Lonnie Walker IV,3,6,0.5
4127,10/30/2022,23.876712328767123,W,1,35.266666666666666,6,14,0.429,3,5,0.6,3,4,0.75,0,5,5,2,1,2,0,1,18,15.1,15.0,Lonnie Walker IV,3,9,0.3333333333333333
4128,11/2/2022,23.884931506849316,W,1,40.36666666666667,9,17,0.529,5,9,0.556,5,6,0.833,0,3,3,1,1,1,2,2,28,19.8,8.0,Lonnie Walker IV,4,8,0.5
4129,11/4/2022,23.89041095890411,L,1,30.016666666666666,6,12,0.5,2,3,0.667,5,5,1.0,0,1,1,1,2,0,0,2,19,15.2,-12.0,Lonnie Walker IV,4,9,0.4444444444444444
4130,11/6/2022,23.895890410958906,L,1,19.416666666666668,3,7,0.429,0,3,0.0,0,0,,0,1,1,1,0,0,0,5,6,1.3,-10.0,Lonnie Walker IV,3,4,0.75
4131,11/11/2022,23.90958904109589,L,1,33.2,8,14,0.571,2,4,0.5,1,2,0.5,0,1,1,1,2,0,2,1,19,12.6,-14.0,Lonnie Walker IV,6,10,0.6
4132,11/13/2022,23.915068493150685,W,1,30.366666666666667,9,15,0.6,4,5,0.8,3,3,1.0,0,1,1,0,0,0,0,2,25,17.6,20.0,Lonnie Walker IV,5,10,0.5
4133,11/18/2022,23.92876712328767,W,1,34.06666666666667,6,13,0.462,1,4,0.25,4,4,1.0,0,1,1,3,0,0,2,2,17,9.9,0.0,Lonnie Walker IV,5,9,0.5555555555555556
4134,11/20/2022,23.934246575342467,W,1,27.733333333333334,6,12,0.5,2,6,0.333,0,0,,0,1,1,2,0,0,2,1,14,7.3,23.0,Lonnie Walker IV,4,6,0.6666666666666666
4135,11/22/2022,23.93972602739726,L,1,38.016666666666666,8,18,0.444,2,6,0.333,6,7,0.857,0,0,0,2,1,0,1,0,24,15.6,-1.0,Lonnie Walker IV,6,12,0.5
4136,11/25/2022,23.947945205479453,W,1,33.5,7,16,0.438,4,9,0.444,0,0,,0,2,2,2,3,0,1,2,18,12.8,18.0,Lonnie Walker IV,3,7,0.42857142857142855
4137,11/26/2022,23.95068493150685,W,1,38.78333333333333,7,10,0.7,3,5,0.6,2,2,1.0,0,5,5,2,0,0,1,0,19,16.7,3.0,Lonnie Walker IV,4,5,0.8
4138,10/23/2022,23.23835616438356,L,0,22.15,2,7,0.286,0,2,0.0,0,0,,0,4,4,1,1,0,0,2,4,2.0,0.0,Troy Brown Jr.,2,5,0.4
4139,10/26/2022,23.246575342465754,L,0,27.7,3,8,0.375,0,3,0.0,0,0,,2,3,5,4,1,0,1,2,6,5.9,3.0,Troy Brown Jr.,3,5,0.6
4140,10/28/2022,23.252054794520546,L,1,32.016666666666666,4,10,0.4,4,6,0.667,0,0,,1,7,8,0,0,0,4,4,12,3.8,-9.0,Troy Brown Jr.,0,4,0.0
4141,10/30/2022,23.257534246575343,W,1,26.266666666666666,4,8,0.5,0,3,0.0,0,0,,1,5,6,0,1,0,0,2,8,6.4,-7.0,Troy Brown Jr.,4,5,0.8
4142,11/2/2022,23.265753424657536,W,1,26.583333333333332,4,7,0.571,1,3,0.333,6,6,1.0,1,9,10,1,0,0,0,1,15,15.4,6.0,Troy Brown Jr.,3,4,0.75
4143,11/4/2022,23.27123287671233,L,1,22.033333333333335,4,10,0.4,2,6,0.333,2,2,1.0,1,1,2,0,1,0,2,2,12,5.8,-14.0,Troy Brown Jr.,2,4,0.5
4144,11/6/2022,23.276712328767122,L,1,29.6,5,12,0.417,2,5,0.4,0,0,,2,4,6,0,0,0,1,2,12,6.4,-8.0,Troy Brown Jr.,3,7,0.42857142857142855
4145,11/7/2022,23.279452054794522,L,1,24.933333333333334,4,7,0.571,2,5,0.4,0,0,,0,4,4,2,0,0,1,4,10,6.7,-9.0,Troy Brown Jr.,2,2,1.0
4146,11/9/2022,23.284931506849315,L,1,31.883333333333333,6,10,0.6,2,6,0.333,0,0,,1,3,4,0,1,0,1,1,14,10.6,-1.0,Troy Brown Jr.,4,4,1.0
4147,11/11/2022,23.29041095890411,L,1,22.916666666666668,1,6,0.167,0,2,0.0,0,0,,0,3,3,0,2,0,0,2,2,0.3,-14.0,Troy Brown Jr.,1,4,0.25
4148,11/13/2022,23.295890410958904,W,1,35.85,4,7,0.571,1,2,0.5,0,0,,1,3,4,1,2,0,0,0,9,10.0,22.0,Troy Brown Jr.,3,5,0.6
4149,11/18/2022,23.30958904109589,W,1,18.15,3,5,0.6,1,2,0.5,1,1,1.0,0,2,2,1,1,0,0,4,8,6.4,-2.0,Troy Brown Jr.,2,3,0.6666666666666666
4150,11/20/2022,23.315068493150687,W,1,23.183333333333334,1,4,0.25,0,2,0.0,0,0,,1,6,7,2,0,0,3,1,2,0.1,10.0,Troy Brown Jr.,1,2,0.5
4151,11/22/2022,23.32054794520548,L,1,20.7,0,5,0.0,0,3,0.0,0,0,,1,2,3,1,0,0,2,0,0,-3.5,-7.0,Troy Brown Jr.,0,2,0.0
4152,11/25/2022,23.328767123287673,W,1,29.216666666666665,4,5,0.8,2,2,1.0,0,0,,1,3,4,0,1,0,0,1,10,10.3,0.0,Troy Brown Jr.,2,3,0.6666666666666666
4153,11/26/2022,23.33150684931507,W,1,22.933333333333334,2,3,0.667,0,1,0.0,2,2,1.0,0,2,2,3,1,0,1,1,6,7.0,11.0,Troy Brown Jr.,2,2,1.0
4154,10/18/2022,27.208219178082192,L,0,23.05,5,9,0.556,3,6,0.5,0,0,,0,3,3,2,1,0,3,2,13,8.2,-19.0,Kendrick Nunn,2,3,0.6666666666666666
4155,10/20/2022,27.213698630136985,L,0,11.016666666666667,0,7,0.0,0,4,0.0,0,0,,0,2,2,2,0,1,1,1,0,-3.6,-18.0,Kendrick Nunn,0,3,0.0
4156,10/23/2022,27.221917808219178,L,0,9.7,0,3,0.0,0,3,0.0,0,0,,0,0,0,1,0,0,2,3,0,-4.6,-7.0,Kendrick Nunn,0,0,
4157,10/26/2022,27.23013698630137,L,0,19.083333333333332,4,12,0.333,1,4,0.25,0,0,,0,4,4,1,0,0,3,1,9,0.7,9.0,Kendrick Nunn,3,8,0.375
4158,10/28/2022,27.235616438356164,L,0,12.433333333333334,4,9,0.444,1,4,0.25,0,1,0.0,0,2,2,0,0,0,1,0,9,3.5,4.0,Kendrick Nunn,3,5,0.6
4159,10/30/2022,27.24109589041096,W,0,3.3833333333333333,1,2,0.5,1,1,1.0,0,0,,0,0,0,0,0,0,0,0,3,2.0,4.0,Kendrick Nunn,0,1,0.0
4160,11/4/2022,27.254794520547946,L,0,1.2833333333333332,0,2,0.0,0,0,,0,0,,0,0,0,0,0,0,0,0,0,-1.4,-2.0,Kendrick Nunn,0,2,0.0
4161,11/6/2022,27.26027397260274,L,1,18.366666666666667,0,5,0.0,0,4,0.0,0,0,,1,2,3,2,1,0,1,0,0,-0.8,-3.0,Kendrick Nunn,0,1,0.0
4162,11/7/2022,27.263013698630136,L,1,26.783333333333335,7,11,0.636,2,4,0.5,2,2,1.0,0,1,1,1,0,0,3,0,18,11.1,-11.0,Kendrick Nunn,5,7,0.7142857142857143
4163,11/9/2022,27.268493150684932,L,0,12.533333333333333,0,4,0.0,0,2,0.0,0,0,,0,0,0,3,0,0,1,1,0,-2.1,-16.0,Kendrick Nunn,0,2,0.0
4164,11/13/2022,27.279452054794522,W,0,10.6,0,4,0.0,0,3,0.0,0,0,,0,1,1,2,0,0,0,2,0,-1.9,-12.0,Kendrick Nunn,0,1,0.0
4165,11/18/2022,27.293150684931508,W,0,16.683333333333334,4,4,1.0,2,2,1.0,0,0,,0,1,1,1,0,0,1,1,10,8.4,5.0,Kendrick Nunn,2,2,1.0
4166,11/20/2022,27.2986301369863,W,0,20.716666666666665,4,8,0.5,3,6,0.5,2,2,1.0,0,3,3,2,0,0,4,0,13,7.3,12.0,Kendrick Nunn,1,2,0.5
4167,11/22/2022,27.304109589041097,L,0,8.7,2,4,0.5,0,1,0.0,0,0,,0,0,0,2,0,0,2,0,4,1.4,-2.0,Kendrick Nunn,2,3,0.6666666666666666
4168,11/25/2022,27.312328767123287,W,0,15.5,3,9,0.333,1,5,0.2,2,2,1.0,0,1,1,1,0,0,1,0,9,3.9,-6.0,Kendrick Nunn,2,4,0.5
4169,11/26/2022,27.315068493150687,W,0,15.033333333333333,3,6,0.5,1,2,0.5,0,0,,0,1,1,1,0,0,0,2,7,4.2,6.0,Kendrick Nunn,2,4,0.5
4170,10/18/2022,25.564383561643837,L,0,7.8,0,1,0.0,0,0,,0,2,0.0,1,0,1,1,0,0,0,2,0,-0.9,0.0,Wenyen Gabriel,0,1,0.0
4171,10/26/2022,25.586301369863016,L,0,2.7666666666666666,0,0,,0,0,,0,0,,0,0,0,0,0,0,0,0,0,0.0,7.0,Wenyen Gabriel,0,0,
4172,10/28/2022,25.59178082191781,L,0,21.483333333333334,3,6,0.5,0,1,0.0,2,2,1.0,0,6,6,1,3,2,1,2,8,10.1,10.0,Wenyen Gabriel,3,5,0.6
4173,10/30/2022,25.5972602739726,W,0,8.616666666666667,2,4,0.5,0,1,0.0,0,0,,1,1,2,0,0,0,0,1,4,2.6,0.0,Wenyen Gabriel,2,3,0.6666666666666666
4174,11/2/2022,25.605479452054794,W,0,15.8,3,4,0.75,0,1,0.0,0,0,,2,2,4,1,1,0,2,4,6,4.5,-6.0,Wenyen Gabriel,3,3,1.0
4175,11/4/2022,25.610958904109587,L,0,11.116666666666667,1,1,1.0,0,0,,3,4,0.75,1,3,4,1,0,0,0,1,5,6.2,-4.0,Wenyen Gabriel,1,1,1.0
4176,11/6/2022,25.616438356164384,L,0,15.25,2,4,0.5,0,1,0.0,0,0,,1,3,4,0,0,1,1,3,4,2.1,-7.0,Wenyen Gabriel,2,3,0.6666666666666666
4177,11/7/2022,25.61917808219178,L,1,23.65,2,3,0.667,0,0,,0,0,,0,4,4,2,3,0,2,3,4,5.1,-9.0,Wenyen Gabriel,2,3,0.6666666666666666
4178,11/9/2022,25.624657534246577,L,0,8.733333333333333,1,1,1.0,0,0,,2,2,1.0,0,1,1,1,1,1,0,2,4,5.6,-4.0,Wenyen Gabriel,1,1,1.0
4179,11/11/2022,25.63013698630137,L,1,19.133333333333333,4,4,1.0,0,0,,0,0,,1,1,2,1,0,2,1,4,8,7.3,10.0,Wenyen Gabriel,4,4,1.0
4180,11/13/2022,25.635616438356166,W,0,14.366666666666667,4,7,0.571,1,1,1.0,0,0,,0,0,0,0,0,0,1,1,9,4.3,-2.0,Wenyen Gabriel,3,6,0.5
4181,11/18/2022,25.649315068493152,W,0,17.766666666666666,5,5,1.0,0,0,,5,5,1.0,3,4,7,0,0,0,1,1,15,15.4,3.0,Wenyen Gabriel,5,5,1.0
4182,11/20/2022,25.654794520547945,W,0,16.083333333333332,1,1,1.0,0,0,,0,0,,0,5,5,1,0,0,0,2,2,3.1,1.0,Wenyen Gabriel,1,1,1.0
4183,11/22/2022,25.660273972602738,L,0,6.816666666666666,0,3,0.0,0,1,0.0,0,0,,1,1,2,0,0,0,0,1,0,-1.5,-3.0,Wenyen Gabriel,0,2,0.0
4184,11/25/2022,25.66849315068493,W,0,12.933333333333334,1,1,1.0,0,0,,0,0,,2,4,6,2,0,0,1,1,2,4.3,-5.0,Wenyen Gabriel,1,1,1.0
4185,11/26/2022,25.671232876712327,W,0,21.866666666666667,5,8,0.625,2,4,0.5,3,3,1.0,0,4,4,1,1,2,2,3,15,12.5,1.0,Wenyen Gabriel,3,4,0.75
4186,10/18/2022,34.26849315068493,L,1,24.666666666666668,1,5,0.2,1,5,0.2,0,0,,1,1,2,2,4,2,1,5,3,4.7,-5.0,Patrick Beverley,0,0,
4187,10/20/2022,34.273972602739725,L,1,33.03333333333333,1,7,0.143,1,6,0.167,2,2,1.0,1,1,2,1,2,2,2,4,5,2.0,7.0,Patrick Beverley,0,1,0.0
4188,10/23/2022,34.28219178082192,L,1,29.516666666666666,1,3,0.333,1,3,0.333,4,4,1.0,1,3,4,5,1,0,2,3,7,8.2,7.0,Patrick Beverley,0,0,
4189,10/26/2022,34.29041095890411,L,1,28.983333333333334,1,4,0.25,0,2,0.0,4,4,1.0,1,3,4,3,1,0,0,3,6,7.1,-9.0,Patrick Beverley,1,2,0.5
4190,10/28/2022,34.295890410958904,L,1,29.683333333333334,2,4,0.5,0,1,0.0,2,2,1.0,1,5,6,4,0,0,1,3,6,6.8,-23.0,Patrick Beverley,2,3,0.6666666666666666
4191,10/30/2022,34.3013698630137,W,1,21.183333333333334,2,5,0.4,1,4,0.25,0,0,,1,4,5,2,0,0,0,3,5,4.4,-9.0,Patrick Beverley,1,1,1.0
4192,11/2/2022,34.30958904109589,W,1,27.333333333333332,0,3,0.0,0,0,,0,0,,1,3,4,3,1,0,2,0,0,0.6,7.0,Patrick Beverley,0,3,0.0
4193,11/4/2022,34.31506849315068,L,1,28.266666666666666,2,2,1.0,1,1,1.0,0,0,,1,4,5,1,0,0,0,2,5,6.2,2.0,Patrick Beverley,1,1,1.0
4194,11/9/2022,34.32876712328767,L,1,34.583333333333336,2,8,0.25,2,5,0.4,1,2,0.5,0,2,2,4,1,0,1,5,7,3.2,3.0,Patrick Beverley,0,3,0.0
4195,11/11/2022,34.33424657534247,L,1,26.4,2,8,0.25,1,3,0.333,0,0,,1,2,3,3,2,0,0,2,5,4.8,-3.0,Patrick Beverley,1,5,0.2
4196,11/13/2022,34.33972602739726,W,1,25.533333333333335,1,5,0.2,0,4,0.0,0,1,0.0,0,4,4,5,0,1,1,5,2,0.9,8.0,Patrick Beverley,1,1,1.0
4197,11/18/2022,34.35342465753425,W,1,25.066666666666666,1,3,0.333,1,3,0.333,1,2,0.5,0,3,3,2,0,1,3,5,4,-0.1,-2.0,Patrick Beverley,0,0,
4198,11/20/2022,34.35890410958904,W,1,19.7,1,5,0.2,1,4,0.25,0,0,,0,1,1,3,0,0,0,1,3,1.9,27.0,Patrick Beverley,0,1,0.0
4199,11/22/2022,34.364383561643834,L,1,29.183333333333334,0,2,0.0,0,1,0.0,0,0,,0,10,10,2,0,0,1,2,0,1.2,-15.0,Patrick Beverley,0,1,0.0
4200,10/18/2022,37.8,L,1,35.2,12,26,0.462,3,10,0.3,4,4,1.0,5,10,15,8,0,0,5,2,31,23.9,-10.0,LeBron James,9,16,0.5625
4201,10/20/2022,37.8054794520548,L,1,36.666666666666664,7,17,0.412,2,8,0.25,4,6,0.667,2,8,10,6,1,2,2,3,20,17.3,-1.0,LeBron James,5,9,0.5555555555555556
4202,10/23/2022,37.81369863013698,L,1,37.71666666666667,12,22,0.545,2,9,0.222,5,7,0.714,1,7,8,8,2,2,4,3,31,26.2,2.0,LeBron James,10,13,0.7692307692307693
4203,10/26/2022,37.821917808219176,L,1,35.3,8,21,0.381,2,8,0.25,1,2,0.5,2,5,7,9,1,0,8,1,19,8.9,-7.0,LeBron James,6,13,0.46153846153846156
4204,10/28/2022,37.827397260273976,L,1,37.45,10,24,0.417,1,6,0.167,7,8,0.875,3,4,7,5,4,0,3,2,28,21.8,-13.0,LeBron James,9,18,0.5
4205,10/30/2022,37.83287671232877,W,1,34.7,10,22,0.455,2,5,0.4,4,5,0.8,0,6,6,8,1,0,3,1,26,19.2,-1.0,LeBron James,8,17,0.47058823529411764
4206,11/2/2022,37.84109589041096,W,1,39.71666666666667,9,23,0.391,0,7,0.0,2,4,0.5,0,10,10,8,0,2,2,3,20,13.5,5.0,LeBron James,9,16,0.5625
4207,11/4/2022,37.846575342465755,L,1,34.15,7,19,0.368,0,5,0.0,3,5,0.6,2,8,10,8,0,1,3,3,17,11.6,-11.0,LeBron James,7,14,0.5
4208,11/6/2022,37.85205479452055,L,1,33.81666666666667,13,23,0.565,1,4,0.25,0,3,0.0,2,5,7,4,0,0,1,0,27,19.6,-8.0,LeBron James,12,19,0.631578947368421
4209,11/9/2022,37.86027397260274,L,1,32.35,12,22,0.545,4,9,0.444,2,4,0.5,1,7,8,5,2,0,3,2,30,23.1,-17.0,LeBron James,8,13,0.6153846153846154
4210,11/25/2022,37.9041095890411,W,1,33.25,8,17,0.471,1,4,0.25,4,4,1.0,0,8,8,5,3,1,9,2,21,12.1,16.0,LeBron James,7,13,0.5384615384615384
4211,11/26/2022,37.90684931506849,W,1,35.46666666666667,11,21,0.524,7,12,0.583,10,10,1.0,0,11,11,3,1,1,4,3,39,30.6,-3.0,LeBron James,4,9,0.4444444444444444
4212,10/18/2022,25.504109589041096,L,0,17.816666666666666,1,4,0.25,1,3,0.333,0,0,,0,1,1,0,1,0,1,2,3,0.1,1.0,Matt Ryan,0,1,0.0
4213,10/20/2022,25.50958904109589,L,0,12.616666666666667,2,4,0.5,1,2,0.5,0,0,,0,1,1,0,0,0,0,1,5,2.9,-2.0,Matt Ryan,1,2,0.5
4214,10/26/2022,25.526027397260275,L,0,8.5,2,3,0.667,2,3,0.667,0,0,,0,1,1,0,0,0,0,3,6,3.8,7.0,Matt Ryan,0,0,
4215,10/30/2022,25.536986301369865,W,0,12.333333333333334,2,4,0.5,2,3,0.667,0,0,,0,0,0,0,0,0,0,1,6,3.6,11.0,Matt Ryan,0,1,0.0
4216,11/2/2022,25.545205479452054,W,0,18.3,4,11,0.364,3,9,0.333,0,0,,1,1,2,1,0,0,1,1,11,5.2,-7.0,Matt Ryan,1,2,0.5
4217,11/4/2022,25.55068493150685,L,0,10.016666666666667,1,4,0.25,1,3,0.333,0,0,,1,3,4,0,0,0,0,1,3,1.8,-3.0,Matt Ryan,0,1,0.0
4218,11/6/2022,25.556164383561644,L,0,17.033333333333335,2,6,0.333,2,3,0.667,2,3,0.667,0,2,2,2,1,0,1,3,8,5.0,-7.0,Matt Ryan,0,3,0.0
4219,11/7/2022,25.55890410958904,L,0,17.8,0,4,0.0,0,3,0.0,2,2,1.0,0,1,1,0,0,0,0,1,2,-0.9,-10.0,Matt Ryan,0,1,0.0
4220,11/9/2022,25.564383561643837,L,0,0.7166666666666667,0,1,0.0,0,0,,0,0,,0,0,0,0,0,0,0,0,0,-0.7,-2.0,Matt Ryan,0,1,0.0
4221,11/13/2022,25.575342465753426,W,0,6.483333333333333,1,3,0.333,1,2,0.5,0,0,,0,1,1,0,0,0,0,1,3,1.2,2.0,Matt Ryan,0,1,0.0
4222,11/20/2022,25.594520547945205,W,0,5.65,0,4,0.0,0,3,0.0,0,0,,0,1,1,1,0,0,0,0,0,-1.8,7.0,Matt Ryan,0,1,0.0
4223,10/18/2022,29.523287671232875,L,0,14.3,0,3,0.0,0,3,0.0,0,0,,0,4,4,0,0,0,2,1,0,-3.3,0.0,Juan Toscano-Anderson,0,0,
4224,10/20/2022,29.528767123287672,L,0,21.633333333333333,3,7,0.429,1,4,0.25,1,1,1.0,0,4,4,3,1,0,1,2,8,6.8,-2.0,Juan Toscano-Anderson,2,3,0.6666666666666666
4225,10/23/2022,29.536986301369865,L,0,19.633333333333333,2,3,0.667,0,1,0.0,0,0,,0,2,2,0,1,0,0,1,4,3.9,-5.0,Juan Toscano-Anderson,2,2,1.0
4226,10/26/2022,29.545205479452054,L,0,9.933333333333334,1,2,0.5,0,0,,0,0,,0,3,3,0,0,0,0,3,2,0.7,-11.0,Juan Toscano-Anderson,1,2,0.5
4227,11/4/2022,29.56986301369863,L,0,14.6,0,0,,0,0,,2,2,1.0,0,1,1,0,0,1,0,1,2,2.6,-9.0,Juan Toscano-Anderson,0,0,
4228,11/6/2022,29.575342465753426,L,0,11.7,1,2,0.5,0,1,0.0,0,0,,0,1,1,1,0,0,1,2,2,0.2,-3.0,Juan Toscano-Anderson,1,1,1.0
4229,11/7/2022,29.578082191780823,L,0,12.85,0,4,0.0,0,1,0.0,1,2,0.5,0,2,2,0,0,2,2,2,1,-3.0,-8.0,Juan Toscano-Anderson,0,3,0.0
4230,11/9/2022,29.583561643835615,L,0,3.75,0,0,,0,0,,0,0,,0,1,1,0,0,0,0,1,0,-0.1,3.0,Juan Toscano-Anderson,0,0,
4231,11/11/2022,29.589041095890412,L,0,12.916666666666666,2,3,0.667,1,1,1.0,0,0,,1,2,3,1,0,0,1,3,5,3.5,1.0,Juan Toscano-Anderson,1,2,0.5
4232,11/13/2022,29.594520547945205,W,0,2.1166666666666667,1,1,1.0,0,0,,0,0,,0,0,0,0,1,0,1,1,2,1.3,-3.0,Juan Toscano-Anderson,1,1,1.0
4233,11/25/2022,29.627397260273973,W,0,1.15,0,0,,0,0,,0,0,,0,0,0,0,0,0,0,0,0,0.0,-2.0,Juan Toscano-Anderson,0,0,
4234,10/20/2022,27.306849315068494,L,0,7.25,1,2,0.5,0,1,0.0,0,0,,0,1,1,2,0,0,0,0,2,2.7,-9.0,Damian Jones,1,1,1.0
4235,10/23/2022,27.315068493150687,L,0,6.116666666666666,2,4,0.5,0,0,,0,0,,1,1,2,0,0,0,0,2,4,2.2,-5.0,Damian Jones,2,4,0.5
4236,10/26/2022,27.323287671232876,L,0,11.566666666666666,1,2,0.5,0,0,,2,4,0.5,1,3,4,0,0,1,0,1,4,4.1,11.0,Damian Jones,1,2,0.5
4237,10/28/2022,27.328767123287673,L,1,23.55,1,4,0.25,0,0,,1,2,0.5,4,4,8,1,0,1,3,3,3,1.4,-19.0,Damian Jones,1,4,0.25
4238,10/30/2022,27.334246575342465,W,0,2.216666666666667,0,1,0.0,0,0,,0,0,,0,0,0,0,0,1,0,1,0,-0.4,-6.0,Damian Jones,0,1,0.0
4239,11/4/2022,27.34794520547945,L,0,1.2833333333333332,0,0,,0,0,,0,0,,0,0,0,0,0,0,0,0,0,0.0,-2.0,Damian Jones,0,0,
4240,11/7/2022,27.356164383561644,L,0,15.216666666666667,3,6,0.5,0,0,,4,4,1.0,3,4,7,0,0,1,2,2,10,8.2,-6.0,Damian Jones,3,6,0.5
4241,11/9/2022,27.361643835616437,L,0,0.7166666666666667,0,0,,0,0,,0,0,,0,0,0,0,0,0,0,0,0,0.0,-2.0,Damian Jones,0,0,
4242,11/11/2022,27.367123287671234,L,0,7.416666666666667,2,2,1.0,0,0,,0,0,,0,2,2,0,1,0,0,1,4,4.6,0.0,Damian Jones,2,2,1.0
4243,11/20/2022,27.39178082191781,W,0,4.383333333333334,0,0,,0,0,,0,0,,0,1,1,0,0,1,0,0,0,1.0,1.0,Damian Jones,0,0,
4244,10/18/2022,19.684931506849313,L,0,1.8666666666666667,1,1,1.0,1,1,1.0,0,0,,0,1,1,0,0,0,0,0,3,3.0,3.0,Max Christie,0,0,
4245,10/26/2022,19.706849315068492,L,0,2.7666666666666666,0,0,,0,0,,2,2,1.0,0,1,1,1,0,0,0,0,2,3.0,7.0,Max Christie,0,0,
4246,11/4/2022,19.731506849315068,L,0,1.2833333333333332,0,1,0.0,0,0,,0,0,,0,0,0,0,0,0,0,0,0,-0.7,-2.0,Max Christie,0,1,0.0
4247,11/6/2022,19.736986301369864,L,0,4.833333333333333,1,1,1.0,0,0,,0,0,,0,0,0,0,0,0,0,1,2,1.3,3.0,Max Christie,1,1,1.0
4248,11/7/2022,19.73972602739726,L,0,29.05,3,7,0.429,2,4,0.5,0,0,,1,0,1,2,2,0,1,0,8,7.4,-16.0,Max Christie,1,3,0.3333333333333333
4249,11/9/2022,19.745205479452054,L,0,14.466666666666667,1,1,1.0,1,1,1.0,0,0,,0,5,5,0,0,0,1,2,3,2.4,-8.0,Max Christie,0,0,
4250,11/11/2022,19.75068493150685,L,0,16.716666666666665,2,5,0.4,2,5,0.4,1,2,0.5,0,4,4,1,1,0,0,1,7,6.4,8.0,Max Christie,0,0,
4251,11/13/2022,19.756164383561643,W,0,20.65,0,1,0.0,0,0,,0,0,,0,9,9,0,0,0,0,0,0,2.0,1.0,Max Christie,0,1,0.0
4252,11/25/2022,19.78904109589041,W,0,1.6166666666666667,0,0,,0,0,,0,0,,0,0,0,0,0,0,0,0,0,0.0,-2.0,Max Christie,0,0,
4253,11/18/2022,29.175342465753424,W,0,14.566666666666666,1,5,0.2,0,1,0.0,0,0,,0,0,0,2,0,0,1,2,2,-1.5,-6.0,Dennis Schröder,1,4,0.25
4254,11/20/2022,29.18082191780822,W,0,22.966666666666665,4,7,0.571,1,2,0.5,4,4,1.0,0,2,2,2,1,0,0,0,13,12.7,8.0,Dennis Schröder,3,5,0.6
4255,11/22/2022,29.186301369863013,L,0,20.033333333333335,0,6,0.0,0,3,0.0,0,0,,0,0,0,1,1,0,1,0,0,-3.5,-8.0,Dennis Schröder,0,3,0.0
4256,11/25/2022,29.194520547945206,W,1,29.05,3,7,0.429,0,1,0.0,3,3,1.0,1,2,3,5,1,0,1,2,9,9.3,7.0,Dennis Schröder,3,6,0.5
4257,11/26/2022,29.197260273972603,W,1,30.7,6,10,0.6,3,4,0.75,6,6,1.0,0,3,3,6,0,0,1,3,21,19.3,4.0,Dennis Schröder,3,6,0.5
4258,11/18/2022,25.301369863013697,W,0,13.15,4,6,0.667,0,1,0.0,0,0,,0,5,5,0,0,1,0,2,8,6.8,8.0,Thomas Bryant,4,5,0.8
4259,11/20/2022,25.306849315068494,W,0,22.983333333333334,5,5,1.0,0,0,,5,8,0.625,0,9,9,1,0,0,0,1,15,15.3,-1.0,Thomas Bryant,5,5,1.0
4260,11/22/2022,25.312328767123287,L,0,11.15,4,5,0.8,0,0,,0,0,,0,3,3,0,0,1,2,1,8,5.3,-8.0,Thomas Bryant,4,5,0.8
4261,11/26/2022,25.323287671232876,W,1,17.883333333333333,3,4,0.75,0,0,,3,5,0.6,2,2,4,1,0,3,0,2,9,10.6,2.0,Thomas Bryant,3,4,0.75
4262,10/18/2022,21.936986301369863,L,0,1.8666666666666667,0,0,,0,0,,2,2,1.0,0,0,0,0,0,0,0,0,2,2.0,3.0,Scotty Pippen Jr.,0,0,
4263,11/7/2022,21.991780821917807,L,0,6.483333333333333,0,2,0.0,0,0,,1,2,0.5,1,1,2,0,0,0,1,2,1,-1.6,0.0,Scotty Pippen Jr.,0,2,0.0
4264,10/18/2022,23.446575342465753,L,0,1.8666666666666667,0,1,0.0,0,1,0.0,0,0,,0,1,1,1,0,0,0,0,0,0.3,3.0,Cole Swider,0,0,
4265,10/19/2022,26.443835616438356,W,0,24.966666666666665,6,16,0.375,3,8,0.375,0,2,0.0,1,3,4,3,1,0,1,0,15,9.1,-4.0,Tyus Jones,3,8,0.375
4266,10/21/2022,26.44931506849315,W,0,21.883333333333333,4,13,0.308,3,7,0.429,0,0,,0,4,4,4,0,0,0,0,11,7.5,-11.0,Tyus Jones,1,6,0.16666666666666666
4267,10/22/2022,26.45205479452055,L,0,24.083333333333332,3,8,0.375,2,6,0.333,2,3,0.667,0,0,0,5,1,1,1,0,10,9.4,-21.0,Tyus Jones,1,2,0.5
4268,10/24/2022,26.457534246575342,W,0,24.283333333333335,4,10,0.4,0,1,0.0,0,0,,2,1,3,1,0,0,2,2,8,2.2,-12.0,Tyus Jones,4,9,0.4444444444444444
4269,10/27/2022,26.465753424657535,W,0,23.55,6,11,0.545,1,4,0.25,1,1,1.0,0,2,2,5,0,0,1,1,14,11.4,18.0,Tyus Jones,5,7,0.7142857142857143
4270,10/29/2022,26.471232876712328,L,1,32.93333333333333,10,15,0.667,3,5,0.6,0,2,0.0,0,1,1,10,2,0,1,0,23,24.0,-9.0,Tyus Jones,7,10,0.7
4271,10/31/2022,26.476712328767125,L,0,27.3,5,9,0.556,2,5,0.4,0,0,,0,2,2,2,1,0,5,1,12,5.3,-18.0,Tyus Jones,3,4,0.75
4272,11/2/2022,26.482191780821918,W,0,23.85,1,6,0.167,0,2,0.0,0,0,,0,0,0,5,1,0,0,2,2,1.9,-1.0,Tyus Jones,1,4,0.25
4273,11/4/2022,26.487671232876714,W,0,14.133333333333333,5,8,0.625,0,2,0.0,1,1,1.0,0,2,2,3,0,0,0,0,11,10.1,3.0,Tyus Jones,5,6,0.8333333333333334
4274,11/6/2022,26.493150684931507,W,0,19.15,2,5,0.4,1,3,0.333,2,2,1.0,0,0,0,3,1,0,1,0,7,6.4,12.0,Tyus Jones,1,2,0.5
4275,11/7/2022,26.495890410958904,L,0,15.183333333333334,3,5,0.6,0,2,0.0,0,0,,0,1,1,3,0,0,0,0,6,6.1,-21.0,Tyus Jones,3,3,1.0
4276,11/9/2022,26.5013698630137,W,0,19.633333333333333,4,10,0.4,3,5,0.6,0,0,,0,1,1,3,0,0,1,0,11,7.0,-10.0,Tyus Jones,1,5,0.2
4277,11/11/2022,26.506849315068493,W,0,19.016666666666666,3,6,0.5,0,1,0.0,0,0,,1,0,1,3,0,0,1,0,6,4.8,14.0,Tyus Jones,3,5,0.6
4278,11/13/2022,26.512328767123286,L,1,36.25,7,18,0.389,1,4,0.25,2,2,1.0,0,3,3,5,3,0,2,1,17,12.2,-4.0,Tyus Jones,6,14,0.42857142857142855
4279,11/15/2022,26.517808219178082,L,0,19.6,1,4,0.25,1,4,0.25,0,0,,0,1,1,3,0,0,0,0,3,3.0,-17.0,Tyus Jones,0,0,
4280,11/18/2022,26.526027397260275,W,0,23.166666666666668,4,7,0.571,1,4,0.25,4,4,1.0,1,1,2,5,0,1,1,2,13,13.1,1.0,Tyus Jones,3,3,1.0
4281,11/20/2022,26.53150684931507,L,1,34.35,5,10,0.5,2,2,1.0,1,3,0.333,0,3,3,6,0,0,1,0,13,11.3,-5.0,Tyus Jones,3,8,0.375
4282,11/22/2022,26.536986301369865,L,0,27.3,3,9,0.333,2,5,0.4,0,0,,0,3,3,6,2,0,1,2,8,8.2,-11.0,Tyus Jones,1,4,0.25
4283,11/25/2022,26.545205479452054,W,0,21.4,3,7,0.429,3,5,0.6,0,0,,1,0,1,6,0,0,1,0,9,9.2,11.0,Tyus Jones,0,2,0.0
4284,11/27/2022,26.55068493150685,W,0,19.05,1,5,0.2,0,3,0.0,0,0,,0,2,2,7,0,0,0,0,2,4.4,-1.0,Tyus Jones,1,2,0.5
4285,10/19/2022,26.08219178082192,W,0,18.666666666666668,4,6,0.667,0,2,0.0,0,0,,2,4,6,0,0,0,1,4,8,5.4,-12.0,Brandon Clarke,4,4,1.0
4286,10/21/2022,26.087671232876712,W,0,14.75,1,2,0.5,0,0,,2,4,0.5,1,3,4,2,0,1,2,2,4,3.1,-16.0,Brandon Clarke,1,2,0.5
4287,10/22/2022,26.09041095890411,L,0,16.783333333333335,4,7,0.571,0,0,,0,0,,0,3,3,1,0,1,1,2,8,5.2,-2.0,Brandon Clarke,4,7,0.5714285714285714
4288,10/24/2022,26.095890410958905,W,0,16.733333333333334,4,5,0.8,0,0,,5,6,0.833,0,2,2,2,0,0,1,4,13,10.1,-10.0,Brandon Clarke,4,5,0.8
4289,10/27/2022,26.104109589041094,W,0,22.55,6,8,0.75,0,1,0.0,4,5,0.8,0,3,3,3,2,1,1,0,16,17.1,11.0,Brandon Clarke,6,7,0.8571428571428571
4290,10/29/2022,26.10958904109589,L,0,14.95,4,6,0.667,0,0,,0,0,,2,1,3,1,1,1,2,4,8,5.9,-6.0,Brandon Clarke,4,6,0.6666666666666666
4291,10/31/2022,26.115068493150684,L,0,15.983333333333333,4,7,0.571,0,0,,0,2,0.0,2,3,5,1,0,0,0,1,8,6.5,-9.0,Brandon Clarke,4,7,0.5714285714285714
4292,11/2/2022,26.12054794520548,W,0,14.0,3,6,0.5,0,0,,0,0,,0,3,3,0,0,1,1,2,6,2.8,9.0,Brandon Clarke,3,6,0.5
4293,11/4/2022,26.126027397260273,W,0,15.916666666666666,4,7,0.571,0,0,,5,5,1.0,1,1,2,2,0,3,1,3,13,12.0,9.0,Brandon Clarke,4,7,0.5714285714285714
4294,11/6/2022,26.13150684931507,W,0,21.4,7,8,0.875,0,0,,2,2,1.0,0,5,5,1,0,2,1,2,16,15.0,5.0,Brandon Clarke,7,8,0.875
4295,11/7/2022,26.134246575342466,L,1,30.666666666666668,5,8,0.625,0,2,0.0,0,0,,1,7,8,1,0,0,2,3,10,6.7,-6.0,Brandon Clarke,5,6,0.8333333333333334
4296,11/9/2022,26.13972602739726,W,0,15.483333333333333,1,2,0.5,0,0,,4,5,0.8,1,3,4,2,0,0,3,4,6,3.0,-4.0,Brandon Clarke,1,2,0.5
4297,11/11/2022,26.145205479452056,W,0,19.433333333333334,6,6,1.0,0,0,,3,4,0.75,0,1,1,3,1,1,0,3,15,15.7,7.0,Brandon Clarke,6,6,1.0
4298,11/13/2022,26.15068493150685,L,0,15.3,1,7,0.143,0,0,,2,4,0.5,3,2,5,0,0,1,1,2,4,0.3,-8.0,Brandon Clarke,1,7,0.14285714285714285
4299,11/15/2022,26.156164383561645,L,0,33.28333333333333,6,12,0.5,1,1,1.0,2,2,1.0,4,9,13,3,0,3,2,1,15,16.3,-12.0,Brandon Clarke,5,11,0.45454545454545453
4300,11/18/2022,26.164383561643834,W,0,22.7,1,2,0.5,0,0,,0,0,,0,5,5,0,1,1,0,1,2,3.8,-4.0,Brandon Clarke,1,2,0.5
4301,11/20/2022,26.16986301369863,L,0,16.716666666666665,1,4,0.25,0,0,,0,0,,1,2,3,1,0,0,1,0,2,0.6,-20.0,Brandon Clarke,1,4,0.25
4302,11/22/2022,26.175342465753424,L,0,17.95,3,5,0.6,0,0,,0,0,,1,1,2,2,0,1,0,1,6,6.4,-5.0,Brandon Clarke,3,5,0.6
4303,11/25/2022,26.183561643835617,W,0,21.166666666666668,5,7,0.714,0,0,,2,2,1.0,1,9,10,1,0,1,1,3,12,11.7,9.0,Brandon Clarke,5,7,0.7142857142857143
4304,11/27/2022,26.18904109589041,W,0,16.783333333333335,3,7,0.429,0,0,,3,3,1.0,2,2,4,0,1,1,1,2,9,7.2,3.0,Brandon Clarke,3,7,0.42857142857142855
4305,10/19/2022,21.564383561643837,W,0,12.766666666666667,0,6,0.0,0,2,0.0,0,0,,2,0,2,1,0,0,0,1,0,-2.5,-5.0,David Roddy,0,4,0.0
4306,10/21/2022,21.56986301369863,W,0,22.533333333333335,3,6,0.5,2,5,0.4,0,0,,0,2,2,0,1,0,2,4,8,3.0,0.0,David Roddy,1,1,1.0
4307,10/22/2022,21.572602739726026,L,0,23.433333333333334,5,12,0.417,0,4,0.0,2,2,1.0,1,2,3,1,0,0,1,4,12,5.0,-36.0,David Roddy,5,8,0.625
4308,10/24/2022,21.578082191780823,W,0,7.666666666666667,0,5,0.0,0,4,0.0,0,0,,0,1,1,1,0,0,0,1,0,-2.9,-2.0,David Roddy,0,1,0.0
4309,10/27/2022,21.586301369863016,W,0,18.25,1,4,0.25,0,3,0.0,0,0,,0,3,3,1,0,0,0,0,2,1.2,11.0,David Roddy,1,1,1.0
4310,10/29/2022,21.59178082191781,L,0,27.15,4,5,0.8,2,3,0.667,0,0,,2,5,7,2,2,2,2,3,10,12.6,7.0,David Roddy,2,2,1.0
4311,10/31/2022,21.5972602739726,L,0,28.8,0,8,0.0,0,4,0.0,2,2,1.0,2,4,6,0,2,1,0,1,2,1.3,-20.0,David Roddy,0,4,0.0
4312,11/2/2022,21.602739726027398,W,0,19.016666666666666,3,6,0.5,3,6,0.5,1,2,0.5,0,1,1,2,2,0,0,3,10,9.1,5.0,David Roddy,0,0,
4313,11/4/2022,21.60821917808219,W,0,27.683333333333334,4,8,0.5,2,5,0.4,1,2,0.5,1,1,2,0,0,1,1,3,11,6.1,12.0,David Roddy,2,3,0.6666666666666666
4314,11/6/2022,21.613698630136987,W,0,15.566666666666666,1,3,0.333,1,2,0.5,0,0,,0,1,1,0,0,0,0,0,3,1.6,-4.0,David Roddy,0,1,0.0
4315,11/7/2022,21.616438356164384,L,0,4.75,0,1,0.0,0,0,,0,0,,2,0,2,0,0,0,0,0,0,0.7,-15.0,David Roddy,0,1,0.0
4316,11/9/2022,21.621917808219177,W,0,9.05,3,6,0.5,0,2,0.0,0,0,,0,1,1,0,0,0,0,1,6,2.9,0.0,David Roddy,3,4,0.75
4317,11/11/2022,21.627397260273973,W,0,6.2,2,2,1.0,1,1,1.0,0,0,,1,1,2,1,0,0,0,0,5,6.1,5.0,David Roddy,1,1,1.0
4318,11/13/2022,21.632876712328766,L,0,27.666666666666668,5,11,0.455,0,3,0.0,1,2,0.5,1,4,5,0,0,1,1,0,11,6.5,-24.0,David Roddy,5,8,0.625
4319,11/15/2022,21.638356164383563,L,0,14.5,1,3,0.333,1,2,0.5,0,0,,0,1,1,1,0,0,0,1,3,1.9,-16.0,David Roddy,0,1,0.0
4320,11/18/2022,21.646575342465752,W,0,15.0,1,3,0.333,0,2,0.0,2,3,0.667,2,1,3,0,0,0,2,1,4,1.2,-8.0,David Roddy,1,1,1.0
4321,11/20/2022,21.65205479452055,L,0,24.283333333333335,3,8,0.375,1,3,0.333,2,2,1.0,1,3,4,1,0,0,0,4,9,5.3,-12.0,David Roddy,2,5,0.4
4322,11/22/2022,21.65753424657534,L,0,14.85,1,3,0.333,1,3,0.333,0,0,,0,2,2,0,0,0,1,1,3,0.5,-16.0,David Roddy,0,0,
4323,11/25/2022,21.665753424657535,W,0,24.483333333333334,4,11,0.364,2,5,0.4,1,1,1.0,0,2,2,0,0,0,2,3,11,2.3,0.0,David Roddy,2,6,0.3333333333333333
4324,11/27/2022,21.671232876712327,W,0,12.55,2,4,0.5,2,4,0.5,0,0,,1,0,1,0,0,0,0,2,6,3.9,6.0,David Roddy,0,0,
4325,10/19/2022,21.77260273972603,W,1,38.983333333333334,7,14,0.5,3,8,0.375,1,2,0.5,2,9,11,1,1,1,0,1,18,16.7,18.0,Santi Aldama,4,6,0.6666666666666666
4326,10/21/2022,21.778082191780822,W,1,31.033333333333335,3,11,0.273,0,3,0.0,2,4,0.5,4,5,9,3,1,3,1,1,8,8.8,22.0,Santi Aldama,3,8,0.375
4327,10/22/2022,21.78082191780822,L,1,20.783333333333335,2,4,0.5,1,3,0.333,3,3,1.0,2,4,6,0,0,0,2,5,8,4.6,-10.0,Santi Aldama,1,1,1.0
4328,10/24/2022,21.786301369863015,W,1,32.4,6,8,0.75,2,4,0.5,3,3,1.0,2,2,4,0,1,1,0,1,17,17.1,17.0,Santi Aldama,4,4,1.0
4329,10/27/2022,21.794520547945204,W,1,29.883333333333333,2,6,0.333,0,4,0.0,0,0,,0,2,2,1,2,2,0,4,4,3.7,1.0,Santi Aldama,2,2,1.0
4330,10/29/2022,21.8,L,1,29.566666666666666,4,8,0.5,0,1,0.0,2,3,0.667,0,3,3,1,0,0,2,5,10,3.2,-10.0,Santi Aldama,4,7,0.5714285714285714
4331,10/31/2022,21.805479452054794,L,1,23.683333333333334,1,7,0.143,0,1,0.0,1,2,0.5,4,4,8,1,0,1,0,3,3,2.3,3.0,Santi Aldama,1,6,0.16666666666666666
4332,11/2/2022,21.81095890410959,W,1,28.983333333333334,4,8,0.5,2,4,0.5,1,2,0.5,3,4,7,0,0,2,0,3,11,10.1,0.0,Santi Aldama,2,4,0.5
4333,11/4/2022,21.816438356164383,W,1,21.016666666666666,5,9,0.556,2,5,0.4,0,0,,1,4,5,1,1,2,2,2,12,9.9,19.0,Santi Aldama,3,4,0.75
4334,11/6/2022,21.82191780821918,W,1,26.9,2,9,0.222,0,4,0.0,0,1,0.0,0,10,10,2,3,0,0,3,4,4.3,6.0,Santi Aldama,2,5,0.4
4335,11/7/2022,21.824657534246576,L,1,18.483333333333334,3,7,0.429,2,6,0.333,0,0,,1,0,1,0,0,0,0,1,8,4.6,-16.0,Santi Aldama,1,1,1.0
4336,11/9/2022,21.83013698630137,W,1,22.983333333333334,3,5,0.6,1,2,0.5,0,0,,4,3,7,1,1,1,0,2,7,10.0,7.0,Santi Aldama,2,3,0.6666666666666666
4337,11/11/2022,21.835616438356166,W,1,34.333333333333336,5,7,0.714,1,2,0.5,1,2,0.5,1,6,7,0,2,1,1,3,12,11.7,10.0,Santi Aldama,4,5,0.8
4338,11/13/2022,21.84109589041096,L,1,28.733333333333334,6,11,0.545,3,4,0.75,0,0,,2,5,7,2,1,3,2,5,15,13.1,3.0,Santi Aldama,3,7,0.42857142857142855
4339,11/15/2022,21.846575342465755,L,0,24.866666666666667,3,6,0.5,1,3,0.333,1,2,0.5,1,6,7,1,1,0,0,3,8,7.6,-2.0,Santi Aldama,2,3,0.6666666666666666
4340,11/18/2022,21.854794520547944,W,0,23.1,4,9,0.444,3,7,0.429,4,4,1.0,2,5,7,1,0,0,0,1,15,13.5,2.0,Santi Aldama,1,2,0.5
4341,11/20/2022,21.86027397260274,L,1,21.1,2,7,0.286,1,4,0.25,3,4,0.75,0,3,3,1,1,0,0,1,8,5.7,-13.0,Santi Aldama,1,3,0.3333333333333333
4342,11/22/2022,21.865753424657534,L,0,16.383333333333333,3,9,0.333,1,4,0.25,0,0,,1,1,2,2,3,1,0,3,7,6.8,-18.0,Santi Aldama,2,5,0.4
4343,11/27/2022,21.87945205479452,W,0,17.7,3,7,0.429,1,3,0.333,0,0,,1,3,4,1,0,0,1,3,7,3.4,4.0,Santi Aldama,2,4,0.5
4344,10/19/2022,26.578082191780823,W,1,33.36666666666667,4,11,0.364,4,9,0.444,0,0,,3,8,11,2,2,0,1,0,12,12.8,6.0,John Konchar,0,2,0.0
4345,10/21/2022,26.583561643835615,W,1,30.25,7,11,0.636,3,6,0.5,0,0,,2,3,5,0,3,1,0,1,17,17.7,13.0,John Konchar,4,5,0.8
4346,10/22/2022,26.586301369863016,L,1,20.433333333333334,2,4,0.5,1,3,0.333,0,0,,1,1,2,0,0,0,1,2,5,2.2,-27.0,John Konchar,1,1,1.0
4347,10/24/2022,26.59178082191781,W,0,26.2,2,3,0.667,2,3,0.667,1,2,0.5,1,3,4,0,2,0,0,1,7,8.5,-4.0,John Konchar,0,0,
4348,10/29/2022,26.605479452054794,L,0,27.983333333333334,0,2,0.0,0,1,0.0,0,0,,0,6,6,1,1,0,0,2,0,1.3,4.0,John Konchar,0,1,0.0
4349,10/31/2022,26.610958904109587,L,1,25.766666666666666,2,8,0.25,0,4,0.0,0,0,,1,2,3,0,3,1,1,4,4,1.6,-12.0,John Konchar,2,4,0.5
4350,11/2/2022,26.616438356164384,W,0,22.083333333333332,4,6,0.667,2,4,0.5,0,0,,2,3,5,4,1,0,1,2,10,11.7,13.0,John Konchar,2,2,1.0
4351,11/4/2022,26.621917808219177,W,0,20.883333333333333,3,4,0.75,2,3,0.667,0,0,,1,3,4,1,0,1,0,1,8,9.0,17.0,John Konchar,1,1,1.0
4352,11/6/2022,26.627397260273973,W,0,15.133333333333333,1,3,0.333,0,1,0.0,0,0,,2,2,4,1,0,0,0,2,2,2.2,-1.0,John Konchar,1,2,0.5
4353,11/7/2022,26.63013698630137,L,0,26.316666666666666,4,8,0.5,4,7,0.571,0,0,,3,4,7,1,0,1,2,2,12,9.9,12.0,John Konchar,0,1,0.0
4354,11/9/2022,26.635616438356166,W,0,28.333333333333332,2,6,0.333,0,2,0.0,0,0,,1,4,5,2,0,0,0,1,4,3.5,-4.0,John Konchar,2,4,0.5
4355,11/11/2022,26.64109589041096,W,0,22.516666666666666,0,2,0.0,0,2,0.0,0,0,,2,5,7,1,0,0,0,0,0,2.2,1.0,John Konchar,0,0,
4356,11/13/2022,26.646575342465752,L,1,36.55,3,9,0.333,1,3,0.333,0,0,,0,9,9,1,1,0,0,3,7,5.1,-7.0,John Konchar,2,6,0.3333333333333333
4357,11/15/2022,26.65205479452055,L,1,36.516666666666666,4,6,0.667,1,3,0.333,0,0,,2,6,8,2,1,0,1,4,9,9.4,-6.0,John Konchar,3,3,1.0
4358,11/18/2022,26.660273972602738,W,1,28.85,7,10,0.7,5,7,0.714,0,0,,1,9,10,2,0,1,1,0,19,19.3,17.0,John Konchar,2,3,0.6666666666666666
4359,11/20/2022,26.665753424657535,L,1,33.266666666666666,4,11,0.364,2,7,0.286,6,6,1.0,2,7,9,7,2,0,1,3,16,18.1,-4.0,John Konchar,2,4,0.5
4360,11/22/2022,26.671232876712327,L,1,30.583333333333332,3,8,0.375,2,6,0.333,2,2,1.0,1,8,9,2,1,2,4,3,10,7.3,-1.0,John Konchar,1,2,0.5
4361,11/25/2022,26.67945205479452,W,1,25.383333333333333,3,6,0.5,3,5,0.6,0,0,,2,4,6,0,1,0,1,1,9,8.2,28.0,John Konchar,0,1,0.0
4362,11/27/2022,26.684931506849313,W,1,29.166666666666668,4,6,0.667,1,2,0.5,1,1,1.0,1,7,8,2,0,0,0,3,10,10.4,7.0,John Konchar,3,4,0.75
4363,10/19/2022,29.24931506849315,W,1,32.53333333333333,1,2,0.5,0,0,,1,4,0.25,6,8,14,3,1,1,1,1,3,9.8,-1.0,Steven Adams,1,2,0.5
4364,10/21/2022,29.254794520547946,W,1,33.25,3,4,0.75,0,0,,0,2,0.0,2,7,9,2,0,2,0,5,6,7.9,23.0,Steven Adams,3,4,0.75
4365,10/22/2022,29.257534246575343,L,1,22.316666666666666,1,3,0.333,0,0,,0,2,0.0,1,3,4,1,1,4,3,1,2,2.2,-30.0,Steven Adams,1,3,0.3333333333333333
4366,10/24/2022,29.263013698630136,W,1,31.266666666666666,3,5,0.6,0,0,,3,6,0.5,4,9,13,2,1,1,0,2,9,13.3,20.0,Steven Adams,3,5,0.6
4367,10/27/2022,29.27123287671233,W,1,23.883333333333333,6,9,0.667,0,0,,0,3,0.0,7,4,11,4,0,0,4,4,12,10.2,2.0,Steven Adams,6,9,0.6666666666666666
4368,10/29/2022,29.276712328767122,L,1,19.216666666666665,1,2,0.5,0,0,,0,0,,5,5,10,1,1,1,4,4,2,2.8,11.0,Steven Adams,1,2,0.5
4369,10/31/2022,29.28219178082192,L,1,18.516666666666666,1,4,0.25,0,0,,0,1,0.0,2,7,9,1,1,1,4,1,2,0.7,-11.0,Steven Adams,1,4,0.25
4370,11/2/2022,29.28767123287671,W,1,33.61666666666667,6,9,0.667,0,0,,2,3,0.667,4,7,11,5,0,2,1,2,14,17.7,-6.0,Steven Adams,6,9,0.6666666666666666
4371,11/4/2022,29.293150684931508,W,1,21.733333333333334,6,10,0.6,0,0,,1,2,0.5,11,8,19,4,2,2,2,2,13,21.5,31.0,Steven Adams,6,10,0.6
4372,11/6/2022,29.2986301369863,W,1,22.183333333333334,2,2,1.0,0,0,,0,0,,5,5,10,1,0,0,1,3,4,6.9,9.0,Steven Adams,2,2,1.0
4373,11/9/2022,29.306849315068494,W,1,37.43333333333333,3,4,0.75,0,0,,1,2,0.5,10,9,19,2,1,1,6,3,7,10.6,5.0,Steven Adams,3,4,0.75
4374,11/11/2022,29.312328767123287,W,1,26.85,1,3,0.333,0,0,,1,4,0.25,5,4,9,3,1,1,1,4,3,6.0,6.0,Steven Adams,1,3,0.3333333333333333
4375,11/13/2022,29.317808219178083,L,1,29.383333333333333,6,8,0.75,0,0,,0,0,,6,4,10,6,1,0,3,5,12,14.4,4.0,Steven Adams,6,8,0.75
4376,11/15/2022,29.323287671232876,L,1,12.816666666666666,1,2,0.5,0,0,,0,2,0.0,2,3,5,1,0,0,2,3,2,0.0,-2.0,Steven Adams,1,2,0.5
4377,11/18/2022,29.33150684931507,W,1,25.3,3,3,1.0,0,0,,0,4,0.0,3,4,7,0,0,0,2,1,6,4.4,15.0,Steven Adams,3,3,1.0
4378,11/20/2022,29.336986301369862,L,1,28.633333333333333,7,10,0.7,0,0,,1,8,0.125,4,6,10,2,3,0,5,2,15,11.2,3.0,Steven Adams,7,10,0.7
4379,11/22/2022,29.34246575342466,L,1,30.183333333333334,2,5,0.4,0,0,,1,4,0.25,5,11,16,0,0,1,3,3,5,4.4,1.0,Steven Adams,2,5,0.4
4380,11/25/2022,29.350684931506848,W,1,25.033333333333335,7,10,0.7,0,0,,1,2,0.5,4,7,11,1,1,0,2,1,15,14.6,26.0,Steven Adams,7,10,0.7
4381,11/27/2022,29.356164383561644,W,1,31.333333333333332,6,9,0.667,0,0,,4,9,0.444,7,3,10,2,0,1,0,1,16,17.6,2.0,Steven Adams,6,9,0.6666666666666666
4382,10/19/2022,23.19178082191781,W,1,37.88333333333333,11,24,0.458,3,6,0.5,9,11,0.818,1,3,4,9,0,1,6,4,34,21.8,1.0,Ja Morant,8,18,0.4444444444444444
4383,10/21/2022,23.197260273972603,W,1,31.233333333333334,17,26,0.654,5,6,0.833,10,13,0.769,3,1,4,8,1,2,3,2,49,43.0,23.0,Ja Morant,12,20,0.6
4384,10/22/2022,23.2,L,1,29.516666666666666,6,12,0.5,0,2,0.0,8,8,1.0,0,1,1,4,1,0,3,3,20,13.9,-31.0,Ja Morant,6,10,0.6
4385,10/24/2022,23.205479452054796,W,1,34.166666666666664,12,22,0.545,4,6,0.667,10,11,0.909,2,6,8,7,2,0,2,1,38,34.7,20.0,Ja Morant,8,16,0.5
4386,10/27/2022,23.213698630136985,W,1,31.5,8,18,0.444,1,3,0.333,5,5,1.0,1,4,5,6,0,0,3,1,22,15.3,2.0,Ja Morant,7,15,0.4666666666666667
4387,10/31/2022,23.224657534246575,L,1,31.483333333333334,12,18,0.667,1,2,0.5,12,15,0.8,1,4,5,4,0,0,3,2,37,28.9,-19.0,Ja Morant,11,16,0.6875
4388,11/2/2022,23.23013698630137,W,1,32.06666666666667,7,19,0.368,0,2,0.0,6,7,0.857,0,9,9,7,2,0,8,1,20,10.3,1.0,Ja Morant,7,17,0.4117647058823529
4389,11/4/2022,23.235616438356164,W,1,24.9,4,12,0.333,1,3,0.333,3,4,0.75,0,4,4,11,0,0,5,0,12,8.7,40.0,Ja Morant,3,9,0.3333333333333333
4390,11/6/2022,23.24109589041096,W,1,33.25,9,27,0.333,1,4,0.25,4,6,0.667,2,7,9,6,1,0,4,0,23,11.6,3.0,Ja Morant,8,23,0.34782608695652173
4391,11/7/2022,23.243835616438357,L,1,35.31666666666667,10,24,0.417,5,12,0.417,5,9,0.556,0,8,8,9,2,1,4,4,30,21.4,14.0,Ja Morant,5,12,0.4166666666666667
4392,11/9/2022,23.24931506849315,W,1,39.55,14,25,0.56,2,5,0.4,2,3,0.667,0,5,5,5,1,0,3,1,32,22.3,11.0,Ja Morant,12,20,0.6
4393,11/11/2022,23.254794520547946,W,1,33.666666666666664,11,25,0.44,2,10,0.2,4,7,0.571,3,7,10,8,2,0,4,4,28,19.9,-2.0,Ja Morant,9,15,0.6
4394,11/15/2022,23.265753424657536,L,1,36.03333333333333,13,27,0.481,2,6,0.333,8,11,0.727,3,5,8,4,3,0,3,1,36,27.1,5.0,Ja Morant,11,21,0.5238095238095238
4395,11/18/2022,23.273972602739725,W,1,32.016666666666666,5,20,0.25,0,2,0.0,9,10,0.9,2,5,7,11,0,1,2,1,19,15.5,6.0,Ja Morant,5,18,0.2777777777777778
4396,11/22/2022,23.284931506849315,L,1,33.833333333333336,12,21,0.571,1,3,0.333,9,15,0.6,1,6,7,6,2,0,5,2,34,24.6,1.0,Ja Morant,11,18,0.6111111111111112
4397,11/25/2022,23.293150684931508,W,1,27.983333333333334,8,16,0.5,2,6,0.333,5,10,0.5,2,2,4,11,0,0,2,1,23,20.3,24.0,Ja Morant,6,10,0.6
4398,11/27/2022,23.2986301369863,W,1,35.233333333333334,9,20,0.45,0,3,0.0,9,11,0.818,1,9,10,14,1,0,4,3,27,24.8,7.0,Ja Morant,9,17,0.5294117647058824
4399,10/24/2022,26.753424657534246,W,1,24.166666666666668,2,13,0.154,0,5,0.0,0,0,,0,0,0,1,0,0,2,3,4,-6.8,7.0,Dillon Brooks,2,8,0.25
4400,10/27/2022,26.76164383561644,W,1,26.25,4,12,0.333,3,6,0.5,0,0,,0,2,2,2,0,0,2,1,11,3.8,-7.0,Dillon Brooks,1,6,0.16666666666666666
4401,10/29/2022,26.767123287671232,L,1,29.15,12,20,0.6,4,7,0.571,2,2,1.0,0,2,2,4,3,0,2,5,30,23.2,9.0,Dillon Brooks,8,13,0.6153846153846154
4402,10/31/2022,26.77260273972603,L,1,29.833333333333332,6,16,0.375,3,7,0.429,4,8,0.5,1,3,4,1,0,0,1,2,19,9.1,-2.0,Dillon Brooks,3,9,0.3333333333333333
4403,11/2/2022,26.778082191780822,W,1,29.566666666666666,3,7,0.429,1,2,0.5,2,2,1.0,0,2,2,0,1,0,0,3,9,5.7,-2.0,Dillon Brooks,2,5,0.4
4404,11/4/2022,26.783561643835615,W,1,22.133333333333333,8,12,0.667,6,7,0.857,1,2,0.5,1,3,4,4,0,0,1,4,23,19.2,31.0,Dillon Brooks,2,5,0.4
4405,11/6/2022,26.78904109589041,W,1,30.483333333333334,4,14,0.286,0,4,0.0,1,1,1.0,1,4,5,1,2,0,0,1,9,5.0,3.0,Dillon Brooks,4,10,0.4
4406,11/7/2022,26.791780821917808,L,1,31.866666666666667,6,17,0.353,0,4,0.0,1,2,0.5,0,7,7,5,1,2,1,6,13,7.7,13.0,Dillon Brooks,6,13,0.46153846153846156
4407,11/9/2022,26.797260273972604,W,1,36.36666666666667,5,13,0.385,3,5,0.6,0,0,,1,4,5,3,0,0,3,5,13,4.9,11.0,Dillon Brooks,2,8,0.25
4408,11/11/2022,26.802739726027397,W,1,32.56666666666667,9,17,0.529,1,6,0.167,2,2,1.0,0,4,4,0,0,0,1,1,21,12.5,1.0,Dillon Brooks,8,11,0.7272727272727273
4409,11/13/2022,26.80821917808219,L,1,28.483333333333334,7,22,0.318,3,9,0.333,2,2,1.0,1,3,4,2,0,0,3,5,19,4.4,1.0,Dillon Brooks,4,13,0.3076923076923077
4410,11/15/2022,26.813698630136987,L,1,37.35,6,18,0.333,2,9,0.222,5,6,0.833,0,2,2,1,1,0,1,3,19,8.5,1.0,Dillon Brooks,4,9,0.4444444444444444
4411,11/18/2022,26.82191780821918,W,1,35.5,6,20,0.3,2,9,0.222,2,4,0.5,1,2,3,6,1,0,1,2,16,8.3,19.0,Dillon Brooks,4,11,0.36363636363636365
4412,11/20/2022,26.827397260273973,L,1,33.85,13,30,0.433,3,11,0.273,2,4,0.5,4,1,5,4,4,0,0,0,31,24.3,-8.0,Dillon Brooks,10,19,0.5263157894736842
4413,11/22/2022,26.832876712328765,L,1,31.583333333333332,6,16,0.375,0,3,0.0,2,2,1.0,4,1,5,5,1,0,3,4,14,8.2,13.0,Dillon Brooks,6,13,0.46153846153846156
4414,11/25/2022,26.84109589041096,W,1,29.333333333333332,8,15,0.533,4,9,0.444,5,5,1.0,0,2,2,4,0,0,1,4,25,18.5,31.0,Dillon Brooks,4,6,0.6666666666666666
4415,11/27/2022,26.846575342465755,W,1,32.55,8,16,0.5,3,7,0.429,4,5,0.8,0,5,5,4,0,0,2,6,23,14.5,-6.0,Dillon Brooks,5,9,0.5555555555555556
4416,10/19/2022,20.958904109589042,W,0,12.533333333333333,1,2,0.5,1,2,0.5,2,2,1.0,1,1,2,1,1,1,0,2,5,6.6,-2.0,Jake LaRavia,0,0,
4417,10/21/2022,20.964383561643835,W,0,15.166666666666666,4,7,0.571,3,4,0.75,1,1,1.0,2,3,5,0,0,1,1,3,12,9.5,-4.0,Jake LaRavia,1,3,0.3333333333333333
4418,10/22/2022,20.96712328767123,L,0,22.433333333333334,2,6,0.333,2,5,0.4,0,0,,0,2,2,0,0,0,1,5,6,0.2,-10.0,Jake LaRavia,0,1,0.0
4419,10/24/2022,20.972602739726028,W,0,11.05,0,2,0.0,0,0,,0,0,,1,1,2,0,0,0,0,2,0,-1.2,-4.0,Jake LaRavia,0,2,0.0
4420,10/27/2022,20.980821917808218,W,0,29.833333333333332,5,6,0.833,3,4,0.75,0,0,,2,7,9,1,1,0,0,5,13,14.0,24.0,Jake LaRavia,2,2,1.0
4421,11/4/2022,21.002739726027396,W,0,19.166666666666668,1,4,0.25,0,2,0.0,2,2,1.0,1,8,9,0,0,0,1,0,4,3.7,-9.0,Jake LaRavia,1,2,0.5
4422,11/6/2022,21.008219178082193,W,0,16.166666666666668,2,3,0.667,2,3,0.667,0,0,,0,1,1,1,0,0,0,2,6,4.9,6.0,Jake LaRavia,0,0,
4423,11/7/2022,21.01095890410959,L,0,24.6,2,4,0.5,2,4,0.5,0,0,,0,3,3,1,1,0,1,2,6,4.8,7.0,Jake LaRavia,0,0,
4424,11/9/2022,21.016438356164382,W,0,16.733333333333334,3,4,0.75,0,1,0.0,0,0,,0,0,0,0,1,0,1,3,6,3.2,-12.0,Jake LaRavia,3,3,1.0
4425,11/11/2022,21.02191780821918,W,0,12.133333333333333,0,4,0.0,0,4,0.0,0,0,,2,0,2,1,1,0,1,1,0,-1.1,1.0,Jake LaRavia,0,0,
4426,11/13/2022,21.027397260273972,L,0,25.883333333333333,1,5,0.2,0,2,0.0,0,0,,0,5,5,3,1,1,3,2,2,0.4,-9.0,Jake LaRavia,1,3,0.3333333333333333
4427,11/18/2022,21.041095890410958,W,0,9.466666666666667,1,3,0.333,0,2,0.0,0,0,,0,1,1,1,0,0,0,2,2,0.5,-2.0,Jake LaRavia,1,1,1.0
4428,11/20/2022,21.046575342465754,L,0,28.85,4,12,0.333,3,9,0.333,0,0,,1,3,4,3,1,0,2,1,11,6.5,-4.0,Jake LaRavia,1,3,0.3333333333333333
4429,11/22/2022,21.052054794520547,L,0,9.866666666666667,0,1,0.0,0,1,0.0,0,0,,0,0,0,2,1,0,1,0,0,0.7,1.0,Jake LaRavia,0,0,
4430,11/25/2022,21.06027397260274,W,0,26.2,1,5,0.2,1,4,0.25,0,0,,2,2,4,0,0,0,1,2,3,0.1,-15.0,Jake LaRavia,0,1,0.0
4431,11/27/2022,21.065753424657533,W,0,15.333333333333334,2,2,1.0,2,2,1.0,0,0,,1,0,1,2,1,0,2,1,6,6.1,-2.0,Jake LaRavia,0,0,
4432,10/19/2022,24.317808219178083,W,1,37.483333333333334,6,22,0.273,3,13,0.231,1,2,0.5,0,4,4,6,0,1,2,3,16,5.5,13.0,Desmond Bane,3,9,0.3333333333333333
4433,10/21/2022,24.323287671232876,W,1,33.25,3,16,0.188,3,10,0.3,5,5,1.0,2,4,6,7,2,0,3,2,14,9.7,2.0,Desmond Bane,0,6,0.0
4434,10/22/2022,24.326027397260273,L,1,27.25,4,11,0.364,2,5,0.4,4,4,1.0,0,5,5,4,1,0,1,2,14,11.4,-8.0,Desmond Bane,2,6,0.3333333333333333
4435,10/24/2022,24.33150684931507,W,1,32.06666666666667,14,21,0.667,8,11,0.727,2,3,0.667,0,1,1,7,1,1,1,5,38,32.4,18.0,Desmond Bane,6,10,0.6
4436,10/27/2022,24.339726027397262,W,1,33.31666666666667,11,18,0.611,6,8,0.75,3,4,0.75,1,5,6,4,0,0,1,2,31,25.6,13.0,Desmond Bane,5,10,0.5
4437,10/29/2022,24.345205479452055,L,1,34.483333333333334,11,23,0.478,3,9,0.333,7,8,0.875,0,6,6,2,1,1,5,2,32,19.0,-8.0,Desmond Bane,8,14,0.5714285714285714
4438,11/2/2022,24.356164383561644,W,1,36.81666666666667,7,16,0.438,5,8,0.625,10,11,0.909,1,7,8,5,0,0,3,1,29,23.1,6.0,Desmond Bane,2,8,0.25
4439,11/4/2022,24.361643835616437,W,1,24.35,8,16,0.5,3,7,0.429,0,0,,1,5,6,2,0,0,3,3,19,10.4,29.0,Desmond Bane,5,9,0.5555555555555556
4440,11/6/2022,24.367123287671234,W,1,35.35,9,16,0.563,4,8,0.5,6,6,1.0,0,3,3,4,1,0,1,1,28,23.7,-1.0,Desmond Bane,5,8,0.625
4441,11/7/2022,24.36986301369863,L,1,35.46666666666667,7,15,0.467,2,6,0.333,3,3,1.0,0,5,5,5,0,0,1,3,19,14.1,-6.0,Desmond Bane,5,9,0.5555555555555556
4442,11/9/2022,24.375342465753423,W,1,39.416666666666664,12,23,0.522,5,10,0.5,3,3,1.0,1,5,6,6,0,0,2,2,32,24.3,6.0,Desmond Bane,7,13,0.5384615384615384
4443,11/11/2022,24.38082191780822,W,1,33.266666666666666,7,16,0.438,2,7,0.286,8,8,1.0,0,3,3,5,1,0,4,3,24,15.8,12.0,Desmond Bane,5,9,0.5555555555555556
4444,10/19/2022,23.767123287671232,W,0,15.816666666666666,2,5,0.4,0,0,,0,0,,2,4,6,1,0,2,1,1,4,4.6,1.0,Xavier Tillman Sr.,2,5,0.4
4445,10/21/2022,23.77260273972603,W,0,6.65,0,2,0.0,0,1,0.0,0,0,,1,1,2,0,0,0,0,1,0,-0.8,-17.0,Xavier Tillman Sr.,0,1,0.0
4446,10/22/2022,23.775342465753425,L,0,8.9,3,4,0.75,1,2,0.5,0,0,,1,1,2,1,0,0,1,0,7,6.1,-9.0,Xavier Tillman Sr.,2,2,1.0
4447,10/29/2022,23.794520547945204,L,0,10.8,2,3,0.667,0,0,,0,0,,1,1,2,1,0,0,1,0,4,3.4,-9.0,Xavier Tillman Sr.,2,3,0.6666666666666666
4448,10/31/2022,23.8,L,0,17.116666666666667,3,4,0.75,0,0,,2,7,0.286,3,2,5,0,0,0,1,1,8,5.7,-2.0,Xavier Tillman Sr.,3,4,0.75
4449,11/4/2022,23.81095890410959,W,0,10.35,1,2,0.5,0,0,,0,0,,0,1,1,1,0,0,1,0,2,1.0,-9.0,Xavier Tillman Sr.,1,2,0.5
4450,11/6/2022,23.816438356164383,W,0,4.416666666666667,0,1,0.0,0,0,,1,2,0.5,2,0,2,0,0,0,2,3,1,-1.9,-8.0,Xavier Tillman Sr.,0,1,0.0
4451,11/7/2022,23.81917808219178,L,0,17.316666666666666,1,2,0.5,0,1,0.0,0,0,,1,2,3,2,0,0,0,2,2,2.9,3.0,Xavier Tillman Sr.,1,1,1.0
4452,11/20/2022,23.854794520547944,L,0,2.65,1,1,1.0,0,0,,0,1,0.0,0,0,0,0,1,0,0,0,2,2.3,5.0,Xavier Tillman Sr.,1,1,1.0
4453,10/22/2022,20.0986301369863,L,0,8.9,0,2,0.0,0,0,,0,1,0.0,0,0,0,2,0,2,2,0,0,-1.0,-9.0,Kennedy Chandler,0,2,0.0
4454,10/27/2022,20.112328767123287,W,0,0.5666666666666667,0,0,,0,0,,0,0,,0,0,0,0,0,0,0,0,0,0.0,0.0,Kennedy Chandler,0,0,
4455,10/29/2022,20.117808219178084,L,0,13.766666666666667,2,4,0.5,0,1,0.0,0,0,,0,0,0,1,0,0,1,1,4,1.3,6.0,Kennedy Chandler,2,3,0.6666666666666666
4456,10/31/2022,20.123287671232877,L,0,12.183333333333334,1,3,0.333,0,1,0.0,1,3,0.333,0,1,1,3,0,0,1,1,3,1.5,2.0,Kennedy Chandler,1,2,0.5
4457,11/4/2022,20.134246575342466,W,0,10.35,1,5,0.2,0,1,0.0,0,0,,0,2,2,4,2,0,1,0,2,3.3,-9.0,Kennedy Chandler,1,4,0.25
4458,11/13/2022,20.15890410958904,L,0,11.75,2,5,0.4,1,3,0.333,0,0,,1,2,3,2,0,0,1,1,5,3.6,-6.0,Kennedy Chandler,1,2,0.5
4459,11/20/2022,20.17808219178082,L,0,13.65,2,5,0.4,0,1,0.0,2,3,0.667,0,3,3,3,1,0,0,1,6,6.5,-7.0,Kennedy Chandler,2,4,0.5
4460,11/25/2022,20.19178082191781,W,0,7.783333333333333,0,3,0.0,0,0,,0,0,,1,0,1,1,1,0,1,1,0,-1.1,-7.0,Kennedy Chandler,0,3,0.0
4461,11/15/2022,23.167123287671235,L,1,25.033333333333335,3,14,0.214,0,7,0.0,1,2,0.5,2,4,6,0,0,5,2,1,7,1.7,-6.0,Jaren Jackson Jr.,3,7,0.42857142857142855
4462,11/18/2022,23.175342465753424,W,1,24.9,7,16,0.438,3,6,0.5,8,11,0.727,5,7,12,0,2,3,2,2,25,22.3,9.0,Jaren Jackson Jr.,4,10,0.4
4463,11/22/2022,23.186301369863013,L,1,27.466666666666665,8,14,0.571,1,5,0.2,5,7,0.714,0,3,3,1,2,5,0,4,22,20.1,15.0,Jaren Jackson Jr.,7,9,0.7777777777777778
4464,11/25/2022,23.194520547945206,W,1,21.8,6,7,0.857,2,3,0.667,6,7,0.857,0,4,4,0,1,3,1,4,20,18.8,18.0,Jaren Jackson Jr.,4,4,1.0
4465,11/27/2022,23.2,W,1,30.3,8,19,0.421,3,8,0.375,2,2,1.0,2,3,5,0,1,0,0,2,21,13.4,0.0,Jaren Jackson Jr.,5,11,0.45454545454545453
4466,10/22/2022,22.145205479452056,L,0,6.266666666666667,0,2,0.0,0,2,0.0,0,0,,0,0,0,0,0,0,0,2,0,-2.2,-3.0,Vince Williams Jr.,0,0,
4467,10/31/2022,22.16986301369863,L,0,4.666666666666667,1,3,0.333,0,2,0.0,0,0,,1,2,3,1,1,0,0,0,2,3.3,4.0,Vince Williams Jr.,1,1,1.0
4468,11/4/2022,22.18082191780822,W,0,7.383333333333334,0,1,0.0,0,1,0.0,0,0,,0,0,0,1,1,1,0,2,0,0.9,-9.0,Vince Williams Jr.,0,0,
4469,11/20/2022,22.224657534246575,L,0,2.65,1,1,1.0,0,0,,0,0,,0,0,0,0,0,0,0,0,2,1.7,5.0,Vince Williams Jr.,1,1,1.0
4470,11/25/2022,22.23835616438356,W,0,4.716666666666667,1,1,1.0,1,1,1.0,0,0,,0,0,0,0,0,0,0,0,3,2.7,-10.0,Vince Williams Jr.,0,0,
4471,10/22/2022,20.18904109589041,L,0,8.9,2,4,0.5,0,1,0.0,0,1,0.0,0,1,1,1,0,0,0,3,4,1.4,-9.0,Kenneth Lofton Jr.,2,3,0.6666666666666666
4472,10/27/2022,20.202739726027396,W,0,0.4166666666666667,0,0,,0,0,,0,0,,0,0,0,0,0,0,0,0,0,0.0,0.0,Kenneth Lofton Jr.,0,0,
4473,10/31/2022,20.213698630136985,L,0,4.666666666666667,2,5,0.4,0,0,,1,2,0.5,1,0,1,0,0,0,0,0,5,2.6,4.0,Kenneth Lofton Jr.,2,5,0.4
4474,11/25/2022,20.28219178082192,W,0,4.716666666666667,1,3,0.333,0,0,,0,0,,0,1,1,2,0,0,1,0,2,1.0,-10.0,Kenneth Lofton Jr.,1,3,0.3333333333333333
4475,10/19/2022,30.454794520547946,W,1,26.616666666666667,6,13,0.462,1,1,1.0,2,2,1.0,6,7,13,2,0,1,1,1,15,15.3,28.0,Jonas Valančiūnas,5,12,0.4166666666666667
4476,10/21/2022,30.46027397260274,W,1,29.45,8,11,0.727,1,3,0.333,13,14,0.929,4,13,17,4,1,1,1,1,30,34.9,19.0,Jonas Valančiūnas,7,8,0.875
4477,10/23/2022,30.465753424657535,L,1,24.45,2,11,0.182,0,1,0.0,2,2,1.0,8,1,9,3,1,0,1,3,6,5.9,-7.0,Jonas Valančiūnas,2,10,0.2
4478,10/25/2022,30.471232876712328,W,1,22.3,5,9,0.556,0,2,0.0,3,3,1.0,0,7,7,2,0,1,1,3,13,10.7,2.0,Jonas Valančiūnas,5,7,0.7142857142857143
4479,10/28/2022,30.47945205479452,L,1,31.283333333333335,11,16,0.688,0,0,,3,3,1.0,3,7,10,2,1,0,2,3,25,21.6,0.0,Jonas Valančiūnas,11,16,0.6875
4480,10/30/2022,30.484931506849314,W,1,23.916666666666668,4,6,0.667,1,2,0.5,2,4,0.5,1,6,7,5,1,0,3,2,11,10.8,1.0,Jonas Valančiūnas,3,4,0.75
4481,11/2/2022,30.493150684931507,L,1,21.716666666666665,3,11,0.273,1,2,0.5,2,2,1.0,4,6,10,1,0,0,2,2,9,5.0,-10.0,Jonas Valančiūnas,2,9,0.2222222222222222
4482,11/4/2022,30.4986301369863,W,1,19.45,2,3,0.667,0,1,0.0,4,6,0.667,1,5,6,0,0,0,1,2,8,6.3,-13.0,Jonas Valančiūnas,2,2,1.0
4483,11/5/2022,30.5013698630137,L,1,25.65,5,12,0.417,0,0,,3,4,0.75,7,10,17,1,1,1,2,2,13,13.7,-9.0,Jonas Valančiūnas,5,12,0.4166666666666667
4484,11/7/2022,30.506849315068493,L,1,21.816666666666666,7,9,0.778,0,0,,0,0,,2,5,7,2,0,0,0,3,14,13.6,-13.0,Jonas Valančiūnas,7,9,0.7777777777777778
4485,11/9/2022,30.512328767123286,W,1,29.633333333333333,8,13,0.615,0,2,0.0,5,6,0.833,3,10,13,3,1,0,2,0,21,20.9,8.0,Jonas Valančiūnas,8,11,0.7272727272727273
4486,11/10/2022,30.515068493150686,L,1,19.633333333333333,2,8,0.25,1,1,1.0,2,2,1.0,2,9,11,1,0,0,0,3,7,5.8,-17.0,Jonas Valančiūnas,1,7,0.14285714285714285
4487,11/12/2022,30.52054794520548,W,1,20.266666666666666,2,7,0.286,1,1,1.0,3,4,0.75,2,2,4,1,1,0,1,3,8,5.0,3.0,Jonas Valančiūnas,1,6,0.16666666666666666
4488,11/15/2022,30.528767123287672,W,1,13.683333333333334,1,4,0.25,0,1,0.0,0,0,,1,2,3,2,0,0,4,4,2,-3.3,-5.0,Jonas Valančiūnas,1,3,0.3333333333333333
4489,11/16/2022,30.53150684931507,W,1,27.233333333333334,8,13,0.615,2,3,0.667,4,4,1.0,3,4,7,2,0,1,3,3,22,17.3,11.0,Jonas Valančiūnas,6,10,0.6
4490,11/18/2022,30.536986301369865,L,1,21.25,5,7,0.714,0,0,,0,1,0.0,0,4,4,3,0,0,2,3,10,6.8,-8.0,Jonas Valančiūnas,5,7,0.7142857142857143
4491,11/21/2022,30.545205479452054,W,1,22.783333333333335,4,4,1.0,0,0,,2,5,0.4,4,9,13,2,0,0,2,3,10,11.3,22.0,Jonas Valančiūnas,4,4,1.0
4492,11/23/2022,30.55068493150685,W,1,26.116666666666667,9,11,0.818,4,5,0.8,0,0,,1,9,10,2,0,1,3,2,22,19.6,24.0,Jonas Valančiūnas,5,6,0.8333333333333334
4493,11/25/2022,30.556164383561644,L,1,17.4,2,5,0.4,0,1,0.0,0,0,,0,3,3,1,0,0,4,5,4,-3.1,-21.0,Jonas Valančiūnas,2,4,0.5
4494,10/19/2022,24.52054794520548,W,0,15.716666666666667,3,6,0.5,1,2,0.5,0,0,,0,2,2,2,0,0,0,2,7,5.2,3.0,Jose Alvarado,2,4,0.5
4495,10/21/2022,24.526027397260275,W,0,14.633333333333333,2,4,0.5,1,3,0.333,1,2,0.5,0,2,2,1,1,0,2,0,6,3.9,-4.0,Jose Alvarado,1,1,1.0
4496,10/23/2022,24.53150684931507,L,0,24.166666666666668,3,6,0.5,1,3,0.333,0,0,,0,3,3,4,1,1,3,1,7,6.0,-5.0,Jose Alvarado,2,3,0.6666666666666666
4497,10/25/2022,24.536986301369865,W,1,25.983333333333334,6,8,0.75,1,3,0.333,0,0,,0,3,3,3,2,0,2,1,13,12.4,12.0,Jose Alvarado,5,5,1.0
4498,10/28/2022,24.545205479452054,L,1,29.316666666666666,4,12,0.333,4,7,0.571,2,2,1.0,0,1,1,3,1,0,3,4,14,6.0,-7.0,Jose Alvarado,0,5,0.0
4499,10/30/2022,24.55068493150685,W,0,18.533333333333335,0,5,0.0,0,4,0.0,0,0,,1,0,1,2,0,0,0,1,0,-1.8,3.0,Jose Alvarado,0,1,0.0
4500,11/2/2022,24.55890410958904,L,0,17.533333333333335,6,8,0.75,3,4,0.75,0,0,,0,2,2,4,1,0,1,2,15,14.4,10.0,Jose Alvarado,3,4,0.75
4501,11/4/2022,24.564383561643837,W,0,18.0,3,6,0.5,3,4,0.75,1,2,0.5,1,0,1,2,2,0,2,2,10,7.9,15.0,Jose Alvarado,0,2,0.0
4502,11/5/2022,24.567123287671233,L,0,15.65,2,5,0.4,1,2,0.5,0,0,,0,1,1,4,0,1,1,2,5,4.3,5.0,Jose Alvarado,1,3,0.3333333333333333
4503,11/7/2022,24.572602739726026,L,0,14.266666666666667,0,5,0.0,0,3,0.0,1,2,0.5,1,1,2,3,1,0,1,2,1,-0.6,0.0,Jose Alvarado,0,2,0.0
4504,11/9/2022,24.578082191780823,W,0,13.416666666666666,3,5,0.6,0,1,0.0,1,1,1.0,1,2,3,2,0,0,0,2,7,6.6,-4.0,Jose Alvarado,3,4,0.75
4505,11/10/2022,24.58082191780822,L,0,16.916666666666668,1,5,0.2,1,4,0.25,0,0,,1,2,3,1,0,0,2,2,3,-0.9,2.0,Jose Alvarado,0,1,0.0
4506,11/12/2022,24.586301369863016,W,0,20.216666666666665,5,6,0.833,2,3,0.667,0,0,,0,2,2,5,3,0,0,5,12,14.9,15.0,Jose Alvarado,3,3,1.0
4507,11/15/2022,24.594520547945205,W,0,21.166666666666668,5,11,0.455,2,6,0.333,0,0,,0,3,3,6,0,1,1,3,12,9.9,15.0,Jose Alvarado,3,5,0.6
4508,11/16/2022,24.5972602739726,W,0,21.366666666666667,6,7,0.857,0,1,0.0,1,1,1.0,1,2,3,1,0,0,1,3,13,10.3,-1.0,Jose Alvarado,6,6,1.0
4509,11/18/2022,24.602739726027398,L,0,24.0,4,12,0.333,0,6,0.0,2,2,1.0,2,4,6,4,1,1,1,4,10,7.7,8.0,Jose Alvarado,4,6,0.6666666666666666
4510,11/21/2022,24.610958904109587,W,0,16.2,4,7,0.571,2,5,0.4,0,0,,0,1,1,3,3,0,0,1,10,11.7,12.0,Jose Alvarado,2,2,1.0
4511,11/23/2022,24.616438356164384,W,1,29.883333333333333,2,5,0.4,1,2,0.5,0,0,,0,3,3,9,3,0,5,3,5,6.3,20.0,Jose Alvarado,1,3,0.3333333333333333
4512,11/25/2022,24.621917808219177,L,1,22.25,2,7,0.286,1,4,0.25,2,2,1.0,0,4,4,2,1,0,1,0,7,5.5,-24.0,Jose Alvarado,1,3,0.3333333333333333
4513,10/19/2022,24.734246575342464,W,0,14.033333333333333,2,4,0.5,0,0,,0,0,,1,3,4,2,0,0,0,1,4,4.6,-7.0,Naji Marshall,2,4,0.5
4514,10/21/2022,24.73972602739726,W,0,11.916666666666666,0,1,0.0,0,0,,0,0,,1,0,1,1,0,1,1,1,0,0.0,4.0,Naji Marshall,0,1,0.0
4515,10/23/2022,24.745205479452054,L,0,13.5,2,6,0.333,0,2,0.0,3,4,0.75,0,1,1,0,2,1,0,1,7,5.8,-7.0,Naji Marshall,2,4,0.5
4516,10/25/2022,24.75068493150685,W,1,33.38333333333333,6,9,0.667,0,2,0.0,3,4,0.75,2,1,3,1,0,0,3,3,15,8.9,14.0,Naji Marshall,6,7,0.8571428571428571
4517,10/28/2022,24.75890410958904,L,1,35.0,7,13,0.538,3,7,0.429,4,5,0.8,4,2,6,5,1,0,2,2,21,19.4,2.0,Naji Marshall,4,6,0.6666666666666666
4518,10/30/2022,24.764383561643836,W,1,38.733333333333334,7,13,0.538,3,5,0.6,0,0,,1,5,6,4,2,0,2,3,17,14.5,17.0,Naji Marshall,4,8,0.5
4519,11/2/2022,24.77260273972603,L,1,38.53333333333333,3,8,0.375,1,3,0.333,2,2,1.0,0,5,5,3,3,1,2,1,9,9.5,-10.0,Naji Marshall,2,5,0.4
4520,11/4/2022,24.778082191780822,W,0,9.083333333333334,0,2,0.0,0,2,0.0,0,0,,0,0,0,0,0,0,0,1,0,-1.8,1.0,Naji Marshall,0,0,
4521,11/5/2022,24.78082191780822,L,0,12.45,0,3,0.0,0,0,,0,0,,1,1,2,0,0,0,0,2,0,-1.9,5.0,Naji Marshall,0,3,0.0
4522,11/7/2022,24.786301369863015,L,0,6.05,1,4,0.25,0,2,0.0,0,0,,1,1,2,0,0,0,0,1,2,0.2,-3.0,Naji Marshall,1,2,0.5
4523,11/9/2022,24.791780821917808,W,0,22.133333333333333,4,8,0.5,1,1,1.0,0,2,0.0,1,4,5,0,0,0,2,2,9,3.3,6.0,Naji Marshall,3,7,0.42857142857142855
4524,11/10/2022,24.794520547945204,L,0,6.2,1,3,0.333,1,2,0.5,0,0,,0,1,1,0,0,0,0,0,3,1.6,6.0,Naji Marshall,0,1,0.0
4525,11/12/2022,24.8,W,0,15.05,1,3,0.333,1,1,1.0,0,0,,1,0,1,2,1,0,0,0,3,4.4,-19.0,Naji Marshall,0,2,0.0
4526,11/15/2022,24.80821917808219,W,0,25.45,1,5,0.2,0,2,0.0,2,2,1.0,0,8,8,4,0,0,2,2,4,3.3,8.0,Naji Marshall,1,3,0.3333333333333333
4527,11/16/2022,24.81095890410959,W,0,18.116666666666667,1,6,0.167,1,4,0.25,0,0,,0,1,1,0,0,0,1,0,3,-1.5,-6.0,Naji Marshall,0,2,0.0
4528,11/18/2022,24.816438356164383,L,0,21.516666666666666,3,5,0.6,1,3,0.333,2,2,1.0,0,1,1,3,1,0,0,1,9,9.7,-5.0,Naji Marshall,2,2,1.0
4529,11/21/2022,24.824657534246576,W,0,23.433333333333334,3,7,0.429,0,2,0.0,0,0,,0,4,4,7,1,0,1,0,6,8.4,19.0,Naji Marshall,3,5,0.6
4530,11/23/2022,24.83013698630137,W,0,24.066666666666666,1,4,0.25,0,1,0.0,3,4,0.75,0,1,1,5,0,0,2,1,5,3.6,4.0,Naji Marshall,1,3,0.3333333333333333
4531,11/25/2022,24.835616438356166,L,0,13.916666666666666,3,6,0.5,3,5,0.6,0,0,,2,0,2,1,0,0,0,1,9,7.7,-9.0,Naji Marshall,0,1,0.0
4532,10/19/2022,27.654794520547945,W,0,15.033333333333333,0,3,0.0,0,1,0.0,0,0,,0,0,0,2,0,0,0,0,0,-0.7,-4.0,Devonte' Graham,0,2,0.0
4533,10/21/2022,27.660273972602738,W,0,11.4,1,4,0.25,1,4,0.25,1,2,0.5,0,1,1,1,0,0,0,0,4,2.2,-6.0,Devonte' Graham,0,0,
4534,10/23/2022,27.665753424657535,L,0,14.916666666666666,1,2,0.5,1,1,1.0,0,0,,0,1,1,2,1,1,1,1,3,4.0,1.0,Devonte' Graham,0,1,0.0
4535,10/25/2022,27.671232876712327,W,0,27.016666666666666,4,10,0.4,4,8,0.5,2,4,0.5,0,1,1,3,0,0,0,2,14,9.4,-1.0,Devonte' Graham,0,2,0.0
4536,10/28/2022,27.67945205479452,L,0,28.05,3,7,0.429,3,6,0.5,2,2,1.0,0,3,3,2,2,0,1,2,11,9.8,-21.0,Devonte' Graham,0,1,0.0
4537,10/30/2022,27.684931506849313,W,0,23.55,3,6,0.5,3,6,0.5,0,0,,1,3,4,6,1,0,0,1,9,12.4,14.0,Devonte' Graham,0,0,
4538,11/2/2022,27.693150684931506,L,0,18.333333333333332,2,3,0.667,0,1,0.0,0,0,,0,1,1,2,0,0,3,1,4,1.0,2.0,Devonte' Graham,2,2,1.0
4539,11/4/2022,27.698630136986303,W,0,9.4,0,1,0.0,0,1,0.0,0,0,,0,1,1,4,0,0,0,1,0,2.0,-4.0,Devonte' Graham,0,0,
4540,11/5/2022,27.7013698630137,L,0,11.016666666666667,0,1,0.0,0,1,0.0,0,0,,0,0,0,1,0,0,1,2,0,-1.8,-9.0,Devonte' Graham,0,0,
4541,11/7/2022,27.706849315068492,L,0,20.366666666666667,3,9,0.333,3,8,0.375,2,2,1.0,0,2,2,4,0,0,0,0,11,9.3,0.0,Devonte' Graham,0,1,0.0
4542,11/9/2022,27.71232876712329,W,0,16.366666666666667,1,2,0.5,1,2,0.5,0,0,,0,1,1,2,1,2,0,1,3,5.7,2.0,Devonte' Graham,0,0,
4543,11/10/2022,27.715068493150685,L,0,7.966666666666667,0,1,0.0,0,1,0.0,0,0,,0,0,0,1,0,0,0,0,0,0.0,-4.0,Devonte' Graham,0,0,
4544,11/12/2022,27.720547945205478,W,0,9.316666666666666,2,4,0.5,1,2,0.5,0,0,,0,0,0,1,2,0,0,0,5,5.7,-7.0,Devonte' Graham,1,2,0.5
4545,11/15/2022,27.72876712328767,W,0,9.483333333333333,0,1,0.0,0,1,0.0,1,2,0.5,0,1,1,2,0,0,0,0,1,1.6,4.0,Devonte' Graham,0,0,
4546,11/16/2022,27.731506849315068,W,0,8.35,2,3,0.667,2,3,0.667,0,0,,1,0,1,1,0,0,1,0,6,5.1,0.0,Devonte' Graham,0,0,
4547,11/18/2022,27.736986301369864,L,0,8.366666666666667,1,2,0.5,1,2,0.5,0,0,,0,0,0,0,0,0,0,0,3,2.0,-4.0,Devonte' Graham,0,0,
4548,11/21/2022,27.745205479452054,W,0,22.033333333333335,6,11,0.545,6,11,0.545,1,1,1.0,0,5,5,4,1,0,1,1,19,17.6,27.0,Devonte' Graham,0,0,
4549,11/23/2022,27.75068493150685,W,0,27.8,7,13,0.538,6,11,0.545,1,1,1.0,0,4,4,0,1,1,1,2,21,15.8,9.0,Devonte' Graham,1,2,0.5
4550,11/25/2022,27.756164383561643,L,0,14.283333333333333,1,3,0.333,1,3,0.333,2,3,0.667,0,2,2,3,1,1,1,0,5,6.3,-6.0,Devonte' Graham,0,0,
4551,10/19/2022,29.797260273972604,W,0,21.383333333333333,4,6,0.667,0,0,,0,1,0.0,3,6,9,2,1,1,3,1,8,8.6,-6.0,Larry Nance Jr.,4,6,0.6666666666666666
4552,10/21/2022,29.802739726027397,W,0,15.166666666666666,1,2,0.5,0,0,,0,0,,2,0,2,2,0,2,0,2,2,4.4,-6.0,Larry Nance Jr.,1,2,0.5
4553,10/23/2022,29.80821917808219,L,0,28.55,5,10,0.5,0,2,0.0,0,0,,2,5,7,6,0,0,0,0,10,12.1,6.0,Larry Nance Jr.,5,8,0.625
4554,10/25/2022,29.813698630136987,W,0,23.783333333333335,5,6,0.833,1,1,1.0,0,0,,0,2,2,1,0,0,1,4,11,7.5,-2.0,Larry Nance Jr.,4,5,0.8
4555,10/28/2022,29.82191780821918,L,0,14.183333333333334,1,5,0.2,0,1,0.0,0,0,,0,0,0,0,1,1,2,3,2,-2.6,-19.0,Larry Nance Jr.,1,4,0.25
4556,10/30/2022,29.827397260273973,W,0,23.233333333333334,7,9,0.778,1,1,1.0,0,0,,1,8,9,3,1,0,3,2,15,13.9,19.0,Larry Nance Jr.,6,8,0.75
4557,11/2/2022,29.835616438356166,L,0,31.283333333333335,5,8,0.625,0,0,,1,2,0.5,0,8,8,5,4,1,0,4,11,16.0,7.0,Larry Nance Jr.,5,8,0.625
4558,11/4/2022,29.84109589041096,W,0,28.55,10,12,0.833,0,0,,0,0,,4,4,8,1,0,0,1,3,20,18.1,22.0,Larry Nance Jr.,10,12,0.8333333333333334
4559,11/5/2022,29.843835616438355,L,0,27.266666666666666,3,4,0.75,0,0,,2,2,1.0,1,3,4,2,3,1,0,1,8,12.7,6.0,Larry Nance Jr.,3,4,0.75
4560,11/7/2022,29.84931506849315,L,0,14.183333333333334,1,1,1.0,0,0,,1,2,0.5,1,3,4,4,0,0,0,2,3,5.9,4.0,Larry Nance Jr.,1,1,1.0
4561,11/10/2022,29.85753424657534,L,0,23.166666666666668,0,2,0.0,0,0,,0,0,,2,4,6,1,0,0,1,2,0,0.1,11.0,Larry Nance Jr.,0,2,0.0
4562,11/12/2022,29.863013698630137,W,0,27.733333333333334,8,10,0.8,2,3,0.667,4,5,0.8,5,4,9,0,0,0,3,3,22,18.3,10.0,Larry Nance Jr.,6,7,0.8571428571428571
4563,11/15/2022,29.87123287671233,W,0,30.783333333333335,8,10,0.8,1,1,1.0,2,2,1.0,2,5,7,2,0,2,0,1,19,20.5,16.0,Larry Nance Jr.,7,9,0.7777777777777778
4564,11/16/2022,29.873972602739727,W,0,18.866666666666667,2,5,0.4,0,2,0.0,4,4,1.0,1,5,6,3,0,1,0,1,8,9.9,6.0,Larry Nance Jr.,2,3,0.6666666666666666
4565,11/18/2022,29.87945205479452,L,0,26.75,7,8,0.875,0,0,,2,2,1.0,4,4,8,1,3,2,3,2,16,18.5,0.0,Larry Nance Jr.,7,8,0.875
4566,11/21/2022,29.887671232876713,W,0,17.85,2,4,0.5,0,1,0.0,0,0,,0,3,3,0,2,2,0,1,4,5.9,19.0,Larry Nance Jr.,2,3,0.6666666666666666
4567,11/23/2022,29.893150684931506,W,0,16.533333333333335,3,4,0.75,0,0,,0,1,0.0,2,0,2,2,0,0,0,0,6,6.8,-1.0,Larry Nance Jr.,3,4,0.75
4568,11/25/2022,29.898630136986302,L,0,14.633333333333333,2,4,0.5,0,1,0.0,0,0,,1,0,1,0,0,1,0,2,4,2.6,-6.0,Larry Nance Jr.,2,3,0.6666666666666666
4569,10/19/2022,31.08219178082192,W,1,31.05,7,16,0.438,3,9,0.333,4,5,0.8,1,3,4,6,3,0,1,2,21,19.2,23.0,CJ McCollum,4,7,0.5714285714285714
4570,10/21/2022,31.087671232876712,W,1,31.55,9,17,0.529,2,6,0.333,1,1,1.0,2,4,6,2,1,0,3,3,21,13.5,15.0,CJ McCollum,7,11,0.6363636363636364
4571,10/23/2022,31.09315068493151,L,1,40.71666666666667,12,25,0.48,2,8,0.25,2,2,1.0,0,4,4,12,1,0,2,2,28,23.1,9.0,CJ McCollum,10,17,0.5882352941176471
4572,10/25/2022,31.0986301369863,W,1,35.516666666666666,6,20,0.3,1,5,0.2,1,1,1.0,0,0,0,11,1,1,3,1,14,8.4,10.0,CJ McCollum,5,15,0.3333333333333333
4573,10/28/2022,31.106849315068494,L,1,34.516666666666666,6,19,0.316,0,5,0.0,5,6,0.833,0,2,2,9,1,0,1,2,17,11.8,0.0,CJ McCollum,6,14,0.42857142857142855
4574,10/30/2022,31.112328767123287,W,1,31.683333333333334,9,19,0.474,4,8,0.5,0,0,,0,5,5,3,1,0,0,2,22,16.1,13.0,CJ McCollum,5,11,0.45454545454545453
4575,11/2/2022,31.12054794520548,L,1,40.81666666666667,10,27,0.37,1,6,0.167,1,1,1.0,1,8,9,8,1,2,1,2,22,16.4,-3.0,CJ McCollum,9,21,0.42857142857142855
4576,11/4/2022,31.126027397260273,W,1,34.43333333333333,7,17,0.412,3,6,0.5,3,4,0.75,2,6,8,5,2,0,3,1,20,15.8,-5.0,CJ McCollum,4,11,0.36363636363636365
4577,11/5/2022,31.12876712328767,L,1,41.31666666666667,12,23,0.522,4,9,0.444,1,1,1.0,2,8,10,0,1,1,2,4,29,19.6,0.0,CJ McCollum,8,14,0.5714285714285714
4578,11/7/2022,31.134246575342466,L,1,35.81666666666667,3,11,0.273,2,5,0.4,1,2,0.5,2,3,5,7,1,0,3,3,9,6.1,-11.0,CJ McCollum,1,6,0.16666666666666666
4579,11/9/2022,31.13972602739726,W,1,34.483333333333334,3,13,0.231,0,5,0.0,1,3,0.333,1,3,4,5,1,2,2,0,7,3.8,-5.0,CJ McCollum,3,8,0.375
4580,11/10/2022,31.14246575342466,L,1,37.93333333333333,6,17,0.353,1,7,0.143,0,0,,1,6,7,7,2,2,5,2,13,8.5,-1.0,CJ McCollum,5,10,0.5
4581,11/12/2022,31.147945205479452,W,1,37.416666666666664,3,14,0.214,1,7,0.143,2,2,1.0,1,6,7,7,2,0,2,1,9,7.4,20.0,CJ McCollum,2,7,0.2857142857142857
4582,11/15/2022,31.156164383561645,W,1,36.9,11,23,0.478,7,13,0.538,1,2,0.5,1,2,3,9,0,1,2,2,30,23.4,7.0,CJ McCollum,4,10,0.4
4583,11/16/2022,31.15890410958904,W,1,37.13333333333333,8,16,0.5,3,8,0.375,4,4,1.0,1,3,4,8,0,1,3,0,23,19.9,10.0,CJ McCollum,5,8,0.625
4584,11/18/2022,31.164383561643834,L,1,34.45,7,18,0.389,4,8,0.5,0,0,,0,5,5,3,3,0,1,4,18,12.2,-1.0,CJ McCollum,3,10,0.3
4585,11/21/2022,31.172602739726027,W,1,21.5,6,10,0.6,3,5,0.6,0,0,,3,0,3,2,0,0,2,0,15,11.9,21.0,CJ McCollum,3,5,0.6
4586,10/19/2022,22.336986301369862,W,0,23.95,5,7,0.714,4,6,0.667,2,3,0.667,4,5,9,2,0,1,1,4,16,16.5,4.0,Trey Murphy III,1,1,1.0
4587,10/21/2022,22.34246575342466,W,0,19.816666666666666,3,9,0.333,2,5,0.4,0,0,,1,2,3,0,3,0,0,2,8,6.4,-11.0,Trey Murphy III,1,4,0.25
4588,10/23/2022,22.34794520547945,L,0,39.7,6,11,0.545,3,4,0.75,1,1,1.0,1,8,9,1,0,0,2,4,16,10.9,14.0,Trey Murphy III,3,7,0.42857142857142855
4589,10/25/2022,22.353424657534248,W,1,36.483333333333334,8,8,1.0,4,4,1.0,2,2,1.0,1,4,5,1,1,0,2,3,22,20.0,1.0,Trey Murphy III,4,4,1.0
4590,10/28/2022,22.361643835616437,L,1,32.6,4,9,0.444,3,7,0.429,2,2,1.0,0,5,5,1,2,0,1,3,13,10.3,3.0,Trey Murphy III,1,2,0.5
4591,10/30/2022,22.367123287671234,W,1,37.28333333333333,6,16,0.375,3,9,0.333,0,0,,4,1,5,1,1,0,1,0,15,10.0,21.0,Trey Murphy III,3,7,0.42857142857142855
4592,11/2/2022,22.375342465753423,L,1,39.71666666666667,4,9,0.444,0,5,0.0,4,4,1.0,2,3,5,3,1,0,0,2,12,11.9,0.0,Trey Murphy III,4,4,1.0
4593,11/4/2022,22.38082191780822,W,0,27.55,3,7,0.429,3,6,0.5,1,1,1.0,1,3,4,4,2,0,0,3,10,11.5,18.0,Trey Murphy III,0,1,0.0
4594,11/5/2022,22.383561643835616,L,0,17.266666666666666,0,3,0.0,0,3,0.0,2,2,1.0,0,0,0,2,0,0,1,0,2,0.3,3.0,Trey Murphy III,0,0,
4595,11/7/2022,22.389041095890413,L,0,28.183333333333334,4,7,0.571,3,6,0.5,0,0,,1,5,6,1,2,0,1,1,11,11.2,8.0,Trey Murphy III,1,1,1.0
4596,11/9/2022,22.394520547945206,W,0,20.316666666666666,0,3,0.0,0,3,0.0,2,2,1.0,1,2,3,1,0,1,0,1,2,2.2,-5.0,Trey Murphy III,0,0,
4597,11/10/2022,22.397260273972602,L,0,30.933333333333334,5,11,0.455,3,8,0.375,3,3,1.0,1,2,3,1,0,3,0,0,16,14.4,-7.0,Trey Murphy III,2,3,0.6666666666666666
4598,11/12/2022,22.4027397260274,W,0,17.666666666666668,2,7,0.286,0,5,0.0,2,2,1.0,0,1,1,0,0,0,1,1,6,0.8,-14.0,Trey Murphy III,2,2,1.0
4599,11/15/2022,22.410958904109588,W,1,25.133333333333333,5,11,0.455,3,6,0.5,0,0,,0,2,2,1,1,1,0,1,13,9.9,-5.0,Trey Murphy III,2,5,0.4
4600,11/16/2022,22.413698630136988,W,1,24.666666666666668,7,9,0.778,5,6,0.833,0,0,,1,9,10,1,3,1,1,0,19,22.3,17.0,Trey Murphy III,2,3,0.6666666666666666
4601,11/18/2022,22.41917808219178,L,1,12.0,0,1,0.0,0,1,0.0,0,0,,0,1,1,1,0,0,0,0,0,0.3,-10.0,Trey Murphy III,0,0,
4602,11/25/2022,22.438356164383563,L,0,26.1,7,14,0.5,1,6,0.167,6,7,0.857,2,1,3,1,1,0,0,4,21,15.4,-17.0,Trey Murphy III,6,8,0.75
4603,10/19/2022,25.12876712328767,W,1,31.0,10,17,0.588,2,4,0.5,6,9,0.667,0,7,7,5,1,0,4,3,28,20.3,24.0,Brandon Ingram,8,13,0.6153846153846154
4604,10/21/2022,25.134246575342466,W,1,37.483333333333334,8,16,0.5,1,1,1.0,11,11,1.0,0,9,9,7,2,1,5,0,28,25.3,23.0,Brandon Ingram,7,15,0.4666666666666667
4605,10/23/2022,25.13972602739726,L,1,10.816666666666666,4,5,0.8,1,2,0.5,1,2,0.5,0,1,1,0,1,0,1,0,10,8.0,0.0,Brandon Ingram,3,3,1.0
4606,11/4/2022,25.172602739726027,W,1,36.233333333333334,8,17,0.471,3,7,0.429,7,10,0.7,0,5,5,5,0,2,4,2,26,17.7,8.0,Brandon Ingram,5,10,0.5
4607,11/5/2022,25.175342465753424,L,1,38.25,7,23,0.304,2,4,0.5,0,0,,1,4,5,7,0,2,1,4,16,8.3,-3.0,Brandon Ingram,5,19,0.2631578947368421
4608,11/7/2022,25.18082191780822,L,1,36.766666666666666,12,24,0.5,3,4,0.75,2,2,1.0,2,4,6,2,0,2,2,2,29,19.6,-5.0,Brandon Ingram,9,20,0.45
4609,11/9/2022,25.186301369863013,W,1,33.28333333333333,8,14,0.571,1,2,0.5,5,6,0.833,1,8,9,3,1,0,4,4,22,15.6,19.0,Brandon Ingram,7,12,0.5833333333333334
4610,11/10/2022,25.18904109589041,L,1,31.333333333333332,6,12,0.5,2,4,0.5,0,0,,0,5,5,2,0,0,5,6,14,3.5,-17.0,Brandon Ingram,4,8,0.5
4611,11/12/2022,25.194520547945206,W,1,37.666666666666664,8,19,0.421,0,4,0.0,4,4,1.0,1,4,5,5,3,1,2,4,20,15.4,21.0,Brandon Ingram,8,15,0.5333333333333333
4612,11/15/2022,25.202739726027396,W,1,37.63333333333333,7,15,0.467,2,2,1.0,3,3,1.0,1,3,4,2,0,1,1,2,19,13.2,-1.0,Brandon Ingram,5,13,0.38461538461538464
4613,11/16/2022,25.205479452054796,W,1,31.783333333333335,4,15,0.267,2,4,0.5,6,8,0.75,0,6,6,9,0,1,2,2,16,12.3,19.0,Brandon Ingram,2,11,0.18181818181818182
4614,11/18/2022,25.21095890410959,L,1,38.21666666666667,9,20,0.45,5,11,0.455,2,2,1.0,0,2,2,7,2,0,2,1,25,19.7,-12.0,Brandon Ingram,4,9,0.4444444444444444
4615,11/21/2022,25.21917808219178,W,1,30.833333333333332,12,19,0.632,3,7,0.429,7,7,1.0,1,5,6,3,3,0,2,1,34,30.4,33.0,Brandon Ingram,9,12,0.75
4616,11/23/2022,25.224657534246575,W,1,31.866666666666667,4,9,0.444,1,3,0.333,8,8,1.0,0,3,3,10,0,0,5,2,17,14.4,13.0,Brandon Ingram,3,6,0.5
4617,11/25/2022,25.23013698630137,L,1,17.833333333333332,2,6,0.333,0,1,0.0,4,4,1.0,0,3,3,3,0,0,2,0,8,5.6,-11.0,Brandon Ingram,2,5,0.4
4618,10/19/2022,24.035616438356165,W,1,27.966666666666665,2,7,0.286,1,3,0.333,1,1,1.0,3,1,4,3,0,1,0,3,6,5.9,34.0,Herbert Jones,1,4,0.25
4619,10/21/2022,24.041095890410958,W,1,31.983333333333334,2,3,0.667,0,0,,3,3,1.0,1,1,2,2,0,2,0,4,7,7.9,16.0,Herbert Jones,2,3,0.6666666666666666
4620,10/23/2022,24.046575342465754,L,1,35.45,3,9,0.333,0,3,0.0,3,5,0.6,1,3,4,1,0,1,3,6,9,0.7,-1.0,Herbert Jones,3,6,0.5
4621,11/4/2022,24.07945205479452,W,1,29.383333333333333,1,5,0.2,0,2,0.0,2,2,1.0,0,1,1,2,3,0,2,4,4,2.0,-6.0,Herbert Jones,1,3,0.3333333333333333
4622,11/5/2022,24.08219178082192,L,1,33.7,7,13,0.538,0,2,0.0,5,9,0.556,4,5,9,2,3,0,0,5,19,17.8,-6.0,Herbert Jones,7,11,0.6363636363636364
4623,11/7/2022,24.087671232876712,L,1,28.566666666666666,7,12,0.583,1,3,0.333,1,1,1.0,0,2,2,2,1,1,2,2,16,11.3,-6.0,Herbert Jones,6,9,0.6666666666666666
4624,11/9/2022,24.09315068493151,W,1,27.916666666666668,5,9,0.556,0,2,0.0,7,8,0.875,1,3,4,3,3,0,1,4,17,16.4,10.0,Herbert Jones,5,7,0.7142857142857143
4625,11/10/2022,24.095890410958905,L,1,34.25,3,6,0.5,0,0,,4,4,1.0,1,2,3,2,0,0,1,2,10,7.9,-16.0,Herbert Jones,3,6,0.5
4626,11/12/2022,24.101369863013698,W,1,19.45,3,7,0.429,0,3,0.0,0,0,,1,2,3,1,0,0,0,3,6,3.1,15.0,Herbert Jones,3,4,0.75
4627,11/15/2022,24.10958904109589,W,1,22.55,4,7,0.571,2,3,0.667,0,1,0.0,1,2,3,2,0,1,0,4,10,8.1,3.0,Herbert Jones,2,4,0.5
4628,11/16/2022,24.112328767123287,W,1,31.6,3,7,0.429,2,2,1.0,2,3,0.667,3,1,4,3,1,0,1,4,10,8.8,21.0,Herbert Jones,1,5,0.2
4629,11/18/2022,24.117808219178084,L,1,35.56666666666667,7,12,0.583,2,4,0.5,1,2,0.5,1,6,7,2,3,0,2,3,17,14.7,-9.0,Herbert Jones,5,8,0.625
4630,11/21/2022,24.126027397260273,W,1,19.766666666666666,1,6,0.167,0,4,0.0,1,2,0.5,0,3,3,2,1,3,2,3,3,1.0,18.0,Herbert Jones,1,2,0.5
4631,11/23/2022,24.13150684931507,W,1,18.833333333333332,3,7,0.429,1,4,0.25,2,2,1.0,0,2,2,1,0,1,0,3,9,6.1,15.0,Herbert Jones,2,3,0.6666666666666666
4632,11/25/2022,24.136986301369863,L,1,22.616666666666667,4,11,0.364,2,4,0.5,3,4,0.75,2,3,5,3,1,1,1,2,13,10.8,-21.0,Herbert Jones,2,7,0.2857142857142857
4633,10/19/2022,22.28767123287671,W,1,30.05,11,22,0.5,0,0,,3,4,0.75,3,6,9,3,4,0,2,3,25,20.4,13.0,Zion Williamson,11,22,0.5
4634,10/21/2022,22.293150684931508,W,1,30.716666666666665,7,19,0.368,0,0,,2,4,0.5,2,3,5,3,1,0,3,0,16,7.1,13.0,Zion Williamson,7,19,0.3684210526315789
4635,10/23/2022,22.2986301369863,L,1,29.883333333333333,10,16,0.625,0,0,,5,6,0.833,2,4,6,1,1,2,4,3,25,17.9,-7.0,Zion Williamson,10,16,0.625
4636,10/30/2022,22.317808219178083,W,1,30.533333333333335,9,17,0.529,0,0,,3,4,0.75,3,9,12,7,1,0,1,1,21,21.6,19.0,Zion Williamson,9,17,0.5294117647058824
4637,11/2/2022,22.326027397260273,L,1,36.6,11,21,0.524,0,1,0.0,5,8,0.625,2,3,5,7,0,0,3,5,27,17.7,-13.0,Zion Williamson,11,20,0.55
4638,11/4/2022,22.33150684931507,W,1,27.916666666666668,7,11,0.636,0,0,,2,4,0.5,0,3,3,1,1,0,2,2,16,10.1,9.0,Zion Williamson,7,11,0.6363636363636364
4639,11/5/2022,22.334246575342465,L,1,37.266666666666666,11,20,0.55,0,1,0.0,7,10,0.7,2,6,8,4,0,0,7,2,29,16.4,-4.0,Zion Williamson,11,19,0.5789473684210527
4640,11/7/2022,22.339726027397262,L,1,33.983333333333334,10,15,0.667,2,3,0.667,4,6,0.667,3,4,7,7,2,1,1,4,26,27.0,-9.0,Zion Williamson,8,12,0.6666666666666666
4641,11/9/2022,22.345205479452055,W,1,30.833333333333332,6,11,0.545,0,0,,7,8,0.875,4,1,5,1,0,0,1,3,19,14.9,3.0,Zion Williamson,6,11,0.5454545454545454
4642,11/10/2022,22.34794520547945,L,1,31.666666666666668,9,14,0.643,1,1,1.0,10,15,0.667,1,5,6,3,1,0,3,4,29,21.5,-12.0,Zion Williamson,8,13,0.6153846153846154
4643,11/12/2022,22.353424657534248,W,1,35.03333333333333,8,9,0.889,0,0,,10,12,0.833,1,3,4,6,1,0,3,3,26,24.7,21.0,Zion Williamson,8,9,0.8888888888888888
4644,11/21/2022,22.378082191780823,W,1,23.1,3,7,0.429,0,0,,3,4,0.75,0,2,2,4,0,0,2,1,9,5.9,28.0,Zion Williamson,3,7,0.42857142857142855
4645,11/23/2022,22.383561643835616,W,1,26.65,14,18,0.778,0,2,0.0,4,8,0.5,4,7,11,1,2,1,1,1,32,30.3,20.0,Zion Williamson,14,16,0.875
4646,11/25/2022,22.389041095890413,L,1,30.0,6,12,0.5,0,0,,2,2,1.0,1,4,5,4,1,0,1,3,14,11.5,-32.0,Zion Williamson,6,12,0.5
4647,10/19/2022,19.59178082191781,W,0,3.2,0,1,0.0,0,0,,0,0,,0,0,0,2,0,0,0,1,0,0.3,-2.0,Dyson Daniels,0,1,0.0
4648,10/25/2022,19.60821917808219,W,0,22.116666666666667,4,5,0.8,1,1,1.0,2,2,1.0,1,2,3,2,3,1,1,3,11,13.3,-18.0,Dyson Daniels,3,4,0.75
4649,11/2/2022,19.63013698630137,L,0,16.1,3,5,0.6,2,3,0.667,0,2,0.0,1,4,5,2,0,1,1,0,8,7.9,5.0,Dyson Daniels,1,2,0.5
4650,11/5/2022,19.638356164383563,L,0,5.133333333333334,0,1,0.0,0,1,0.0,0,0,,1,2,3,0,0,0,1,0,0,-0.4,-3.0,Dyson Daniels,0,0,
4651,11/12/2022,19.65753424657534,W,0,0.18333333333333332,0,0,,0,0,,2,2,1.0,0,0,0,0,0,0,0,0,2,2.0,0.0,Dyson Daniels,0,0,
4652,11/15/2022,19.665753424657535,W,0,17.216666666666665,1,4,0.25,1,3,0.333,0,0,,1,8,9,1,1,1,0,1,3,5.7,13.0,Dyson Daniels,0,1,0.0
4653,11/16/2022,19.66849315068493,W,0,18.983333333333334,2,3,0.667,0,0,,0,0,,1,3,4,2,0,1,0,5,4,4.4,-4.0,Dyson Daniels,2,3,0.6666666666666666
4654,11/18/2022,19.673972602739727,L,0,17.883333333333333,0,2,0.0,0,0,,1,2,0.5,0,3,3,0,0,0,0,0,1,0.1,1.0,Dyson Daniels,0,2,0.0
4655,11/21/2022,19.682191780821917,W,0,20.4,4,7,0.571,1,3,0.333,0,0,,0,5,5,2,2,0,0,5,9,8.6,14.0,Dyson Daniels,3,4,0.75
4656,11/23/2022,19.687671232876713,W,0,22.2,2,5,0.4,0,2,0.0,1,2,0.5,0,1,1,2,1,1,2,5,5,1.3,3.0,Dyson Daniels,2,3,0.6666666666666666
4657,11/25/2022,19.693150684931506,L,0,24.966666666666665,3,5,0.6,1,1,1.0,2,2,1.0,0,5,5,6,0,0,3,2,9,8.6,18.0,Dyson Daniels,2,4,0.5
4658,10/23/2022,22.41917808219178,L,0,2.85,0,1,0.0,0,1,0.0,0,0,,0,0,0,0,0,0,0,1,0,-1.1,-8.0,Jaxson Hayes,0,0,
4659,10/25/2022,22.424657534246574,W,0,13.416666666666666,0,1,0.0,0,1,0.0,0,2,0.0,0,2,2,1,0,0,1,1,0,-1.6,-8.0,Jaxson Hayes,0,0,
4660,10/28/2022,22.432876712328767,L,0,7.933333333333334,0,0,,0,0,,0,0,,0,1,1,1,0,0,0,0,0,1.0,-5.0,Jaxson Hayes,0,0,
4661,10/30/2022,22.438356164383563,W,0,8.433333333333334,1,1,1.0,0,0,,0,0,,0,1,1,1,1,1,0,2,2,3.6,3.0,Jaxson Hayes,1,1,1.0
4662,11/2/2022,22.446575342465753,L,0,4.366666666666666,0,2,0.0,0,0,,0,0,,1,0,1,0,0,0,0,1,0,-1.1,-3.0,Jaxson Hayes,0,2,0.0
4663,11/21/2022,22.4986301369863,W,0,7.366666666666666,1,2,0.5,0,1,0.0,0,0,,2,1,3,0,1,0,1,0,2,2.7,4.0,Jaxson Hayes,1,1,1.0
4664,11/23/2022,22.504109589041096,W,0,5.35,0,2,0.0,0,1,0.0,1,2,0.5,0,3,3,0,0,0,1,1,1,-1.3,-4.0,Jaxson Hayes,0,1,0.0
4665,11/25/2022,22.50958904109589,L,0,12.0,1,5,0.2,0,3,0.0,3,3,1.0,0,3,3,2,1,0,0,0,5,5.2,8.0,Jaxson Hayes,1,2,0.5
4666,10/21/2022,28.4027397260274,W,0,5.883333333333333,1,3,0.333,0,0,,0,0,,2,3,5,0,0,0,0,1,2,2.2,-3.0,Willy Hernangómez,1,3,0.3333333333333333
4667,10/28/2022,28.421917808219177,L,0,8.083333333333334,0,2,0.0,0,1,0.0,2,2,1.0,2,2,4,1,0,0,1,1,2,1.9,-2.0,Willy Hernangómez,0,1,0.0
4668,11/9/2022,28.454794520547946,W,0,11.583333333333334,4,6,0.667,0,1,0.0,0,0,,0,3,3,0,1,0,4,1,8,2.9,-14.0,Willy Hernangómez,4,5,0.8
4669,11/16/2022,28.473972602739725,W,0,1.9,0,1,0.0,0,0,,0,0,,0,0,0,0,0,0,0,0,0,-0.7,-3.0,Willy Hernangómez,0,1,0.0
4670,11/21/2022,28.487671232876714,W,0,7.366666666666666,2,3,0.667,0,1,0.0,1,2,0.5,1,1,2,0,0,0,1,0,5,3.3,4.0,Willy Hernangómez,2,2,1.0
4671,11/23/2022,28.493150684931507,W,0,5.35,1,2,0.5,0,0,,1,2,0.5,1,0,1,0,0,0,0,1,3,1.9,-4.0,Willy Hernangómez,1,2,0.5
4672,11/25/2022,28.4986301369863,L,0,12.0,2,4,0.5,0,0,,2,2,1.0,3,2,5,0,1,0,0,1,6,7.3,8.0,Willy Hernangómez,2,4,0.5
4673,10/28/2022,36.47397260273973,L,0,17.066666666666666,2,3,0.667,2,3,0.667,0,0,,0,1,1,1,1,0,0,1,6,6.3,-17.0,Garrett Temple,0,0,
4674,10/30/2022,36.47945205479452,W,0,3.5666666666666664,0,1,0.0,0,1,0.0,0,0,,0,0,0,0,0,0,0,1,0,-1.1,-3.0,Garrett Temple,0,0,
4675,11/21/2022,36.53972602739726,W,0,7.366666666666666,1,4,0.25,0,2,0.0,0,0,,0,0,0,1,1,0,0,0,2,1.3,4.0,Garrett Temple,1,2,0.5
4676,11/23/2022,36.54520547945206,W,0,5.35,1,2,0.5,1,2,0.5,0,0,,0,1,1,1,1,0,1,1,3,2.6,-4.0,Garrett Temple,0,0,
4677,11/25/2022,36.55068493150685,L,0,12.0,2,4,0.5,1,2,0.5,1,2,0.5,0,0,0,0,2,1,0,2,6,5.5,8.0,Garrett Temple,1,2,0.5
4678,10/28/2022,22.424657534246574,L,0,1.9666666666666668,0,0,,0,0,,0,0,,0,0,0,0,0,0,0,0,0,0.0,1.0,Dereon Seabron,0,0,
4679,10/30/2022,22.43013698630137,W,0,0.5333333333333333,0,0,,0,0,,0,0,,0,0,0,0,0,0,0,0,0,0.0,-2.0,Dereon Seabron,0,0,
4680,10/19/2022,29.536986301369865,L,1,27.516666666666666,6,11,0.545,3,5,0.6,0,2,0.0,0,3,3,3,0,0,0,4,15,10.3,2.0,Spencer Dinwiddie,3,6,0.5
4681,10/22/2022,29.545205479452054,W,1,28.366666666666667,6,13,0.462,3,5,0.6,0,0,,0,2,2,2,0,0,3,2,15,6.5,23.0,Spencer Dinwiddie,3,8,0.375
4682,10/25/2022,29.553424657534247,L,1,37.983333333333334,8,15,0.533,4,8,0.5,4,5,0.8,0,2,2,5,0,0,2,2,24,17.6,-15.0,Spencer Dinwiddie,4,7,0.5714285714285714
4683,10/27/2022,29.55890410958904,W,1,27.633333333333333,4,8,0.5,3,5,0.6,0,0,,0,3,3,5,1,0,2,3,11,9.2,-20.0,Spencer Dinwiddie,1,3,0.3333333333333333
4684,10/29/2022,29.564383561643837,L,1,35.45,8,13,0.615,2,6,0.333,2,3,0.667,0,2,2,2,1,0,2,3,20,13.5,2.0,Spencer Dinwiddie,6,7,0.8571428571428571
4685,10/30/2022,29.567123287671233,W,1,31.516666666666666,5,13,0.385,0,4,0.0,2,2,1.0,0,4,4,5,3,0,1,3,12,10.4,-9.0,Spencer Dinwiddie,5,9,0.5555555555555556
4686,11/2/2022,29.575342465753426,W,1,35.166666666666664,8,20,0.4,4,11,0.364,0,0,,1,3,4,5,4,0,1,1,20,16.9,9.0,Spencer Dinwiddie,4,9,0.4444444444444444
4687,11/4/2022,29.58082191780822,W,1,37.983333333333334,8,17,0.471,3,8,0.375,2,2,1.0,0,1,1,7,2,0,2,4,21,15.9,0.0,Spencer Dinwiddie,5,9,0.5555555555555556
4688,11/7/2022,29.589041095890412,W,1,27.883333333333333,1,8,0.125,0,3,0.0,0,0,,2,4,6,5,0,0,4,3,2,-2.3,-3.0,Spencer Dinwiddie,1,5,0.2
4689,11/9/2022,29.594520547945205,L,1,37.5,9,19,0.474,4,10,0.4,7,8,0.875,0,4,4,5,2,1,1,2,29,24.5,-5.0,Spencer Dinwiddie,5,9,0.5555555555555556
4690,11/10/2022,29.5972602739726,L,1,37.55,11,17,0.647,7,12,0.583,4,4,1.0,0,4,4,6,1,0,1,2,33,30.1,3.0,Spencer Dinwiddie,4,5,0.8
4691,11/12/2022,29.602739726027398,W,1,32.5,7,11,0.636,6,8,0.75,0,0,,0,7,7,6,0,1,2,1,20,19.7,0.0,Spencer Dinwiddie,1,3,0.3333333333333333
4692,11/15/2022,29.610958904109587,W,1,40.983333333333334,6,15,0.4,2,8,0.25,2,3,0.667,1,2,3,6,2,0,2,2,16,12.2,-7.0,Spencer Dinwiddie,4,7,0.5714285714285714
4693,11/16/2022,29.613698630136987,L,1,32.416666666666664,3,18,0.167,1,9,0.111,2,2,1.0,1,1,2,10,2,0,0,0,9,7.6,-10.0,Spencer Dinwiddie,2,9,0.2222222222222222
4694,11/18/2022,29.61917808219178,W,1,26.166666666666668,5,6,0.833,3,3,1.0,2,2,1.0,0,2,2,1,1,0,0,1,15,14.7,13.0,Spencer Dinwiddie,2,3,0.6666666666666666
4695,11/20/2022,29.624657534246577,L,1,29.6,5,15,0.333,1,8,0.125,0,0,,0,1,1,8,0,1,4,2,11,4.3,-14.0,Spencer Dinwiddie,4,7,0.5714285714285714
4696,11/23/2022,29.632876712328766,L,1,31.616666666666667,6,8,0.75,2,4,0.5,1,2,0.5,0,4,4,4,1,0,0,2,15,15.6,-23.0,Spencer Dinwiddie,4,4,1.0
4697,11/26/2022,29.64109589041096,L,1,28.333333333333332,6,11,0.545,3,8,0.375,0,0,,0,2,2,7,0,0,3,5,15,10.2,5.0,Spencer Dinwiddie,3,3,1.0
4698,11/27/2022,29.643835616438356,L,1,31.166666666666668,8,13,0.615,3,6,0.5,3,3,1.0,0,3,3,2,0,0,1,2,22,16.6,-16.0,Spencer Dinwiddie,5,7,0.7142857142857143
4699,10/19/2022,29.46027397260274,L,1,38.2,2,4,0.5,1,2,0.5,0,0,,0,3,3,0,2,0,0,4,5,4.3,-10.0,Dorian Finney-Smith,1,2,0.5
4700,10/22/2022,29.46849315068493,W,1,27.116666666666667,3,6,0.5,1,4,0.25,0,1,0.0,3,2,5,1,1,1,1,2,7,6.9,28.0,Dorian Finney-Smith,2,2,1.0
4701,10/25/2022,29.476712328767125,L,1,34.71666666666667,2,5,0.4,0,2,0.0,0,0,,2,2,4,2,0,1,1,2,4,3.6,-4.0,Dorian Finney-Smith,2,3,0.6666666666666666
4702,10/27/2022,29.482191780821918,W,1,39.63333333333333,2,7,0.286,1,6,0.167,1,2,0.5,1,2,3,1,0,0,1,4,6,0.9,0.0,Dorian Finney-Smith,1,1,1.0
4703,10/29/2022,29.487671232876714,L,1,35.0,5,15,0.333,3,9,0.333,0,0,,4,1,5,1,0,2,1,4,13,7.1,-7.0,Dorian Finney-Smith,2,6,0.3333333333333333
4704,10/30/2022,29.49041095890411,W,1,29.166666666666668,5,7,0.714,3,5,0.6,0,0,,1,7,8,0,2,0,0,3,13,13.7,-1.0,Dorian Finney-Smith,2,2,1.0
4705,11/2/2022,29.4986301369863,W,1,26.1,2,6,0.333,0,3,0.0,0,0,,0,2,2,0,1,1,0,0,4,2.9,0.0,Dorian Finney-Smith,2,3,0.6666666666666666
4706,11/4/2022,29.504109589041096,W,1,30.7,4,7,0.571,2,5,0.4,1,2,0.5,2,2,4,0,1,0,3,1,11,6.9,-2.0,Dorian Finney-Smith,2,2,1.0
4707,11/7/2022,29.512328767123286,W,1,35.016666666666666,5,9,0.556,2,5,0.4,6,6,1.0,1,2,3,1,1,0,4,1,18,12.3,-7.0,Dorian Finney-Smith,3,4,0.75
4708,11/9/2022,29.517808219178082,L,1,30.716666666666665,3,6,0.5,2,5,0.4,0,0,,0,1,1,1,1,1,1,0,8,6.7,-4.0,Dorian Finney-Smith,1,1,1.0
4709,11/10/2022,29.52054794520548,L,1,29.55,2,6,0.333,1,3,0.333,0,0,,0,5,5,1,1,0,2,3,5,1.6,4.0,Dorian Finney-Smith,1,3,0.3333333333333333
4710,11/12/2022,29.526027397260275,W,1,33.75,2,7,0.286,2,6,0.333,0,0,,0,5,5,1,0,0,1,2,6,2.3,-4.0,Dorian Finney-Smith,0,1,0.0
4711,11/15/2022,29.534246575342465,W,1,36.416666666666664,7,15,0.467,7,13,0.538,0,0,,1,2,3,0,3,0,0,2,21,16.8,4.0,Dorian Finney-Smith,0,2,0.0
4712,11/16/2022,29.536986301369865,L,1,38.45,3,11,0.273,1,8,0.125,0,0,,2,6,8,0,0,1,0,2,7,3.6,-4.0,Dorian Finney-Smith,2,3,0.6666666666666666
4713,11/18/2022,29.542465753424658,W,1,30.483333333333334,2,6,0.333,1,4,0.25,1,2,0.5,2,2,4,2,1,0,0,0,6,6.6,16.0,Dorian Finney-Smith,1,2,0.5
4714,11/20/2022,29.54794520547945,L,1,35.6,1,5,0.2,1,4,0.25,0,0,,0,3,3,1,1,1,0,1,3,2.8,-3.0,Dorian Finney-Smith,0,1,0.0
4715,11/23/2022,29.556164383561644,L,1,36.93333333333333,4,9,0.444,2,5,0.4,0,0,,0,3,3,1,1,2,2,3,10,6.1,-15.0,Dorian Finney-Smith,2,4,0.5
4716,11/26/2022,29.564383561643837,L,1,31.633333333333333,5,12,0.417,3,9,0.333,3,3,1.0,1,3,4,2,2,1,2,0,16,13.3,8.0,Dorian Finney-Smith,2,3,0.6666666666666666
4717,11/27/2022,29.567123287671233,L,1,38.03333333333333,5,9,0.556,2,6,0.333,1,1,1.0,4,0,4,3,3,0,0,2,13,15.8,-15.0,Dorian Finney-Smith,3,3,1.0
4718,10/19/2022,21.923287671232877,L,0,17.95,0,0,,0,0,,1,2,0.5,2,2,4,2,1,1,1,2,1,3.9,18.0,Josh Green,0,0,
4719,10/22/2022,21.931506849315067,W,0,15.45,1,1,1.0,1,1,1.0,2,2,1.0,0,0,0,1,0,0,1,5,5,2.4,10.0,Josh Green,0,0,
4720,10/25/2022,21.93972602739726,L,0,13.616666666666667,1,2,0.5,0,1,0.0,0,0,,0,2,2,0,0,0,0,1,2,1.2,4.0,Josh Green,1,1,1.0
4721,10/27/2022,21.945205479452056,W,0,13.35,3,3,1.0,3,3,1.0,1,2,0.5,1,3,4,1,1,0,1,2,10,10.2,3.0,Josh Green,0,0,
4722,10/29/2022,21.95068493150685,L,0,15.15,2,5,0.4,0,2,0.0,2,2,1.0,2,3,5,1,4,0,2,0,6,8.3,24.0,Josh Green,2,3,0.6666666666666666
4723,10/30/2022,21.953424657534246,W,0,17.133333333333333,2,3,0.667,1,2,0.5,1,2,0.5,1,1,2,0,1,0,1,1,6,4.9,1.0,Josh Green,1,1,1.0
4724,11/2/2022,21.96164383561644,W,0,18.75,2,3,0.667,2,3,0.667,0,2,0.0,1,0,1,0,0,0,0,2,6,3.8,8.0,Josh Green,0,0,
4725,11/4/2022,21.96712328767123,W,0,20.1,3,3,1.0,1,1,1.0,0,0,,1,1,2,0,1,0,0,3,7,6.9,1.0,Josh Green,2,2,1.0
4726,11/7/2022,21.975342465753425,W,0,26.8,5,5,1.0,2,2,1.0,4,4,1.0,1,4,5,2,0,0,2,2,16,15.0,11.0,Josh Green,3,3,1.0
4727,11/9/2022,21.980821917808218,L,0,25.183333333333334,3,6,0.5,0,2,0.0,0,2,0.0,0,0,0,3,2,0,0,2,6,5.5,-9.0,Josh Green,3,4,0.75
4728,11/10/2022,21.983561643835618,L,0,19.033333333333335,1,4,0.25,0,1,0.0,2,2,1.0,1,0,1,0,2,0,1,0,4,3.3,-15.0,Josh Green,1,3,0.3333333333333333
4729,11/12/2022,21.98904109589041,W,0,23.7,2,5,0.4,1,4,0.25,1,2,0.5,1,0,1,1,1,0,0,4,6,3.7,4.0,Josh Green,1,1,1.0
4730,11/15/2022,21.997260273972604,W,0,13.666666666666666,0,1,0.0,0,1,0.0,0,2,0.0,0,1,1,0,0,0,0,1,0,-1.6,-3.0,Josh Green,0,0,
4731,11/16/2022,22.0,L,1,16.533333333333335,0,2,0.0,0,1,0.0,4,4,1.0,3,2,5,0,2,0,1,3,4,5.1,-11.0,Josh Green,0,1,0.0
4732,11/18/2022,22.005479452054793,W,0,17.7,2,3,0.667,0,1,0.0,1,1,1.0,1,0,1,3,0,0,0,4,5,4.9,21.0,Josh Green,2,2,1.0
4733,11/20/2022,22.01095890410959,L,0,30.066666666666666,8,9,0.889,6,7,0.857,1,2,0.5,0,2,2,0,0,0,1,3,23,17.9,13.0,Josh Green,2,2,1.0
4734,11/23/2022,22.019178082191782,L,0,22.166666666666668,1,4,0.25,1,2,0.5,0,0,,1,0,1,0,1,0,0,4,3,0.7,11.0,Josh Green,0,2,0.0
4735,11/26/2022,22.027397260273972,L,0,17.133333333333333,2,6,0.333,0,3,0.0,2,2,1.0,0,1,1,2,0,0,1,6,6,0.9,-15.0,Josh Green,2,3,0.6666666666666666
4736,11/27/2022,22.03013698630137,L,0,19.966666666666665,2,3,0.667,1,2,0.5,3,4,0.75,0,4,4,0,1,0,1,2,8,6.7,5.0,Josh Green,1,1,1.0
4737,10/19/2022,23.638356164383563,L,1,36.666666666666664,10,23,0.435,2,10,0.2,13,13,1.0,0,9,9,6,1,0,4,3,35,25.6,-16.0,Luka Dončić,8,13,0.6153846153846154
4738,10/22/2022,23.646575342465752,W,1,29.966666666666665,12,23,0.522,4,9,0.444,4,5,0.8,2,5,7,10,2,2,3,2,32,29.8,31.0,Luka Dončić,8,14,0.5714285714285714
4739,10/25/2022,23.654794520547945,L,1,36.31666666666667,16,30,0.533,2,13,0.154,3,5,0.6,3,8,11,7,2,1,3,3,37,29.5,6.0,Luka Dončić,14,17,0.8235294117647058
4740,10/27/2022,23.660273972602738,W,1,40.5,14,28,0.5,2,6,0.333,11,13,0.846,1,10,11,14,3,0,5,2,41,36.9,20.0,Luka Dončić,12,22,0.5454545454545454
4741,10/29/2022,23.665753424657535,L,1,40.0,8,23,0.348,0,6,0.0,15,19,0.789,2,14,16,10,1,0,3,6,31,24.7,-25.0,Luka Dončić,8,17,0.47058823529411764
4742,10/30/2022,23.66849315068493,W,1,36.916666666666664,17,26,0.654,2,9,0.222,8,14,0.571,0,3,3,5,1,0,0,3,44,34.4,13.0,Luka Dončić,15,17,0.8823529411764706
4743,11/2/2022,23.676712328767124,W,1,35.46666666666667,12,20,0.6,2,6,0.333,7,10,0.7,0,5,5,11,2,0,5,3,33,27.6,-3.0,Luka Dončić,10,14,0.7142857142857143
4744,11/4/2022,23.682191780821917,W,1,36.55,10,15,0.667,3,6,0.5,12,14,0.857,1,7,8,6,3,1,4,4,35,32.8,8.0,Luka Dončić,7,9,0.7777777777777778
4745,11/7/2022,23.69041095890411,W,1,38.416666666666664,11,22,0.5,5,9,0.556,9,12,0.75,0,6,6,6,2,1,5,5,36,25.5,1.0,Luka Dončić,6,13,0.46153846153846156
4746,11/9/2022,23.695890410958903,L,1,35.416666666666664,9,29,0.31,2,11,0.182,4,7,0.571,0,6,6,6,3,2,0,3,24,15.3,-3.0,Luka Dončić,7,18,0.3888888888888889
4747,11/10/2022,23.698630136986303,L,1,39.166666666666664,8,21,0.381,3,8,0.375,3,9,0.333,0,9,9,6,2,0,5,2,22,11.2,-6.0,Luka Dončić,5,13,0.38461538461538464
4748,11/12/2022,23.704109589041096,W,1,37.68333333333333,13,22,0.591,1,5,0.2,15,18,0.833,3,10,13,10,2,1,2,3,42,42.2,6.0,Luka Dončić,12,17,0.7058823529411765
4749,11/15/2022,23.71232876712329,W,1,39.71666666666667,11,22,0.5,2,5,0.4,11,11,1.0,2,9,11,5,3,0,3,3,35,30.4,4.0,Luka Dončić,9,17,0.5294117647058824
4750,11/18/2022,23.720547945205478,W,1,34.86666666666667,11,22,0.5,2,7,0.286,9,11,0.818,1,11,12,11,1,0,2,1,33,31.5,25.0,Luka Dončić,9,15,0.6
4751,11/20/2022,23.726027397260275,L,1,35.65,7,16,0.438,2,8,0.25,6,10,0.6,0,9,9,8,1,0,4,2,22,16.5,1.0,Luka Dončić,5,8,0.625
4752,11/23/2022,23.734246575342464,L,1,39.6,17,28,0.607,3,8,0.375,5,9,0.556,1,7,8,9,0,0,5,4,42,30.1,-13.0,Luka Dončić,14,20,0.7
4753,11/26/2022,23.742465753424657,L,1,42.71666666666667,8,15,0.533,2,4,0.5,6,9,0.667,0,7,7,9,2,1,4,2,24,21.8,2.0,Luka Dončić,6,11,0.5454545454545454
4754,11/27/2022,23.745205479452054,L,1,35.083333333333336,10,20,0.5,3,7,0.429,4,9,0.444,0,5,5,12,0,0,6,2,27,18.1,-10.0,Luka Dončić,7,13,0.5384615384615384
4755,10/19/2022,30.594520547945205,L,0,25.016666666666666,3,10,0.3,1,5,0.2,2,2,1.0,0,2,2,1,1,0,2,1,9,3.1,-2.0,Tim Hardaway Jr.,2,5,0.4
4756,10/22/2022,30.602739726027398,W,0,25.883333333333333,3,10,0.3,2,6,0.333,8,8,1.0,0,2,2,2,0,0,0,1,16,11.8,23.0,Tim Hardaway Jr.,1,4,0.25
4757,10/27/2022,30.616438356164384,W,0,30.283333333333335,6,13,0.462,4,8,0.5,2,2,1.0,0,2,2,1,0,2,1,1,18,12.6,-1.0,Tim Hardaway Jr.,2,5,0.4
4758,10/29/2022,30.621917808219177,L,0,22.183333333333334,2,7,0.286,1,3,0.333,3,4,0.75,0,2,2,1,1,0,2,3,8,2.6,3.0,Tim Hardaway Jr.,1,4,0.25
4759,10/30/2022,30.624657534246577,W,0,27.116666666666667,5,15,0.333,3,9,0.333,8,8,1.0,0,1,1,3,1,0,0,2,21,15.1,9.0,Tim Hardaway Jr.,2,6,0.3333333333333333
4760,11/2/2022,30.632876712328766,W,0,20.75,1,9,0.111,1,6,0.167,0,0,,0,1,1,2,0,0,1,2,3,-3.0,-2.0,Tim Hardaway Jr.,0,3,0.0
4761,11/4/2022,30.638356164383563,W,0,19.1,2,8,0.25,2,6,0.333,0,0,,0,2,2,3,1,0,2,2,6,2.1,-6.0,Tim Hardaway Jr.,0,2,0.0
4762,11/7/2022,30.646575342465752,W,0,13.8,4,8,0.5,2,4,0.5,1,2,0.5,0,1,1,1,0,0,0,0,11,7.6,6.0,Tim Hardaway Jr.,2,4,0.5
4763,11/9/2022,30.65205479452055,L,0,22.183333333333334,2,10,0.2,1,7,0.143,0,0,,0,2,2,2,2,0,0,0,5,2.8,-3.0,Tim Hardaway Jr.,1,3,0.3333333333333333
4764,11/10/2022,30.654794520547945,L,0,28.1,5,12,0.417,5,11,0.455,1,2,0.5,1,1,2,1,0,0,0,0,16,10.9,-7.0,Tim Hardaway Jr.,0,1,0.0
4765,11/12/2022,30.660273972602738,W,0,31.3,6,13,0.462,3,10,0.3,1,1,1.0,0,3,3,5,1,0,3,2,16,10.9,23.0,Tim Hardaway Jr.,3,3,1.0
4766,11/15/2022,30.66849315068493,W,0,22.466666666666665,0,7,0.0,0,5,0.0,0,0,,1,2,3,3,3,0,2,2,0,-1.3,-11.0,Tim Hardaway Jr.,0,2,0.0
4767,11/16/2022,30.671232876712327,L,0,33.71666666666667,10,26,0.385,5,14,0.357,3,3,1.0,0,4,4,3,0,0,1,0,28,16.1,-8.0,Tim Hardaway Jr.,5,12,0.4166666666666667
4768,11/18/2022,30.676712328767124,W,0,24.283333333333335,3,6,0.5,3,6,0.5,4,4,1.0,0,4,4,4,1,1,1,2,13,13.9,18.0,Tim Hardaway Jr.,0,0,
4769,11/20/2022,30.682191780821917,L,0,20.683333333333334,0,9,0.0,0,5,0.0,2,2,1.0,1,2,3,2,1,0,1,1,2,-2.0,8.0,Tim Hardaway Jr.,0,4,0.0
4770,11/23/2022,30.69041095890411,L,0,22.216666666666665,1,7,0.143,0,5,0.0,0,0,,0,1,1,2,1,0,0,0,2,0.2,6.0,Tim Hardaway Jr.,1,2,0.5
4771,11/26/2022,30.698630136986303,L,0,17.016666666666666,2,5,0.4,0,3,0.0,0,0,,0,2,2,0,0,0,1,1,4,0.5,-16.0,Tim Hardaway Jr.,2,2,1.0
4772,11/27/2022,30.7013698630137,L,1,20.966666666666665,2,8,0.25,2,6,0.333,0,0,,0,0,0,0,0,0,1,0,6,0.2,-14.0,Tim Hardaway Jr.,0,2,0.0
4773,10/19/2022,31.594520547945205,L,1,29.883333333333333,3,6,0.5,3,5,0.6,1,1,1.0,0,2,2,1,0,0,2,3,10,5.1,-11.0,Reggie Bullock,0,1,0.0
4774,10/22/2022,31.602739726027398,W,1,24.066666666666666,3,5,0.6,2,4,0.5,0,0,,0,3,3,0,1,0,0,2,8,6.8,28.0,Reggie Bullock,1,1,1.0
4775,10/25/2022,31.610958904109587,L,1,35.05,1,8,0.125,1,6,0.167,0,0,,1,4,5,2,2,0,0,4,3,1.5,-2.0,Reggie Bullock,0,2,0.0
4776,10/27/2022,31.616438356164384,W,1,41.6,3,7,0.429,2,6,0.333,1,2,0.5,0,4,4,1,2,1,0,3,9,8.3,7.0,Reggie Bullock,1,1,1.0
4777,10/29/2022,31.621917808219177,L,1,37.81666666666667,2,5,0.4,2,5,0.4,1,1,1.0,2,2,4,1,0,0,2,4,7,3.4,-20.0,Reggie Bullock,0,0,
4778,10/30/2022,31.624657534246577,W,1,28.85,2,5,0.4,2,3,0.667,0,0,,0,0,0,0,1,0,0,3,6,3.1,10.0,Reggie Bullock,0,2,0.0
4779,11/2/2022,31.632876712328766,W,1,28.983333333333334,1,4,0.25,1,4,0.25,0,1,0.0,1,1,2,1,0,0,1,2,3,0.1,-4.0,Reggie Bullock,0,0,
4780,11/4/2022,31.638356164383563,W,1,25.35,1,7,0.143,0,5,0.0,0,0,,1,3,4,2,3,1,2,3,2,1.0,12.0,Reggie Bullock,1,2,0.5
4781,11/7/2022,31.646575342465752,W,1,22.033333333333335,0,5,0.0,0,3,0.0,0,0,,0,1,1,1,2,0,0,2,0,-1.3,-18.0,Reggie Bullock,0,2,0.0
4782,11/9/2022,31.65205479452055,L,1,25.816666666666666,0,3,0.0,0,2,0.0,0,0,,0,3,3,0,0,0,0,4,0,-2.8,-4.0,Reggie Bullock,0,1,0.0
4783,11/10/2022,31.654794520547945,L,1,27.216666666666665,2,4,0.5,2,4,0.5,0,0,,0,5,5,2,1,0,0,1,6,7.5,1.0,Reggie Bullock,0,0,
4784,11/12/2022,31.660273972602738,W,1,17.216666666666665,1,5,0.2,0,4,0.0,0,0,,0,2,2,1,2,0,0,4,2,0.6,-5.0,Reggie Bullock,1,1,1.0
4785,11/15/2022,31.66849315068493,W,1,30.833333333333332,4,8,0.5,4,8,0.5,1,2,0.5,1,2,3,1,0,0,0,3,13,9.4,9.0,Reggie Bullock,0,0,
4786,11/16/2022,31.671232876712327,L,1,32.85,0,6,0.0,0,6,0.0,0,0,,2,1,3,0,0,0,0,2,0,-3.3,-16.0,Reggie Bullock,0,0,
4787,11/18/2022,31.676712328767124,W,1,30.533333333333335,4,7,0.571,2,5,0.4,0,0,,0,6,6,3,1,0,0,2,10,10.8,20.0,Reggie Bullock,2,2,1.0
4788,11/20/2022,31.682191780821917,L,1,25.55,1,5,0.2,1,5,0.2,0,0,,1,3,4,0,1,0,0,1,3,2.1,-25.0,Reggie Bullock,0,0,
4789,11/23/2022,31.69041095890411,L,1,27.45,2,6,0.333,1,3,0.333,0,0,,0,1,1,1,0,0,1,1,5,1.2,-21.0,Reggie Bullock,1,3,0.3333333333333333
4790,11/26/2022,31.698630136986303,L,1,26.533333333333335,0,4,0.0,0,4,0.0,4,4,1.0,0,3,3,3,0,0,0,2,4,3.4,6.0,Reggie Bullock,0,0,
4791,10/19/2022,27.06027397260274,L,0,24.266666666666666,9,15,0.6,4,7,0.571,3,10,0.3,1,7,8,2,0,1,1,2,25,18.4,9.0,Christian Wood,5,8,0.625
4792,10/22/2022,27.068493150684933,W,0,25.1,6,12,0.5,1,3,0.333,12,14,0.857,4,8,12,3,0,1,2,4,25,22.6,22.0,Christian Wood,5,9,0.5555555555555556
4793,10/25/2022,27.076712328767123,L,0,29.483333333333334,8,10,0.8,3,3,1.0,4,6,0.667,2,4,6,0,1,0,3,1,23,18.6,8.0,Christian Wood,5,7,0.7142857142857143
4794,10/27/2022,27.08219178082192,W,0,24.383333333333333,3,5,0.6,2,2,1.0,3,4,0.75,0,6,6,0,0,1,3,5,11,5.8,2.0,Christian Wood,1,3,0.3333333333333333
4795,10/29/2022,27.087671232876712,L,0,28.75,5,10,0.5,0,2,0.0,1,2,0.5,1,6,7,0,0,1,3,5,11,3.8,-7.0,Christian Wood,5,8,0.625
4796,10/30/2022,27.09041095890411,W,0,23.5,2,6,0.333,0,1,0.0,1,1,1.0,1,9,10,0,0,0,2,2,5,2.2,7.0,Christian Wood,2,5,0.4
4797,11/2/2022,27.0986301369863,W,0,23.166666666666668,10,15,0.667,1,5,0.2,0,0,,2,8,10,0,0,0,3,0,21,15.3,-7.0,Christian Wood,9,10,0.9
4798,11/4/2022,27.104109589041094,W,0,22.75,5,8,0.625,1,2,0.5,2,2,1.0,0,5,5,1,1,1,1,1,13,11.9,-6.0,Christian Wood,4,6,0.6666666666666666
4799,11/7/2022,27.112328767123287,W,0,20.566666666666666,3,9,0.333,0,1,0.0,0,0,,2,4,6,1,1,0,4,2,6,0.4,-1.0,Christian Wood,3,8,0.375
4800,11/12/2022,27.126027397260273,W,0,25.133333333333333,7,11,0.636,1,5,0.2,4,5,0.8,0,5,5,1,2,0,2,6,19,13.5,14.0,Christian Wood,6,6,1.0
4801,11/15/2022,27.134246575342466,W,0,23.816666666666666,6,8,0.75,2,2,1.0,1,4,0.25,0,7,7,0,0,0,4,2,15,7.9,-4.0,Christian Wood,4,6,0.6666666666666666
4802,11/16/2022,27.136986301369863,L,0,30.516666666666666,9,22,0.409,2,7,0.286,6,6,1.0,1,7,8,3,1,1,0,4,26,19.2,0.0,Christian Wood,7,15,0.4666666666666667
4803,11/18/2022,27.14246575342466,W,0,26.15,11,16,0.688,2,4,0.5,4,5,0.8,2,6,8,1,0,0,3,2,28,20.9,21.0,Christian Wood,9,12,0.75
4804,11/20/2022,27.147945205479452,L,0,17.416666666666668,2,3,0.667,0,0,,1,2,0.5,1,6,7,2,0,0,0,1,5,6.8,-3.0,Christian Wood,2,3,0.6666666666666666
4805,11/23/2022,27.156164383561645,L,0,34.166666666666664,10,14,0.714,2,3,0.667,4,5,0.8,2,10,12,2,0,0,5,4,26,19.0,-8.0,Christian Wood,8,11,0.7272727272727273
4806,11/26/2022,27.164383561643834,L,0,22.833333333333332,3,8,0.375,2,4,0.5,2,4,0.5,1,5,6,0,1,3,3,2,10,6.3,-13.0,Christian Wood,1,4,0.25
4807,11/27/2022,27.167123287671235,L,0,32.083333333333336,8,17,0.471,2,6,0.333,3,4,0.75,0,7,7,2,1,0,1,4,21,13.8,5.0,Christian Wood,6,11,0.5454545454545454
4808,10/22/2022,31.257534246575343,W,0,7.1,0,0,,0,0,,1,2,0.5,0,0,0,0,0,1,1,2,1,-0.5,8.0,Dwight Powell,0,0,
4809,10/29/2022,31.276712328767122,L,1,18.466666666666665,5,7,0.714,0,1,0.0,3,3,1.0,0,2,2,0,0,0,0,1,13,10.3,7.0,Dwight Powell,5,6,0.8333333333333334
4810,10/30/2022,31.279452054794522,W,0,11.966666666666667,2,3,0.667,0,0,,1,1,1.0,2,2,4,0,0,1,0,2,5,5.6,10.0,Dwight Powell,2,3,0.6666666666666666
4811,11/2/2022,31.28767123287671,W,0,18.6,4,5,0.8,0,0,,1,2,0.5,2,3,5,0,1,1,0,1,9,10.3,25.0,Dwight Powell,4,5,0.8
4812,11/4/2022,31.293150684931508,W,1,26.35,3,6,0.5,0,0,,3,4,0.75,1,1,2,2,0,0,0,3,9,6.8,8.0,Dwight Powell,3,6,0.5
4813,11/7/2022,31.301369863013697,W,0,22.616666666666667,1,2,0.5,0,0,,0,0,,4,4,8,0,1,1,2,2,2,3.9,7.0,Dwight Powell,1,2,0.5
4814,11/9/2022,31.306849315068494,L,1,18.833333333333332,1,2,0.5,0,0,,0,0,,0,4,4,0,3,0,1,4,2,2.6,-10.0,Dwight Powell,1,2,0.5
4815,11/10/2022,31.30958904109589,L,1,26.35,6,9,0.667,0,0,,2,2,1.0,4,3,7,0,1,0,1,2,14,13.0,5.0,Dwight Powell,6,9,0.6666666666666666
4816,11/12/2022,31.315068493150687,W,1,15.366666666666667,1,2,0.5,0,0,,0,0,,2,0,2,0,0,0,1,3,2,0.2,-15.0,Dwight Powell,1,2,0.5
4817,11/15/2022,31.323287671232876,W,1,22.466666666666665,1,3,0.333,0,0,,1,2,0.5,2,0,2,5,1,0,1,3,3,4.6,13.0,Dwight Powell,1,3,0.3333333333333333
4818,11/16/2022,31.326027397260273,L,1,17.483333333333334,2,3,0.667,0,0,,3,4,0.75,4,1,5,0,0,0,1,3,7,6.2,-9.0,Dwight Powell,2,3,0.6666666666666666
4819,11/18/2022,31.33150684931507,W,1,12.983333333333333,2,2,1.0,0,0,,1,1,1.0,0,1,1,1,0,0,1,1,5,4.0,-1.0,Dwight Powell,2,2,1.0
4820,11/20/2022,31.336986301369862,L,1,20.283333333333335,5,6,0.833,0,0,,1,4,0.25,3,2,5,1,1,0,1,3,11,9.8,-6.0,Dwight Powell,5,6,0.8333333333333334
4821,11/23/2022,31.345205479452055,L,1,10.866666666666667,0,0,,0,0,,1,2,0.5,0,1,1,0,0,1,1,3,1,-0.6,-6.0,Dwight Powell,0,0,
4822,11/26/2022,31.353424657534248,L,1,14.15,3,3,1.0,0,0,,2,2,1.0,2,0,2,0,2,0,1,2,8,8.7,8.0,Dwight Powell,3,3,1.0
4823,11/27/2022,31.356164383561644,L,1,7.733333333333333,1,1,1.0,0,0,,2,4,0.5,0,0,0,0,0,1,0,0,4,3.6,-4.0,Dwight Powell,1,1,1.0
4824,10/19/2022,30.720547945205478,L,0,26.35,1,3,0.333,0,1,0.0,0,0,,1,4,5,1,0,1,0,2,2,2.8,5.0,Maxi Kleber,1,2,0.5
4825,10/22/2022,30.72876712328767,W,0,21.416666666666668,3,5,0.6,2,3,0.667,1,2,0.5,2,6,8,0,2,0,1,1,9,10.1,14.0,Maxi Kleber,1,2,0.5
4826,10/25/2022,30.736986301369864,L,0,27.616666666666667,1,3,0.333,1,3,0.333,4,4,1.0,2,3,5,0,0,2,2,2,7,6.2,-7.0,Maxi Kleber,0,0,
4827,10/27/2022,30.742465753424657,W,0,32.9,4,5,0.8,3,4,0.75,4,6,0.667,1,0,1,1,0,0,1,2,15,11.9,15.0,Maxi Kleber,1,1,1.0
4828,10/29/2022,30.747945205479454,L,0,28.466666666666665,1,8,0.125,0,6,0.0,0,0,,1,4,5,0,1,2,1,2,2,-0.7,-8.0,Maxi Kleber,1,2,0.5
4829,10/30/2022,30.75068493150685,W,0,24.966666666666665,1,3,0.333,0,2,0.0,0,0,,0,2,2,2,1,0,0,2,2,2.5,17.0,Maxi Kleber,1,1,1.0
4830,11/2/2022,30.75890410958904,W,0,25.016666666666666,0,0,,0,0,,0,0,,0,5,5,1,0,2,0,2,0,2.8,-4.0,Maxi Kleber,0,0,
4831,11/4/2022,30.764383561643836,W,0,16.816666666666666,1,4,0.25,0,1,0.0,0,0,,0,2,2,2,0,0,3,0,2,-1.4,-16.0,Maxi Kleber,1,3,0.3333333333333333
4832,11/7/2022,30.77260273972603,W,0,29.4,2,3,0.667,1,1,1.0,0,0,,2,3,5,1,0,1,0,3,5,6.2,18.0,Maxi Kleber,1,2,0.5
4833,11/9/2022,30.778082191780822,L,0,33.36666666666667,3,6,0.5,2,5,0.4,0,0,,1,2,3,0,1,0,0,2,8,6.5,-1.0,Maxi Kleber,1,1,1.0
4834,11/10/2022,30.78082191780822,L,0,20.866666666666667,1,6,0.167,0,5,0.0,0,0,,0,3,3,2,1,0,0,2,2,0.7,-22.0,Maxi Kleber,1,1,1.0
4835,11/12/2022,30.786301369863015,W,0,23.35,2,5,0.4,0,1,0.0,0,0,,1,1,2,1,0,0,0,2,4,2.2,2.0,Maxi Kleber,2,4,0.5
4836,11/15/2022,30.794520547945204,W,0,9.633333333333333,0,1,0.0,0,1,0.0,0,0,,0,1,1,0,0,1,0,2,0,-0.5,5.0,Maxi Kleber,0,0,
4837,11/26/2022,30.824657534246576,L,0,29.1,5,7,0.714,1,3,0.333,0,0,,0,5,5,3,0,0,0,3,11,10.5,-1.0,Maxi Kleber,4,4,1.0
4838,11/27/2022,30.827397260273973,L,0,24.283333333333335,2,3,0.667,2,3,0.667,0,0,,2,2,4,3,0,1,1,2,6,7.7,0.0,Maxi Kleber,0,0,
4839,10/19/2022,34.74794520547945,L,1,14.133333333333333,1,3,0.333,0,0,,1,4,0.25,1,3,4,1,1,1,2,1,3,1.7,-5.0,JaVale McGee,1,3,0.3333333333333333
4840,10/22/2022,34.75616438356165,W,1,13.016666666666667,3,4,0.75,0,0,,0,0,,2,4,6,1,0,2,1,3,6,6.9,2.0,JaVale McGee,3,4,0.75
4841,10/25/2022,34.76438356164383,L,1,12.266666666666667,3,5,0.6,0,0,,2,4,0.5,1,1,2,0,1,1,0,1,8,7.2,0.0,JaVale McGee,3,5,0.6
4842,10/27/2022,34.76986301369863,W,1,11.933333333333334,2,5,0.4,0,0,,4,4,1.0,3,0,3,0,0,0,3,0,8,4.4,-8.0,JaVale McGee,2,5,0.4
4843,10/30/2022,34.778082191780825,W,1,8.866666666666667,0,2,0.0,0,0,,0,0,,0,3,3,0,0,0,0,1,0,-0.9,-12.0,JaVale McGee,0,2,0.0
4844,11/2/2022,34.78630136986301,W,1,7.983333333333333,2,2,1.0,0,0,,0,0,,0,2,2,0,1,0,0,1,4,4.6,-7.0,JaVale McGee,2,2,1.0
4845,11/4/2022,34.79178082191781,W,0,4.3,2,2,1.0,0,0,,1,1,1.0,0,1,1,0,0,0,1,0,5,3.7,6.0,JaVale McGee,2,2,1.0
4846,11/7/2022,34.8,W,1,3.4166666666666665,0,1,0.0,0,0,,0,0,,0,0,0,0,0,0,1,0,0,-1.7,-4.0,JaVale McGee,0,1,0.0
4847,11/9/2022,34.8054794520548,L,0,10.983333333333333,2,4,0.5,0,0,,1,2,0.5,3,3,6,0,0,0,1,2,5,3.8,4.0,JaVale McGee,2,4,0.5
4848,11/10/2022,34.80821917808219,L,0,7.55,1,4,0.25,0,0,,1,2,0.5,1,2,3,0,0,1,2,1,3,-0.2,-7.0,JaVale McGee,1,4,0.25
4849,11/18/2022,34.83013698630137,W,0,16.533333333333335,5,6,0.833,0,0,,0,2,0.0,0,4,4,1,0,2,2,4,10,6.7,11.0,JaVale McGee,5,6,0.8333333333333334
4850,11/20/2022,34.83561643835616,L,0,10.733333333333333,1,3,0.333,0,0,,0,0,,0,1,1,0,0,1,0,0,2,1.3,3.0,JaVale McGee,1,3,0.3333333333333333
4851,11/23/2022,34.843835616438355,L,0,4.6,2,2,1.0,0,0,,1,1,1.0,0,1,1,0,0,0,0,1,5,4.3,4.0,JaVale McGee,2,2,1.0
4852,11/26/2022,34.85205479452055,L,0,6.433333333333334,1,1,1.0,0,0,,0,0,,0,2,2,1,0,0,1,2,2,1.2,-7.0,JaVale McGee,1,1,1.0
4853,11/27/2022,34.85479452054795,L,0,3.533333333333333,1,1,1.0,0,0,,0,0,,0,1,1,0,0,0,1,1,2,0.6,-10.0,JaVale McGee,1,1,1.0
4854,10/25/2022,31.59178082191781,L,0,12.95,1,4,0.25,1,3,0.333,0,0,,0,0,0,2,2,0,0,0,3,4.0,0.0,Facundo Campazzo,0,1,0.0
4855,10/27/2022,31.5972602739726,W,0,2.783333333333333,0,0,,0,0,,0,0,,0,0,0,1,1,0,0,1,0,1.3,2.0,Facundo Campazzo,0,0,
4856,11/10/2022,31.635616438356166,L,0,0.16666666666666666,0,0,,0,0,,0,0,,0,0,0,0,0,0,0,0,0,0.0,0.0,Facundo Campazzo,0,0,
4857,11/16/2022,31.65205479452055,L,0,22.583333333333332,1,7,0.143,1,6,0.167,0,0,,0,2,2,5,3,0,3,1,3,2.2,5.0,Facundo Campazzo,0,1,0.0
4858,11/18/2022,31.65753424657534,W,0,4.366666666666666,0,0,,0,0,,0,0,,0,0,0,0,0,0,0,0,0,0.0,-1.0,Facundo Campazzo,0,0,
4859,11/23/2022,31.671232876712327,L,0,1.75,0,0,,0,0,,1,2,0.5,0,0,0,0,0,0,0,0,1,0.6,2.0,Facundo Campazzo,0,0,
4860,11/26/2022,31.67945205479452,L,0,4.116666666666666,0,1,0.0,0,1,0.0,0,0,,0,0,0,1,0,0,0,1,0,-0.4,-2.0,Facundo Campazzo,0,0,
4861,11/27/2022,31.682191780821917,L,0,3.4333333333333336,1,1,1.0,1,1,1.0,0,0,,0,0,0,0,0,0,0,0,3,2.7,5.0,Facundo Campazzo,0,0,
4862,11/16/2022,30.01095890410959,L,0,3.466666666666667,1,3,0.333,1,2,0.5,0,0,,0,0,0,0,0,0,0,3,3,0.1,1.0,Dāvis Bertāns,0,1,0.0
4863,11/18/2022,30.016438356164382,W,0,4.366666666666666,0,2,0.0,0,2,0.0,0,0,,0,1,1,0,0,0,0,1,0,-1.5,-1.0,Dāvis Bertāns,0,0,
4864,11/20/2022,30.02191780821918,L,0,14.416666666666666,5,7,0.714,4,5,0.8,1,1,1.0,0,1,1,2,0,0,1,4,15,11.2,21.0,Dāvis Bertāns,1,2,0.5
4865,11/23/2022,30.03013698630137,L,0,5.133333333333334,0,3,0.0,0,1,0.0,0,0,,1,0,1,1,0,0,0,0,0,-0.7,-6.0,Dāvis Bertāns,0,2,0.0
4866,11/27/2022,30.041095890410958,L,0,16.85,1,3,0.333,1,3,0.333,0,0,,0,2,2,1,0,0,0,2,3,1.8,-1.0,Dāvis Bertāns,0,0,
4867,11/10/2022,24.28767123287671,L,0,4.116666666666666,0,3,0.0,0,3,0.0,0,0,,0,2,2,1,0,0,0,0,0,-0.8,4.0,Frank Ntilikina,0,0,
4868,11/16/2022,24.304109589041097,L,0,11.983333333333333,2,4,0.5,1,2,0.5,0,0,,0,1,1,0,1,0,0,1,5,3.9,7.0,Frank Ntilikina,1,2,0.5
4869,11/18/2022,24.30958904109589,W,0,7.5,1,1,1.0,0,0,,0,0,,0,0,0,2,0,0,1,1,2,1.7,-1.0,Frank Ntilikina,1,1,1.0
4870,11/23/2022,24.323287671232876,L,0,1.75,0,0,,0,0,,0,0,,0,2,2,0,0,0,0,0,0,0.6,2.0,Frank Ntilikina,0,0,
4871,11/27/2022,24.334246575342465,L,0,3.4333333333333336,0,0,,0,0,,0,0,,0,0,0,0,1,0,0,0,0,1.0,5.0,Frank Ntilikina,0,0,
4872,10/22/2022,26.96164383561644,W,0,7.0,0,0,,0,0,,2,2,1.0,0,2,2,1,0,0,0,0,2,3.3,8.0,Theo Pinson,0,0,
4873,11/10/2022,27.013698630136986,L,0,0.16666666666666666,0,0,,0,0,,0,0,,0,0,0,0,0,0,0,0,0,0.0,0.0,Theo Pinson,0,0,
4874,11/18/2022,27.035616438356165,W,0,4.066666666666666,0,0,,0,0,,0,0,,0,1,1,0,0,0,0,0,0,0.3,-1.0,Theo Pinson,0,0,
4875,11/23/2022,27.04931506849315,L,0,1.75,1,1,1.0,0,0,,0,0,,0,0,0,0,0,0,0,1,2,1.3,2.0,Theo Pinson,1,1,1.0
4876,11/27/2022,27.06027397260274,L,0,3.4333333333333336,0,1,0.0,0,1,0.0,0,0,,0,2,2,0,0,0,1,0,0,-1.1,5.0,Theo Pinson,0,0,
4877,10/22/2022,20.2986301369863,W,0,6.266666666666667,0,3,0.0,0,2,0.0,0,0,,0,1,1,0,0,0,2,0,0,-3.8,3.0,Jaden Hardy,0,1,0.0
4878,10/29/2022,20.317808219178083,L,0,3.716666666666667,0,2,0.0,0,0,,0,0,,0,1,1,1,0,0,0,2,0,-1.2,1.0,Jaden Hardy,0,2,0.0
4879,11/10/2022,20.350684931506848,L,0,0.16666666666666666,0,0,,0,0,,0,0,,0,0,0,0,0,0,0,0,0,0.0,0.0,Jaden Hardy,0,0,
4880,10/22/2022,26.673972602739727,W,0,4.283333333333333,4,4,1.0,1,1,1.0,0,0,,1,1,2,0,0,0,0,0,9,8.8,2.0,Tyler Dorsey,3,3,1.0
4881,10/22/2022,23.991780821917807,W,0,4.966666666666667,1,4,0.25,0,1,0.0,0,0,,1,1,2,2,1,0,0,0,2,3.0,3.0,McKinley Wright IV,1,3,0.3333333333333333
4882,10/19/2022,27.01095890410959,L,1,26.983333333333334,7,13,0.538,0,0,,0,0,,4,5,9,2,0,0,3,2,14,9.6,-10.0,Jakob Poeltl,7,13,0.5384615384615384
4883,10/21/2022,27.016438356164382,W,1,28.6,4,6,0.667,0,0,,13,21,0.619,2,6,8,5,1,1,2,1,21,21.2,12.0,Jakob Poeltl,4,6,0.6666666666666666
4884,10/22/2022,27.019178082191782,W,1,27.033333333333335,6,9,0.667,0,0,,1,2,0.5,7,5,12,3,0,1,1,5,13,14.9,0.0,Jakob Poeltl,6,9,0.6666666666666666
4885,10/24/2022,27.024657534246575,W,1,30.5,7,12,0.583,0,0,,0,0,,8,6,14,4,1,0,2,1,14,17.2,0.0,Jakob Poeltl,7,12,0.5833333333333334
4886,10/26/2022,27.03013698630137,L,1,29.1,5,8,0.625,0,0,,2,4,0.5,5,5,10,4,0,0,2,1,12,13.0,0.0,Jakob Poeltl,5,8,0.625
4887,10/28/2022,27.035616438356165,W,1,30.183333333333334,10,12,0.833,0,0,,1,2,0.5,3,10,13,4,1,1,2,1,21,23.4,9.0,Jakob Poeltl,10,12,0.8333333333333334
4888,10/30/2022,27.041095890410958,W,1,33.5,2,2,1.0,0,0,,0,0,,1,13,14,4,2,3,3,3,4,10.7,-4.0,Jakob Poeltl,2,2,1.0
4889,11/2/2022,27.04931506849315,L,1,20.666666666666668,3,6,0.5,0,0,,0,0,,5,1,6,2,0,1,5,2,6,3.1,-26.0,Jakob Poeltl,3,6,0.5
4890,11/4/2022,27.054794520547944,L,1,26.35,2,6,0.333,0,0,,0,2,0.0,2,5,7,3,3,1,1,2,4,6.7,-21.0,Jakob Poeltl,2,6,0.3333333333333333
4891,11/5/2022,27.057534246575344,L,1,28.583333333333332,7,12,0.583,0,0,,0,2,0.0,3,5,8,2,1,1,2,2,14,11.5,-23.0,Jakob Poeltl,7,12,0.5833333333333334
4892,11/7/2022,27.063013698630137,L,1,31.8,2,3,0.667,0,0,,0,2,0.0,0,7,7,9,2,3,3,1,4,11.0,-12.0,Jakob Poeltl,2,3,0.6666666666666666
4893,11/9/2022,27.068493150684933,L,1,36.733333333333334,10,12,0.833,0,0,,2,5,0.4,6,3,9,4,2,0,1,3,22,24.1,-9.0,Jakob Poeltl,10,12,0.8333333333333334
4894,11/11/2022,27.073972602739726,W,1,29.783333333333335,7,11,0.636,0,0,,1,3,0.333,3,7,10,3,0,4,2,3,15,15.2,9.0,Jakob Poeltl,7,11,0.6363636363636364
4895,11/14/2022,27.08219178082192,L,1,20.333333333333332,3,6,0.5,0,0,,0,0,,4,6,10,1,0,1,4,3,6,3.8,-16.0,Jakob Poeltl,3,6,0.5
4896,11/15/2022,27.084931506849315,L,1,31.666666666666668,14,17,0.824,0,0,,3,5,0.6,5,9,14,5,0,1,4,3,31,29.1,7.0,Jakob Poeltl,14,17,0.8235294117647058
4897,11/17/2022,27.09041095890411,L,1,27.35,5,9,0.556,0,0,,0,0,,3,4,7,4,1,1,2,4,10,9.9,-10.0,Jakob Poeltl,5,9,0.5555555555555556
4898,11/19/2022,27.095890410958905,L,1,25.066666666666666,8,15,0.533,0,0,,4,4,1.0,3,5,8,3,1,0,0,1,20,19.0,-16.0,Jakob Poeltl,8,15,0.5333333333333333
4899,11/23/2022,27.106849315068494,L,1,25.55,1,3,0.333,0,0,,2,4,0.5,4,10,14,3,3,0,5,2,4,6.6,-27.0,Jakob Poeltl,1,3,0.3333333333333333
4900,11/25/2022,27.112328767123287,L,1,25.216666666666665,5,8,0.625,0,0,,0,0,,5,3,8,4,0,0,3,4,10,9.0,-6.0,Jakob Poeltl,5,8,0.625
4901,11/26/2022,27.115068493150684,L,1,9.783333333333333,6,8,0.75,0,0,,0,0,,4,5,9,0,0,1,1,2,12,12.0,11.0,Jakob Poeltl,6,8,0.75
4902,10/19/2022,22.778082191780822,L,1,24.366666666666667,5,8,0.625,1,2,0.5,3,3,1.0,2,1,3,2,1,2,0,3,14,14.7,-11.0,Tre Jones,4,6,0.6666666666666666
4903,10/21/2022,22.783561643835615,W,1,35.03333333333333,6,12,0.5,1,3,0.333,5,6,0.833,1,3,4,4,2,0,3,4,18,13.4,-10.0,Tre Jones,5,9,0.5555555555555556
4904,10/22/2022,22.786301369863015,W,1,30.433333333333334,6,12,0.5,0,0,,5,5,1.0,0,1,1,4,1,0,4,1,17,10.7,-1.0,Tre Jones,6,12,0.5
4905,10/24/2022,22.791780821917808,W,1,29.733333333333334,3,10,0.3,1,4,0.25,1,1,1.0,0,7,7,8,3,0,1,3,8,10.7,10.0,Tre Jones,2,6,0.3333333333333333
4906,10/26/2022,22.797260273972604,L,1,32.81666666666667,3,12,0.25,1,3,0.333,6,6,1.0,2,5,7,3,1,0,1,2,13,10.0,-11.0,Tre Jones,2,9,0.2222222222222222
4907,10/28/2022,22.802739726027397,W,1,32.75,3,8,0.375,1,2,0.5,4,4,1.0,2,2,4,8,1,0,5,0,11,10.2,23.0,Tre Jones,2,6,0.3333333333333333
4908,10/30/2022,22.80821917808219,W,1,31.5,2,12,0.167,1,2,0.5,5,7,0.714,1,1,2,8,0,0,2,3,10,5.0,6.0,Tre Jones,1,10,0.1
4909,11/2/2022,22.816438356164383,L,1,21.666666666666668,3,9,0.333,1,2,0.5,0,0,,0,8,8,7,1,0,2,1,7,7.8,-23.0,Tre Jones,2,7,0.2857142857142857
4910,11/4/2022,22.82191780821918,L,1,33.0,7,15,0.467,3,5,0.6,1,1,1.0,0,2,2,6,2,0,1,3,18,14.9,-4.0,Tre Jones,4,10,0.4
4911,11/5/2022,22.824657534246576,L,1,24.166666666666668,2,7,0.286,0,1,0.0,0,0,,0,0,0,7,1,0,1,1,4,4.4,-17.0,Tre Jones,2,6,0.3333333333333333
4912,11/7/2022,22.83013698630137,L,1,33.35,9,13,0.692,1,2,0.5,1,1,1.0,1,2,3,9,3,0,3,3,20,20.9,-6.0,Tre Jones,8,11,0.7272727272727273
4913,11/9/2022,22.835616438356166,L,1,37.03333333333333,4,13,0.308,1,4,0.25,2,2,1.0,0,4,4,11,1,0,2,2,11,10.6,-1.0,Tre Jones,3,9,0.3333333333333333
4914,11/11/2022,22.84109589041096,W,1,29.7,4,7,0.571,1,1,1.0,0,0,,0,5,5,9,1,1,1,2,9,13.4,8.0,Tre Jones,3,6,0.5
4915,11/15/2022,22.852054794520548,L,1,22.9,1,6,0.167,0,1,0.0,0,0,,0,2,2,10,3,0,0,1,2,8.4,14.0,Tre Jones,1,5,0.2
4916,11/17/2022,22.85753424657534,L,1,29.366666666666667,7,13,0.538,1,2,0.5,0,0,,0,1,1,4,2,0,3,2,15,10.0,-18.0,Tre Jones,6,11,0.5454545454545454
4917,11/19/2022,22.863013698630137,L,1,25.95,3,13,0.231,0,2,0.0,0,0,,1,1,2,10,1,0,1,2,6,5.3,-5.0,Tre Jones,3,11,0.2727272727272727
4918,11/20/2022,22.865753424657534,L,1,26.183333333333334,5,12,0.417,0,1,0.0,0,0,,0,2,2,4,0,0,3,1,10,3.6,-16.0,Tre Jones,5,11,0.45454545454545453
4919,11/23/2022,22.873972602739727,L,1,31.083333333333332,1,8,0.125,1,7,0.143,6,6,1.0,0,0,0,9,2,0,3,2,9,8.3,-13.0,Tre Jones,0,1,0.0
4920,11/25/2022,22.87945205479452,L,1,33.333333333333336,7,13,0.538,2,5,0.4,3,3,1.0,1,1,2,5,2,0,4,2,19,14.4,-9.0,Tre Jones,5,8,0.625
4921,11/26/2022,22.882191780821916,L,1,35.81666666666667,9,13,0.692,0,1,0.0,5,7,0.714,3,5,8,13,2,0,1,2,23,29.6,12.0,Tre Jones,9,12,0.75
4922,10/19/2022,19.416438356164385,L,1,27.433333333333334,2,8,0.25,0,2,0.0,0,1,0.0,2,5,7,2,2,0,0,2,4,4.3,-2.0,Jeremy Sochan,2,6,0.3333333333333333
4923,10/21/2022,19.421917808219177,W,1,21.066666666666666,2,4,0.5,0,1,0.0,0,0,,1,4,5,1,0,0,1,3,4,2.4,2.0,Jeremy Sochan,2,3,0.6666666666666666
4924,10/22/2022,19.424657534246574,W,1,10.283333333333333,0,3,0.0,0,2,0.0,1,2,0.5,0,3,3,1,0,1,1,1,1,-0.6,-9.0,Jeremy Sochan,0,1,0.0
4925,10/24/2022,19.43013698630137,W,1,23.383333333333333,7,9,0.778,0,2,0.0,0,0,,2,2,4,1,1,0,1,5,14,11.2,13.0,Jeremy Sochan,7,7,1.0
4926,10/26/2022,19.435616438356163,L,1,27.633333333333333,5,13,0.385,2,6,0.333,0,0,,1,0,1,2,1,1,1,3,12,6.5,2.0,Jeremy Sochan,3,7,0.42857142857142855
4927,10/28/2022,19.44109589041096,W,1,31.266666666666666,5,8,0.625,2,4,0.5,1,2,0.5,0,6,6,5,1,1,3,3,13,11.8,4.0,Jeremy Sochan,3,4,0.75
4928,11/2/2022,19.454794520547946,L,1,9.816666666666666,1,4,0.25,0,2,0.0,0,0,,1,1,2,0,1,0,0,0,2,1.6,-13.0,Jeremy Sochan,1,2,0.5
4929,11/4/2022,19.46027397260274,L,1,22.1,3,8,0.375,0,4,0.0,0,0,,1,1,2,2,0,0,1,0,6,3.0,-5.0,Jeremy Sochan,3,4,0.75
4930,11/5/2022,19.463013698630135,L,1,24.183333333333334,2,2,1.0,1,1,1.0,0,0,,1,1,2,1,1,1,0,2,5,7.0,6.0,Jeremy Sochan,1,1,1.0
4931,11/7/2022,19.46849315068493,L,1,28.35,1,4,0.25,0,2,0.0,0,0,,2,2,4,2,2,1,0,2,2,4.9,-3.0,Jeremy Sochan,1,2,0.5
4932,11/9/2022,19.473972602739725,L,1,30.383333333333333,6,7,0.857,1,2,0.5,0,0,,1,1,2,0,2,0,2,3,13,10.3,-6.0,Jeremy Sochan,5,5,1.0
4933,11/11/2022,19.47945205479452,W,1,29.833333333333332,4,7,0.571,0,2,0.0,2,2,1.0,1,6,7,2,0,1,2,4,10,7.7,22.0,Jeremy Sochan,4,5,0.8
4934,11/14/2022,19.487671232876714,L,1,24.6,5,13,0.385,0,3,0.0,2,3,0.667,2,5,7,0,1,0,3,4,12,3.8,-34.0,Jeremy Sochan,5,10,0.5
4935,11/15/2022,19.49041095890411,L,1,26.633333333333333,2,3,0.667,0,0,,2,2,1.0,0,4,4,4,0,2,1,5,6,7.1,18.0,Jeremy Sochan,2,3,0.6666666666666666
4936,11/17/2022,19.495890410958904,L,1,31.4,5,10,0.5,0,2,0.0,1,1,1.0,0,4,4,5,0,0,3,2,11,6.9,-12.0,Jeremy Sochan,5,8,0.625
4937,11/19/2022,19.5013698630137,L,1,28.0,2,6,0.333,0,1,0.0,0,0,,2,2,4,2,0,1,7,2,4,-3.1,-24.0,Jeremy Sochan,2,5,0.4
4938,11/20/2022,19.504109589041096,L,1,26.3,6,14,0.429,0,3,0.0,0,1,0.0,3,3,6,1,3,0,2,2,12,8.1,-21.0,Jeremy Sochan,6,11,0.5454545454545454
4939,11/23/2022,19.512328767123286,L,1,24.016666666666666,6,10,0.6,0,1,0.0,0,2,0.0,1,1,2,1,0,0,1,5,12,5.3,-26.0,Jeremy Sochan,6,9,0.6666666666666666
4940,11/25/2022,19.517808219178082,L,1,35.8,5,11,0.455,1,3,0.333,2,4,0.5,5,4,9,5,4,1,2,3,13,16.2,-17.0,Jeremy Sochan,4,8,0.5
4941,11/26/2022,19.52054794520548,L,1,14.4,2,6,0.333,1,1,1.0,0,0,,0,0,0,3,0,0,0,1,5,3.3,0.0,Jeremy Sochan,1,5,0.2
4942,10/19/2022,23.02191780821918,L,1,29.65,8,17,0.471,3,7,0.429,1,2,0.5,2,9,11,4,2,0,2,2,20,17.0,-11.0,Keldon Johnson,5,10,0.5
4943,10/21/2022,23.027397260273972,W,1,33.4,8,15,0.533,4,9,0.444,3,4,0.75,0,3,3,6,1,0,2,4,23,17.8,16.0,Keldon Johnson,4,6,0.6666666666666666
4944,10/22/2022,23.03013698630137,W,1,31.75,7,17,0.412,3,8,0.375,4,5,0.8,2,6,8,0,1,0,3,1,21,12.3,13.0,Keldon Johnson,4,9,0.4444444444444444
4945,10/24/2022,23.035616438356165,W,1,33.78333333333333,8,20,0.4,1,6,0.167,1,4,0.25,0,3,3,4,2,0,1,0,18,10.7,5.0,Keldon Johnson,7,14,0.5
4946,10/26/2022,23.041095890410958,L,1,33.28333333333333,9,20,0.45,5,10,0.5,4,4,1.0,0,4,4,3,0,0,3,2,27,16.1,-2.0,Keldon Johnson,4,10,0.4
4947,10/28/2022,23.046575342465754,W,1,34.666666666666664,8,19,0.421,6,12,0.5,11,12,0.917,0,3,3,4,2,0,4,2,33,23.4,10.0,Keldon Johnson,2,7,0.2857142857142857
4948,10/30/2022,23.052054794520547,W,1,38.05,8,15,0.533,5,10,0.5,4,4,1.0,0,6,6,8,1,1,5,1,25,21.4,20.0,Keldon Johnson,3,5,0.6
4949,11/4/2022,23.065753424657533,L,1,34.416666666666664,7,19,0.368,2,9,0.222,0,1,0.0,1,6,7,3,0,0,0,3,16,8.5,-12.0,Keldon Johnson,5,10,0.5
4950,11/5/2022,23.068493150684933,L,1,31.133333333333333,8,14,0.571,4,7,0.571,5,6,0.833,0,3,3,4,0,0,3,0,25,18.7,-16.0,Keldon Johnson,4,7,0.5714285714285714
4951,11/7/2022,23.073972602739726,L,1,35.666666666666664,12,20,0.6,5,11,0.455,1,2,0.5,1,4,5,2,2,0,6,2,30,18.9,-17.0,Keldon Johnson,7,9,0.7777777777777778
4952,11/9/2022,23.07945205479452,L,1,39.733333333333334,4,15,0.267,2,8,0.25,6,10,0.6,2,6,8,4,0,0,3,1,16,8.1,-13.0,Keldon Johnson,2,7,0.2857142857142857
4953,11/11/2022,23.084931506849315,W,1,31.95,9,17,0.529,5,8,0.625,6,6,1.0,0,2,2,2,1,0,4,2,29,18.9,7.0,Keldon Johnson,4,9,0.4444444444444444
4954,11/14/2022,23.09315068493151,L,1,18.583333333333332,5,15,0.333,3,9,0.333,2,2,1.0,0,1,1,1,0,0,1,0,15,6.5,-18.0,Keldon Johnson,2,6,0.3333333333333333
4955,11/15/2022,23.095890410958905,L,1,34.05,6,14,0.429,4,9,0.444,4,5,0.8,0,5,5,5,2,0,4,1,20,14.8,-7.0,Keldon Johnson,2,5,0.4
4956,11/19/2022,23.106849315068494,L,1,27.616666666666667,5,15,0.333,1,5,0.2,0,0,,1,1,2,1,1,0,0,1,11,4.8,-18.0,Keldon Johnson,4,10,0.4
4957,11/20/2022,23.10958904109589,L,1,31.0,4,20,0.2,1,10,0.1,3,5,0.6,2,1,3,1,1,0,2,2,12,-0.6,-28.0,Keldon Johnson,3,10,0.3
4958,11/23/2022,23.117808219178084,L,1,16.1,2,9,0.222,0,4,0.0,1,1,1.0,0,1,1,0,0,0,1,1,5,-1.6,-20.0,Keldon Johnson,2,5,0.4
4959,11/25/2022,23.123287671232877,L,1,35.13333333333333,6,23,0.261,1,8,0.125,2,3,0.667,3,6,9,2,1,0,2,2,15,4.4,-11.0,Keldon Johnson,5,15,0.3333333333333333
4960,11/26/2022,23.126027397260273,L,1,36.516666666666666,10,28,0.357,3,9,0.333,3,5,0.6,3,7,10,3,2,1,0,6,26,16.2,-13.0,Keldon Johnson,7,19,0.3684210526315789
4961,10/19/2022,30.791780821917808,L,0,16.416666666666668,5,10,0.5,2,5,0.4,0,0,,2,0,2,0,0,0,0,2,12,7.6,-18.0,Doug McDermott,3,5,0.6
4962,10/21/2022,30.797260273972604,W,0,12.15,1,3,0.333,1,1,1.0,0,0,,0,1,1,3,0,0,1,1,3,2.3,-10.0,Doug McDermott,0,2,0.0
4963,10/22/2022,30.8,W,0,24.4,5,9,0.556,4,5,0.8,0,0,,0,3,3,1,0,1,1,1,14,10.6,19.0,Doug McDermott,1,4,0.25
4964,10/24/2022,30.805479452054794,W,0,17.116666666666667,1,5,0.2,0,3,0.0,0,0,,0,1,1,1,0,0,1,1,2,-1.5,-12.0,Doug McDermott,1,2,0.5
4965,10/26/2022,30.81095890410959,L,0,24.35,6,14,0.429,4,8,0.5,3,3,1.0,1,2,3,3,0,0,1,3,19,12.8,-10.0,Doug McDermott,2,6,0.3333333333333333
4966,10/28/2022,30.816438356164383,W,0,26.733333333333334,3,9,0.333,1,6,0.167,2,3,0.667,0,4,4,2,0,0,0,3,9,4.9,5.0,Doug McDermott,2,3,0.6666666666666666
4967,10/30/2022,30.82191780821918,W,0,25.433333333333334,8,16,0.5,7,14,0.5,0,0,,0,3,3,1,0,1,1,3,23,15.1,3.0,Doug McDermott,1,2,0.5
4968,11/2/2022,30.83013698630137,L,0,22.35,4,9,0.444,1,4,0.25,0,0,,0,4,4,3,0,0,3,1,9,4.2,-9.0,Doug McDermott,3,5,0.6
4969,11/4/2022,30.835616438356166,L,0,22.5,4,6,0.667,2,3,0.667,0,0,,0,1,1,1,0,0,2,0,10,6.4,5.0,Doug McDermott,2,3,0.6666666666666666
4970,11/5/2022,30.838356164383562,L,0,15.916666666666666,0,3,0.0,0,2,0.0,1,3,0.333,0,0,0,0,0,0,0,1,1,-2.3,-18.0,Doug McDermott,0,1,0.0
4971,11/7/2022,30.843835616438355,L,0,19.066666666666666,3,7,0.429,1,4,0.25,2,3,0.667,0,1,1,1,0,0,0,1,9,5.5,-1.0,Doug McDermott,2,3,0.6666666666666666
4972,11/9/2022,30.84931506849315,L,0,23.533333333333335,4,9,0.444,1,5,0.2,0,0,,0,3,3,1,0,0,0,2,9,5.1,10.0,Doug McDermott,3,4,0.75
4973,11/11/2022,30.854794520547944,W,0,23.783333333333335,4,7,0.571,2,3,0.667,0,0,,1,2,3,1,0,0,3,2,10,4.9,6.0,Doug McDermott,2,4,0.5
4974,11/14/2022,30.863013698630137,L,0,22.6,2,6,0.333,2,5,0.4,1,2,0.5,0,0,0,0,1,1,2,0,7,2.9,-22.0,Doug McDermott,0,1,0.0
4975,11/15/2022,30.865753424657534,L,0,17.233333333333334,2,8,0.25,1,5,0.2,1,1,1.0,0,0,0,0,0,0,2,3,6,-2.0,-12.0,Doug McDermott,1,3,0.3333333333333333
4976,11/19/2022,30.876712328767123,L,0,17.016666666666666,5,6,0.833,3,4,0.75,0,0,,1,1,2,0,0,0,1,1,13,10.4,-10.0,Doug McDermott,2,2,1.0
4977,11/20/2022,30.87945205479452,L,0,18.766666666666666,4,7,0.571,0,2,0.0,0,1,0.0,0,2,2,2,0,0,0,1,8,5.9,-16.0,Doug McDermott,4,5,0.8
4978,11/23/2022,30.887671232876713,L,0,22.9,9,12,0.75,3,6,0.5,0,0,,0,1,1,2,0,0,1,3,21,15.7,-13.0,Doug McDermott,6,6,1.0
4979,11/26/2022,30.895890410958906,L,0,25.9,6,14,0.429,3,7,0.429,0,0,,0,2,2,3,1,0,1,3,15,9.1,-4.0,Doug McDermott,3,7,0.42857142857142855
4980,10/19/2022,26.736986301369864,L,0,4.933333333333334,1,1,1.0,0,0,,0,0,,0,0,0,0,0,0,1,0,2,0.7,-14.0,Keita Bates-Diop,1,1,1.0
4981,10/21/2022,26.742465753424657,W,0,8.533333333333333,2,3,0.667,0,0,,0,0,,1,0,1,0,0,0,0,0,4,3.4,1.0,Keita Bates-Diop,2,3,0.6666666666666666
4982,10/22/2022,26.745205479452054,W,0,4.033333333333333,1,1,1.0,1,1,1.0,0,0,,0,0,0,0,0,0,0,0,3,2.7,0.0,Keita Bates-Diop,0,0,
4983,10/24/2022,26.75068493150685,W,0,0.43333333333333335,0,0,,0,0,,0,0,,0,0,0,0,0,0,0,0,0,0.0,-2.0,Keita Bates-Diop,0,0,
4984,10/26/2022,26.756164383561643,L,0,14.75,6,9,0.667,0,0,,3,3,1.0,1,3,4,1,1,0,3,0,15,11.4,0.0,Keita Bates-Diop,6,9,0.6666666666666666
4985,10/28/2022,26.76164383561644,W,0,14.833333333333334,2,4,0.5,0,1,0.0,0,0,,0,0,0,1,0,0,1,0,4,1.7,2.0,Keita Bates-Diop,2,3,0.6666666666666666
4986,10/30/2022,26.767123287671232,W,1,22.95,6,15,0.4,1,5,0.2,5,5,1.0,2,4,6,1,0,0,4,4,18,7.6,-1.0,Keita Bates-Diop,5,10,0.5
4987,11/2/2022,26.775342465753425,L,1,24.916666666666668,6,12,0.5,2,4,0.5,3,4,0.75,1,3,4,1,0,0,2,0,17,10.9,-30.0,Keita Bates-Diop,4,8,0.5
4988,11/4/2022,26.78082191780822,L,0,19.1,2,4,0.5,0,0,,3,5,0.6,2,1,3,0,1,0,0,1,7,6.5,-4.0,Keita Bates-Diop,2,4,0.5
4989,11/5/2022,26.783561643835615,L,0,18.383333333333333,3,5,0.6,0,1,0.0,2,2,1.0,2,1,3,1,2,0,1,0,8,9.1,-12.0,Keita Bates-Diop,3,4,0.75
4990,11/7/2022,26.78904109589041,L,0,12.016666666666667,1,4,0.25,0,1,0.0,0,0,,2,2,4,0,1,0,2,1,2,0.2,3.0,Keita Bates-Diop,1,3,0.3333333333333333
4991,11/11/2022,26.8,W,0,1.65,0,1,0.0,0,1,0.0,0,0,,0,1,1,0,0,0,0,0,0,-0.4,0.0,Keita Bates-Diop,0,0,
4992,11/14/2022,26.80821917808219,L,1,30.65,5,12,0.417,2,4,0.5,0,0,,6,3,9,2,2,0,0,0,12,14.1,-8.0,Keita Bates-Diop,3,8,0.375
4993,11/15/2022,26.81095890410959,L,0,26.166666666666668,5,7,0.714,0,1,0.0,0,0,,3,1,4,2,1,0,0,1,10,11.5,-13.0,Keita Bates-Diop,5,6,0.8333333333333334
4994,11/17/2022,26.816438356164383,L,1,31.3,7,11,0.636,0,2,0.0,2,3,0.667,1,3,4,2,1,1,0,2,16,14.6,-11.0,Keita Bates-Diop,7,9,0.7777777777777778
4995,11/19/2022,26.82191780821918,L,1,27.75,4,7,0.571,1,1,1.0,0,0,,2,3,5,0,0,1,0,1,9,8.3,-14.0,Keita Bates-Diop,3,6,0.5
4996,11/20/2022,26.824657534246576,L,0,16.05,2,4,0.5,0,1,0.0,0,0,,0,1,1,0,0,1,0,0,4,3.0,-3.0,Keita Bates-Diop,2,3,0.6666666666666666
4997,11/23/2022,26.832876712328765,L,0,24.166666666666668,3,8,0.375,0,2,0.0,4,5,0.8,1,4,5,2,3,0,1,1,10,10.1,6.0,Keita Bates-Diop,3,6,0.5
4998,11/25/2022,26.838356164383562,L,0,3.3833333333333333,0,1,0.0,0,0,,0,0,,0,1,1,1,1,0,0,0,0,1.3,-2.0,Keita Bates-Diop,0,1,0.0
4999,10/19/2022,29.09315068493151,L,0,17.166666666666668,0,3,0.0,0,3,0.0,0,0,,0,2,2,1,0,0,2,1,0,-3.2,-18.0,Josh Richardson,0,0,
5000,10/21/2022,29.0986301369863,W,0,28.2,8,13,0.615,6,8,0.75,5,5,1.0,0,2,2,1,1,0,3,3,27,19.2,3.0,Josh Richardson,2,5,0.4
5001,10/22/2022,29.101369863013698,W,0,20.983333333333334,4,9,0.444,2,6,0.333,1,1,1.0,0,1,1,3,1,0,1,2,11,7.9,1.0,Josh Richardson,2,3,0.6666666666666666
5002,10/24/2022,29.106849315068494,W,0,16.9,4,7,0.571,1,2,0.5,0,0,,0,3,3,1,1,0,0,1,9,7.9,3.0,Josh Richardson,3,5,0.6
5003,10/26/2022,29.112328767123287,L,1,32.55,4,8,0.5,3,6,0.5,0,0,,0,3,3,10,2,1,0,2,11,16.8,-2.0,Josh Richardson,1,2,0.5
5004,10/28/2022,29.117808219178084,W,1,30.516666666666666,4,10,0.4,2,6,0.333,2,2,1.0,1,4,5,6,1,0,2,2,12,10.9,-1.0,Josh Richardson,2,4,0.5
5005,11/2/2022,29.13150684931507,L,0,18.5,3,9,0.333,2,6,0.333,2,2,1.0,0,1,1,3,0,0,2,2,10,4.5,-15.0,Josh Richardson,1,3,0.3333333333333333
5006,11/4/2022,29.136986301369863,L,0,22.266666666666666,0,4,0.0,0,2,0.0,5,8,0.625,0,1,1,3,0,0,3,3,5,-0.8,-13.0,Josh Richardson,0,2,0.0
5007,11/5/2022,29.13972602739726,L,0,19.016666666666666,3,7,0.429,2,4,0.5,0,0,,0,1,1,3,0,0,2,4,8,3.1,-8.0,Josh Richardson,1,3,0.3333333333333333
5008,11/7/2022,29.145205479452056,L,0,27.666666666666668,8,11,0.727,2,5,0.4,4,5,0.8,1,2,3,3,1,0,6,3,22,14.3,10.0,Josh Richardson,6,6,1.0
5009,11/9/2022,29.15068493150685,L,0,21.55,4,12,0.333,3,6,0.5,2,2,1.0,1,1,2,1,1,0,3,0,13,5.9,-2.0,Josh Richardson,1,6,0.16666666666666666
5010,11/11/2022,29.156164383561645,W,0,23.166666666666668,2,10,0.2,1,6,0.167,2,2,1.0,0,2,2,0,0,1,1,1,7,0.7,14.0,Josh Richardson,1,4,0.25
5011,11/14/2022,29.164383561643834,L,0,25.166666666666668,3,12,0.25,1,6,0.167,3,4,0.75,1,4,5,3,1,0,1,2,10,5.6,-3.0,Josh Richardson,2,6,0.3333333333333333
5012,11/15/2022,29.167123287671235,L,0,24.216666666666665,2,7,0.286,0,4,0.0,0,0,,0,1,1,5,0,0,0,2,4,2.9,-17.0,Josh Richardson,2,3,0.6666666666666666
5013,11/17/2022,29.172602739726027,L,0,23.266666666666666,3,7,0.429,2,4,0.5,1,1,1.0,0,1,1,3,2,0,2,2,9,6.9,-6.0,Josh Richardson,1,3,0.3333333333333333
5014,11/19/2022,29.17808219178082,L,0,18.366666666666667,3,7,0.429,0,3,0.0,0,0,,2,2,4,3,0,0,1,1,6,5.0,-13.0,Josh Richardson,3,4,0.75
5015,11/20/2022,29.18082191780822,L,0,18.5,4,10,0.4,2,3,0.667,0,0,,1,0,1,2,1,0,0,0,10,7.7,-10.0,Josh Richardson,2,7,0.2857142857142857
5016,10/19/2022,22.156164383561645,L,1,28.583333333333332,3,15,0.2,0,8,0.0,5,8,0.625,1,1,2,4,1,0,2,1,11,2.9,-22.0,Devin Vassell,3,7,0.42857142857142855
5017,10/21/2022,22.161643835616438,W,1,33.75,7,15,0.467,4,7,0.571,5,6,0.833,0,5,5,4,2,0,0,1,23,20.8,-9.0,Devin Vassell,3,8,0.375
5018,10/22/2022,22.164383561643834,W,1,34.21666666666667,9,14,0.643,4,8,0.5,0,0,,0,4,4,3,1,0,1,1,22,18.7,0.0,Devin Vassell,5,6,0.8333333333333334
5019,10/24/2022,22.16986301369863,W,1,33.233333333333334,8,22,0.364,5,10,0.5,2,2,1.0,0,9,9,7,1,0,1,2,23,17.6,16.0,Devin Vassell,3,12,0.25
5020,11/4/2022,22.2,L,0,25.216666666666665,12,16,0.75,4,5,0.8,1,1,1.0,0,2,2,2,0,0,2,2,29,21.8,2.0,Devin Vassell,8,11,0.7272727272727273
5021,11/5/2022,22.202739726027396,L,0,24.683333333333334,7,12,0.583,4,6,0.667,2,3,0.667,0,4,4,4,1,1,1,1,20,18.3,-21.0,Devin Vassell,3,6,0.5
5022,11/7/2022,22.208219178082192,L,1,34.11666666666667,6,17,0.353,3,8,0.375,2,3,0.667,0,3,3,4,2,0,3,0,17,9.8,-4.0,Devin Vassell,3,9,0.3333333333333333
5023,11/9/2022,22.213698630136985,L,1,39.1,9,21,0.429,4,10,0.4,0,0,,0,3,3,6,0,1,1,1,22,15.3,0.0,Devin Vassell,5,11,0.45454545454545453
5024,11/11/2022,22.21917808219178,W,1,31.3,9,17,0.529,2,7,0.286,2,2,1.0,0,5,5,0,0,1,1,1,22,14.5,22.0,Devin Vassell,7,10,0.7
5025,11/14/2022,22.22739726027397,L,1,25.083333333333332,3,11,0.273,0,4,0.0,0,0,,0,4,4,1,0,1,1,1,6,0.7,-32.0,Devin Vassell,3,7,0.42857142857142855
5026,11/15/2022,22.23013698630137,L,1,35.2,7,15,0.467,4,8,0.5,3,3,1.0,0,2,2,2,1,1,4,3,21,11.8,-5.0,Devin Vassell,3,7,0.42857142857142855
5027,11/17/2022,22.235616438356164,L,1,36.233333333333334,11,19,0.579,4,9,0.444,3,5,0.6,0,3,3,3,1,1,2,1,29,21.6,-14.0,Devin Vassell,7,10,0.7
5028,11/20/2022,22.243835616438357,L,1,29.233333333333334,7,14,0.5,3,4,0.75,0,1,0.0,0,4,4,4,0,1,0,1,17,13.9,-14.0,Devin Vassell,4,10,0.4
5029,11/23/2022,22.252054794520546,L,1,31.65,10,17,0.588,4,8,0.5,2,3,0.667,0,4,4,8,1,0,2,3,26,22.3,-18.0,Devin Vassell,6,9,0.6666666666666666
5030,11/25/2022,22.257534246575343,L,1,35.96666666666667,7,22,0.318,0,6,0.0,4,4,1.0,1,5,6,3,1,0,1,2,18,8.9,-8.0,Devin Vassell,7,16,0.4375
5031,11/26/2022,22.26027397260274,L,1,37.86666666666667,6,16,0.375,4,9,0.444,4,4,1.0,0,4,4,3,1,0,3,4,20,10.9,13.0,Devin Vassell,2,7,0.2857142857142857
5032,10/19/2022,24.706849315068492,L,0,8.8,2,2,1.0,0,0,,1,1,1.0,0,2,2,0,1,1,0,0,5,6.7,3.0,Isaiah Roby,2,2,1.0
5033,10/22/2022,24.715068493150685,W,0,13.8,1,2,0.5,0,0,,0,0,,2,2,4,2,1,1,0,2,2,5.3,7.0,Isaiah Roby,1,2,0.5
5034,10/24/2022,24.720547945205478,W,0,12.783333333333333,2,6,0.333,2,4,0.5,0,2,0.0,1,1,2,4,2,0,1,2,6,5.8,7.0,Isaiah Roby,0,2,0.0
5035,10/26/2022,24.726027397260275,L,0,10.45,1,3,0.333,0,1,0.0,0,0,,0,3,3,0,0,0,1,0,2,0.2,-9.0,Isaiah Roby,1,2,0.5
5036,10/28/2022,24.731506849315068,W,0,5.983333333333333,0,1,0.0,0,1,0.0,0,0,,0,1,1,0,1,0,0,0,0,0.6,-5.0,Isaiah Roby,0,0,
5037,11/5/2022,24.753424657534246,L,0,16.166666666666668,3,7,0.429,0,1,0.0,1,3,0.333,0,4,4,3,0,0,0,0,7,5.8,-5.0,Isaiah Roby,3,6,0.5
5038,11/7/2022,24.75890410958904,L,0,2.2333333333333334,0,0,,0,0,,0,0,,0,0,0,0,0,0,0,1,0,-0.4,-6.0,Isaiah Roby,0,0,
5039,11/11/2022,24.76986301369863,W,0,1.65,0,0,,0,0,,0,0,,0,0,0,0,0,0,0,0,0,0.0,0.0,Isaiah Roby,0,0,
5040,11/14/2022,24.778082191780822,L,0,24.15,3,9,0.333,1,4,0.25,2,4,0.5,0,4,4,3,0,1,1,2,9,5.3,-17.0,Isaiah Roby,2,5,0.4
5041,11/15/2022,24.78082191780822,L,0,5.6,2,4,0.5,0,1,0.0,0,1,0.0,1,0,1,0,0,0,1,1,4,0.9,-6.0,Isaiah Roby,2,3,0.6666666666666666
5042,11/17/2022,24.786301369863015,L,0,22.383333333333333,4,7,0.571,3,3,1.0,0,0,,0,2,2,3,0,2,0,3,11,10.6,-6.0,Isaiah Roby,1,4,0.25
5043,11/19/2022,24.791780821917808,L,0,21.283333333333335,2,6,0.333,1,5,0.2,3,3,1.0,0,4,4,1,1,0,1,2,8,5.7,-17.0,Isaiah Roby,1,1,1.0
5044,11/20/2022,24.794520547945204,L,0,14.666666666666666,1,2,0.5,0,0,,0,0,,1,6,7,3,0,0,0,2,2,4.8,-1.0,Isaiah Roby,1,2,0.5
5045,11/23/2022,24.802739726027397,L,0,15.9,3,4,0.75,1,1,1.0,1,2,0.5,1,2,3,1,0,0,0,1,8,7.6,9.0,Isaiah Roby,2,3,0.6666666666666666
5046,11/25/2022,24.80821917808219,L,0,11.55,2,5,0.4,1,2,0.5,0,0,,0,1,1,0,0,0,1,1,5,1.2,3.0,Isaiah Roby,1,3,0.3333333333333333
5047,11/26/2022,24.81095890410959,L,0,16.116666666666667,4,6,0.667,2,3,0.667,0,2,0.0,0,1,1,0,0,0,1,6,10,3.5,-14.0,Isaiah Roby,2,3,0.6666666666666666
5048,11/2/2022,22.013698630136986,L,0,12.0,3,5,0.6,1,2,0.5,2,2,1.0,1,3,4,0,0,2,0,1,9,9.3,-9.0,Charles Bassey,2,3,0.6666666666666666
5049,11/7/2022,22.027397260273972,L,0,15.7,1,3,0.333,0,0,,1,2,0.5,3,5,8,1,1,1,1,3,3,4.7,6.0,Charles Bassey,1,3,0.3333333333333333
5050,11/9/2022,22.03287671232877,L,0,16.0,4,5,0.8,0,1,0.0,2,2,1.0,1,5,6,2,2,1,0,4,10,12.8,8.0,Charles Bassey,4,4,1.0
5051,11/11/2022,22.03835616438356,W,0,18.216666666666665,2,3,0.667,1,2,0.5,0,0,,3,11,14,4,0,4,3,4,5,10.1,9.0,Charles Bassey,1,1,1.0
5052,11/14/2022,22.046575342465754,L,0,23.816666666666666,3,5,0.6,0,0,,0,0,,6,1,7,3,0,2,3,2,6,7.9,-27.0,Charles Bassey,3,5,0.6
5053,11/15/2022,22.04931506849315,L,0,16.333333333333332,3,4,0.75,0,0,,0,0,,2,3,5,1,0,1,3,5,6,3.1,-14.0,Charles Bassey,3,4,0.75
5054,11/17/2022,22.054794520547944,L,0,11.383333333333333,2,2,1.0,0,0,,0,0,,1,1,2,2,1,0,4,2,4,2.0,1.0,Charles Bassey,2,2,1.0
5055,11/19/2022,22.06027397260274,L,0,22.933333333333334,2,6,0.333,0,1,0.0,2,4,0.5,2,7,9,0,0,0,3,1,6,1.9,-6.0,Charles Bassey,2,5,0.4
5056,11/20/2022,22.063013698630137,L,0,20.933333333333334,4,5,0.8,0,0,,0,2,0.0,2,6,8,5,1,0,1,2,8,11.2,-15.0,Charles Bassey,4,5,0.8
5057,11/23/2022,22.07123287671233,L,0,11.966666666666667,1,1,1.0,0,0,,1,2,0.5,0,3,3,1,0,1,0,2,3,3.8,3.0,Charles Bassey,1,1,1.0
5058,11/25/2022,22.076712328767123,L,0,1.6166666666666667,1,1,1.0,0,0,,0,0,,0,1,1,0,0,0,0,1,2,1.6,2.0,Charles Bassey,1,1,1.0
5059,11/26/2022,22.07945205479452,L,0,2.216666666666667,0,1,0.0,0,0,,0,0,,1,0,1,0,0,0,0,0,0,0.0,-2.0,Charles Bassey,0,1,0.0
5060,10/19/2022,24.915068493150685,L,0,12.216666666666667,0,3,0.0,0,2,0.0,1,2,0.5,0,0,0,1,1,4,2,3,1,-0.2,-20.0,Zach Collins,0,1,0.0
5061,10/21/2022,24.92054794520548,W,0,18.45,5,8,0.625,1,1,1.0,0,0,,2,2,4,3,1,3,2,3,11,11.4,-4.0,Zach Collins,4,7,0.5714285714285714
5062,10/22/2022,24.923287671232877,W,0,8.283333333333333,1,1,1.0,1,1,1.0,0,0,,1,2,3,1,0,0,1,1,3,3.3,-6.0,Zach Collins,0,0,
5063,10/24/2022,24.92876712328767,W,0,17.05,5,9,0.556,0,2,0.0,1,1,1.0,1,3,4,5,0,0,1,4,11,9.2,11.0,Zach Collins,5,7,0.7142857142857143
5064,10/26/2022,24.934246575342467,L,0,16.983333333333334,2,4,0.5,1,2,0.5,2,2,1.0,2,2,4,5,1,0,3,3,7,7.3,-14.0,Zach Collins,1,2,0.5
5065,10/28/2022,24.93972602739726,W,0,17.816666666666666,7,9,0.778,2,3,0.667,0,1,0.0,2,4,6,3,0,1,2,3,16,14.3,-4.0,Zach Collins,5,6,0.8333333333333334
5066,10/30/2022,24.945205479452056,W,0,22.733333333333334,4,8,0.5,1,2,0.5,0,1,0.0,2,4,6,2,1,1,2,5,9,6.3,21.0,Zach Collins,3,6,0.5
5067,11/2/2022,24.953424657534246,L,0,24.316666666666666,3,10,0.3,0,3,0.0,2,2,1.0,2,6,8,3,1,1,1,3,8,7.0,-17.0,Zach Collins,3,7,0.42857142857142855
5068,11/4/2022,24.958904109589042,L,0,21.133333333333333,4,7,0.571,1,2,0.5,0,0,,0,7,7,2,1,1,3,2,9,7.1,16.0,Zach Collins,3,5,0.6
5069,11/25/2022,25.016438356164382,L,0,21.166666666666668,2,6,0.333,0,3,0.0,0,0,,2,5,7,0,1,1,2,3,4,2.0,-7.0,Zach Collins,2,3,0.6666666666666666
5070,11/26/2022,25.019178082191782,L,0,18.833333333333332,4,6,0.667,2,3,0.667,2,2,1.0,4,4,8,2,1,2,1,3,12,15.0,-10.0,Zach Collins,2,3,0.6666666666666666
5071,10/19/2022,22.983561643835618,L,0,8.8,2,5,0.4,0,0,,0,0,,0,0,0,0,0,0,0,0,4,1.3,3.0,Romeo Langford,2,5,0.4
5072,10/24/2022,22.997260273972604,W,0,0.43333333333333335,0,0,,0,0,,0,0,,0,0,0,0,0,0,0,0,0,0.0,-2.0,Romeo Langford,0,0,
5073,10/26/2022,23.002739726027396,L,0,16.166666666666668,2,4,0.5,0,0,,0,0,,1,0,1,1,0,0,1,1,4,2.0,-16.0,Romeo Langford,2,4,0.5
5074,10/30/2022,23.013698630136986,W,1,34.28333333333333,3,7,0.429,0,2,0.0,1,2,0.5,4,3,7,1,2,1,1,1,7,8.6,-9.0,Romeo Langford,3,5,0.6
5075,11/2/2022,23.02191780821918,L,1,15.75,2,6,0.333,1,3,0.333,0,0,,2,1,3,0,0,0,1,4,5,0.7,-24.0,Romeo Langford,1,3,0.3333333333333333
5076,11/9/2022,23.041095890410958,L,0,20.916666666666668,2,4,0.5,0,1,0.0,2,2,1.0,2,0,2,1,0,0,0,1,6,5.7,3.0,Romeo Langford,2,3,0.6666666666666666
5077,11/11/2022,23.046575342465754,W,0,17.316666666666666,2,5,0.4,0,1,0.0,0,0,,1,0,1,0,1,1,2,3,4,0.5,-7.0,Romeo Langford,2,4,0.5
5078,11/23/2022,23.07945205479452,L,0,23.166666666666668,1,7,0.143,0,3,0.0,1,2,0.5,1,1,2,1,2,0,3,2,3,-2.0,-6.0,Romeo Langford,1,4,0.25
5079,11/25/2022,23.084931506849315,L,0,21.516666666666666,2,6,0.333,0,3,0.0,1,2,0.5,3,1,4,0,1,1,0,0,5,5.3,-9.0,Romeo Langford,2,3,0.6666666666666666
5080,11/26/2022,23.087671232876712,L,0,25.6,3,3,1.0,1,1,1.0,0,0,,2,1,3,4,1,1,1,4,7,9.7,-6.0,Romeo Langford,2,2,1.0
5081,10/19/2022,32.75068493150685,L,0,8.8,2,3,0.667,1,2,0.5,0,0,,1,2,3,1,0,0,0,1,5,5.3,3.0,Gorgui Dieng,1,1,1.0
5082,10/22/2022,32.75890410958904,W,0,12.683333333333334,1,4,0.25,0,3,0.0,0,0,,0,1,1,5,0,2,0,3,2,3.6,15.0,Gorgui Dieng,1,1,1.0
5083,10/26/2022,32.76986301369863,L,0,1.9166666666666665,0,0,,0,0,,0,0,,1,0,1,2,0,0,0,1,0,1.7,2.0,Gorgui Dieng,0,0,
5084,10/30/2022,32.78082191780822,W,0,4.316666666666666,0,1,0.0,0,1,0.0,0,0,,2,2,4,0,0,0,0,0,0,1.3,-1.0,Gorgui Dieng,0,0,
5085,11/2/2022,32.78904109589041,L,0,16.6,3,6,0.5,3,6,0.5,0,0,,0,2,2,2,0,2,4,3,9,4.2,-16.0,Gorgui Dieng,0,0,
5086,11/5/2022,32.797260273972604,L,0,10.333333333333334,2,3,0.667,1,2,0.5,0,0,,0,1,1,1,1,0,3,1,5,2.3,-4.0,Gorgui Dieng,1,1,1.0
5087,11/14/2022,32.821917808219176,L,0,8.966666666666667,1,4,0.25,1,3,0.333,3,4,0.75,2,1,3,1,0,0,0,0,6,5.6,1.0,Gorgui Dieng,0,1,0.0
5088,11/17/2022,32.83013698630137,L,0,11.633333333333333,1,3,0.333,0,2,0.0,0,0,,0,3,3,1,0,1,0,2,2,1.8,-11.0,Gorgui Dieng,1,1,1.0
5089,11/20/2022,32.83835616438356,L,1,21.416666666666668,3,6,0.5,1,3,0.333,0,0,,3,4,7,3,0,0,0,5,7,7.4,-10.0,Gorgui Dieng,2,3,0.6666666666666666
5090,11/23/2022,32.846575342465755,L,0,6.75,1,2,0.5,0,1,0.0,0,0,,0,2,2,2,0,0,1,1,2,1.6,5.0,Gorgui Dieng,1,1,1.0
5091,11/2/2022,20.8,L,0,20.85,1,4,0.25,1,3,0.333,0,0,,0,1,1,2,0,0,2,0,3,0.3,-16.0,Jordan Hall,0,1,0.0
5092,11/5/2022,20.80821917808219,L,0,4.816666666666666,0,1,0.0,0,1,0.0,0,0,,0,0,0,0,0,0,0,1,0,-1.1,0.0,Jordan Hall,0,0,
5093,11/11/2022,20.824657534246576,W,0,1.65,0,0,,0,0,,0,0,,0,0,0,1,0,0,0,0,0,0.7,0.0,Jordan Hall,0,0,
5094,11/14/2022,20.832876712328765,L,0,16.05,3,7,0.429,0,2,0.0,0,0,,1,2,3,3,1,0,2,3,6,3.5,-9.0,Jordan Hall,3,5,0.6
5095,11/17/2022,20.84109589041096,L,0,15.683333333333334,1,3,0.333,1,2,0.5,2,2,1.0,2,3,5,2,0,0,2,2,5,4.2,-3.0,Jordan Hall,0,1,0.0
5096,11/19/2022,20.846575342465755,L,0,9.6,0,3,0.0,0,2,0.0,5,6,0.833,0,1,1,1,0,0,1,0,5,2.5,4.0,Jordan Hall,0,1,0.0
5097,11/20/2022,20.84931506849315,L,0,5.65,1,5,0.2,0,3,0.0,0,0,,0,2,2,1,0,0,0,0,2,0.2,-7.0,Jordan Hall,1,2,0.5
5098,11/23/2022,20.85753424657534,L,0,6.75,3,4,0.75,1,1,1.0,0,1,0.0,0,0,0,1,0,0,0,0,7,5.7,5.0,Jordan Hall,2,3,0.6666666666666666
5099,11/25/2022,20.863013698630137,L,0,1.6166666666666667,0,1,0.0,0,1,0.0,0,0,,0,0,0,0,0,0,0,0,0,-0.7,2.0,Jordan Hall,0,0,
5100,10/30/2022,19.46849315068493,W,0,19.0,1,7,0.143,1,4,0.25,2,2,1.0,1,1,2,2,0,0,0,1,5,2.5,2.0,Malaki Branham,0,3,0.0
5101,11/2/2022,19.476712328767125,L,0,22.7,4,11,0.364,2,6,0.333,3,4,0.75,1,1,2,3,0,0,1,1,13,8.2,-11.0,Malaki Branham,2,5,0.4
5102,11/4/2022,19.482191780821918,L,1,13.916666666666666,1,3,0.333,0,1,0.0,0,0,,0,3,3,1,0,0,0,1,2,1.5,1.0,Malaki Branham,1,2,0.5
5103,11/5/2022,19.484931506849314,L,1,22.616666666666667,2,7,0.286,0,4,0.0,0,0,,0,2,2,2,1,0,2,0,4,0.9,-7.0,Malaki Branham,2,3,0.6666666666666666
5104,11/19/2022,19.523287671232875,L,0,9.6,1,2,0.5,1,2,0.5,0,0,,0,1,1,1,0,0,0,1,3,2.6,4.0,Malaki Branham,0,0,
5105,11/20/2022,19.526027397260275,L,0,5.65,0,4,0.0,0,3,0.0,0,0,,0,0,0,0,0,0,2,0,0,-4.8,-7.0,Malaki Branham,0,1,0.0
5106,11/25/2022,19.53972602739726,L,0,13.7,1,3,0.333,1,2,0.5,0,0,,0,2,2,1,0,0,1,0,3,1.6,7.0,Malaki Branham,0,1,0.0
5107,11/26/2022,19.542465753424658,L,0,16.95,3,4,0.75,2,3,0.667,0,0,,0,1,1,2,0,0,1,1,8,6.7,-12.0,Malaki Branham,1,1,1.0
5108,11/2/2022,19.438356164383563,L,0,9.866666666666667,1,3,0.333,0,2,0.0,0,0,,0,1,1,3,0,0,0,2,2,1.9,-6.0,Dominick Barlow,1,1,1.0
5109,11/19/2022,19.484931506849314,L,0,6.816666666666666,1,1,1.0,0,0,,4,4,1.0,1,0,1,0,0,0,0,0,6,6.4,5.0,Dominick Barlow,1,1,1.0
5110,11/20/2022,19.487671232876714,L,0,5.65,0,2,0.0,0,1,0.0,0,0,,1,0,1,0,1,0,0,1,0,-0.1,-7.0,Dominick Barlow,0,1,0.0
5111,10/28/2022,19.61917808219178,W,0,15.25,4,6,0.667,2,3,0.667,0,0,,0,0,0,4,0,0,1,3,10,8.0,-18.0,Blake Wesley,2,3,0.6666666666666666
5112,10/30/2022,19.624657534246577,W,0,8.233333333333333,2,3,0.667,0,0,,2,4,0.5,1,1,2,0,0,0,1,0,6,3.9,8.0,Blake Wesley,2,3,0.6666666666666666
5113,10/19/2022,20.69041095890411,L,1,32.21666666666667,7,20,0.35,1,7,0.143,1,1,1.0,1,4,5,3,1,1,3,3,16,6.3,-16.0,Jalen Green,6,13,0.46153846153846156
5114,10/21/2022,20.695890410958903,L,1,35.166666666666664,13,21,0.619,4,5,0.8,3,4,0.75,0,5,5,2,1,0,2,1,33,24.6,-12.0,Jalen Green,9,16,0.5625
5115,10/22/2022,20.698630136986303,L,1,31.65,6,19,0.316,4,7,0.571,6,6,1.0,1,3,4,2,1,0,2,3,22,11.9,-5.0,Jalen Green,2,12,0.16666666666666666
5116,10/24/2022,20.704109589041096,W,1,35.75,9,16,0.563,4,8,0.5,3,3,1.0,2,1,3,3,0,0,3,1,25,17.8,-1.0,Jalen Green,5,8,0.625
5117,10/26/2022,20.70958904109589,L,1,36.06666666666667,6,20,0.3,2,9,0.222,3,4,0.75,2,5,7,2,1,1,2,2,17,8.2,-19.0,Jalen Green,4,11,0.36363636363636365
5118,10/28/2022,20.715068493150685,L,1,31.5,4,19,0.211,2,10,0.2,1,2,0.5,0,6,6,2,1,0,1,1,11,1.7,-19.0,Jalen Green,2,9,0.2222222222222222
5119,10/30/2022,20.720547945205478,L,1,31.1,5,18,0.278,2,7,0.286,3,4,0.75,0,1,1,2,1,0,1,0,15,5.7,-7.0,Jalen Green,3,11,0.2727272727272727
5120,10/31/2022,20.723287671232878,L,1,36.166666666666664,4,17,0.235,1,5,0.2,4,7,0.571,0,4,4,1,1,1,1,2,13,3.3,1.0,Jalen Green,3,12,0.25
5121,11/2/2022,20.72876712328767,L,1,30.033333333333335,9,17,0.529,3,8,0.375,1,1,1.0,0,4,4,1,1,0,3,3,22,12.4,-13.0,Jalen Green,6,9,0.6666666666666666
5122,11/5/2022,20.736986301369864,L,1,29.2,6,16,0.375,4,11,0.364,5,7,0.714,1,1,2,4,0,0,5,1,21,9.8,-16.0,Jalen Green,2,5,0.4
5123,11/7/2022,20.742465753424657,W,1,37.916666666666664,12,18,0.667,5,11,0.455,5,7,0.714,0,3,3,3,2,1,3,3,34,26.9,13.0,Jalen Green,7,7,1.0
5124,11/9/2022,20.747945205479454,L,1,40.45,8,14,0.571,2,6,0.333,3,4,0.75,1,5,6,6,0,0,4,1,21,16.0,-8.0,Jalen Green,6,8,0.75
5125,11/12/2022,20.756164383561643,L,1,38.21666666666667,11,20,0.55,5,10,0.5,6,6,1.0,0,2,2,6,0,0,5,0,33,23.2,-12.0,Jalen Green,6,10,0.6
5126,11/14/2022,20.76164383561644,L,1,35.36666666666667,10,19,0.526,3,8,0.375,2,2,1.0,0,6,6,7,1,0,3,0,25,20.4,-16.0,Jalen Green,7,11,0.6363636363636364
5127,11/16/2022,20.767123287671232,W,1,35.93333333333333,5,15,0.333,1,4,0.25,6,7,0.857,1,6,7,6,0,1,5,2,17,9.7,9.0,Jalen Green,4,11,0.36363636363636365
5128,11/18/2022,20.77260273972603,L,1,31.666666666666668,2,10,0.2,0,4,0.0,12,15,0.8,0,5,5,5,2,0,6,4,16,8.0,0.0,Jalen Green,2,6,0.3333333333333333
5129,11/20/2022,20.778082191780822,L,1,37.9,4,15,0.267,1,8,0.125,7,8,0.875,2,3,5,4,2,0,0,1,16,13.4,-24.0,Jalen Green,3,7,0.42857142857142855
5130,11/25/2022,20.791780821917808,W,1,32.93333333333333,10,17,0.588,3,9,0.333,7,9,0.778,0,5,5,5,0,0,6,6,30,17.9,6.0,Jalen Green,7,8,0.875
5131,11/26/2022,20.794520547945204,W,1,34.36666666666667,11,19,0.579,6,9,0.667,0,0,,0,2,2,9,0,0,4,1,28,21.6,17.0,Jalen Green,5,10,0.5
5132,10/19/2022,21.783561643835615,L,0,22.7,1,7,0.143,0,2,0.0,4,4,1.0,0,5,5,0,1,0,1,4,6,1.4,-10.0,Kenyon Martin Jr.,1,5,0.2
5133,10/21/2022,21.78904109589041,L,0,24.783333333333335,3,5,0.6,1,2,0.5,1,2,0.5,1,4,5,3,1,1,3,2,8,7.2,12.0,Kenyon Martin Jr.,2,3,0.6666666666666666
5134,10/22/2022,21.791780821917808,L,1,29.883333333333333,6,11,0.545,2,5,0.4,0,1,0.0,2,3,5,2,0,0,1,1,14,10.6,-5.0,Kenyon Martin Jr.,4,6,0.6666666666666666
5135,10/24/2022,21.797260273972604,W,1,34.266666666666666,1,9,0.111,1,6,0.167,0,0,,1,3,4,3,1,1,1,4,3,-0.1,-4.0,Kenyon Martin Jr.,0,3,0.0
5136,10/26/2022,21.802739726027397,L,0,24.9,3,9,0.333,0,2,0.0,5,7,0.714,2,8,10,3,0,0,1,4,11,8.4,4.0,Kenyon Martin Jr.,3,7,0.42857142857142855
5137,10/28/2022,21.80821917808219,L,0,16.616666666666667,4,6,0.667,1,1,1.0,2,2,1.0,1,3,4,0,0,0,0,0,11,10.0,-11.0,Kenyon Martin Jr.,3,5,0.6
5138,10/30/2022,21.813698630136987,L,0,24.083333333333332,4,6,0.667,0,1,0.0,0,0,,2,1,3,1,0,0,1,1,8,6.4,-2.0,Kenyon Martin Jr.,4,5,0.8
5139,10/31/2022,21.816438356164383,L,0,28.75,9,17,0.529,2,8,0.25,3,6,0.5,0,6,6,1,1,2,1,3,23,16.2,3.0,Kenyon Martin Jr.,7,9,0.7777777777777778
5140,11/2/2022,21.82191780821918,L,0,20.233333333333334,1,2,0.5,0,1,0.0,0,0,,0,3,3,1,1,0,1,2,2,1.8,-2.0,Kenyon Martin Jr.,1,1,1.0
5141,11/5/2022,21.83013698630137,L,1,31.3,6,8,0.75,3,5,0.6,2,3,0.667,1,2,3,1,1,0,2,1,17,14.0,-19.0,Kenyon Martin Jr.,3,3,1.0
5142,11/7/2022,21.835616438356166,W,0,25.85,8,14,0.571,4,8,0.5,1,2,0.5,2,2,4,5,0,2,1,2,21,19.1,14.0,Kenyon Martin Jr.,4,6,0.6666666666666666
5143,11/9/2022,21.84109589041096,L,0,22.566666666666666,5,6,0.833,2,3,0.667,1,2,0.5,2,4,6,0,0,2,0,3,13,13.2,18.0,Kenyon Martin Jr.,3,3,1.0
5144,11/12/2022,21.84931506849315,L,0,25.716666666666665,4,7,0.571,0,3,0.0,1,1,1.0,3,4,7,1,0,0,3,2,9,5.9,1.0,Kenyon Martin Jr.,4,4,1.0
5145,11/14/2022,21.854794520547944,L,0,20.6,4,7,0.571,0,2,0.0,0,0,,1,4,5,1,0,0,1,0,8,6.3,-8.0,Kenyon Martin Jr.,4,5,0.8
5146,11/16/2022,21.86027397260274,W,0,24.816666666666666,4,5,0.8,1,1,1.0,1,1,1.0,0,1,1,1,0,2,1,1,10,9.1,0.0,Kenyon Martin Jr.,3,4,0.75
5147,11/18/2022,21.865753424657534,L,1,26.266666666666666,5,9,0.556,0,2,0.0,2,4,0.5,4,4,8,1,1,0,2,4,12,9.0,6.0,Kenyon Martin Jr.,5,7,0.7142857142857143
5148,11/20/2022,21.87123287671233,L,0,23.65,4,6,0.667,1,2,0.5,3,4,0.75,0,4,4,1,1,0,0,0,12,11.9,12.0,Kenyon Martin Jr.,3,4,0.75
5149,11/25/2022,21.884931506849316,W,1,33.7,10,13,0.769,1,1,1.0,0,0,,5,10,15,2,1,0,5,3,21,18.6,8.0,Kenyon Martin Jr.,9,12,0.75
5150,11/26/2022,21.887671232876713,W,0,14.166666666666666,1,5,0.2,0,2,0.0,1,2,0.5,1,4,5,1,0,0,2,0,3,0.1,-1.0,Kenyon Martin Jr.,1,3,0.3333333333333333
5151,10/19/2022,21.443835616438356,L,0,15.1,4,6,0.667,0,0,,0,0,,3,4,7,0,0,0,0,1,8,8.3,-1.0,Tari Eason,4,6,0.6666666666666666
5152,10/21/2022,21.44931506849315,L,0,19.516666666666666,2,6,0.333,1,2,0.5,1,1,1.0,1,6,7,1,0,1,0,1,6,6.1,11.0,Tari Eason,1,4,0.25
5153,10/22/2022,21.45205479452055,L,0,18.816666666666666,4,9,0.444,3,4,0.75,0,0,,0,2,2,1,1,3,1,3,11,8.5,-7.0,Tari Eason,1,5,0.2
5154,10/24/2022,21.457534246575342,W,0,18.75,4,12,0.333,0,2,0.0,3,4,0.75,5,4,9,0,3,0,1,3,11,9.3,7.0,Tari Eason,4,10,0.4
5155,10/26/2022,21.463013698630135,L,0,23.166666666666668,1,7,0.143,1,4,0.25,0,0,,3,3,6,1,1,0,0,4,3,1.6,-11.0,Tari Eason,0,3,0.0
5156,10/28/2022,21.46849315068493,L,0,15.3,2,4,0.5,0,0,,0,0,,1,2,3,0,1,0,0,1,4,3.9,-1.0,Tari Eason,2,4,0.5
5157,10/30/2022,21.473972602739725,L,0,11.833333333333334,4,4,1.0,1,1,1.0,0,0,,2,0,2,1,1,0,1,4,9,8.3,-4.0,Tari Eason,3,3,1.0
5158,10/31/2022,21.476712328767125,L,0,11.833333333333334,2,7,0.286,0,1,0.0,2,2,1.0,1,0,1,0,1,0,1,1,6,2.2,-3.0,Tari Eason,2,6,0.3333333333333333
5159,11/2/2022,21.482191780821918,L,0,18.15,3,7,0.429,0,1,0.0,0,0,,3,4,7,2,1,3,2,2,6,7.3,-4.0,Tari Eason,3,6,0.5
5160,11/5/2022,21.49041095890411,L,0,23.983333333333334,6,8,0.75,2,2,1.0,3,5,0.6,3,3,6,2,1,0,1,3,17,16.2,2.0,Tari Eason,4,6,0.6666666666666666
5161,11/7/2022,21.495890410958904,W,0,19.716666666666665,3,7,0.429,2,3,0.667,0,0,,2,4,6,0,2,0,1,3,8,6.7,13.0,Tari Eason,1,4,0.25
5162,11/9/2022,21.5013698630137,L,0,21.416666666666668,5,15,0.333,0,2,0.0,4,5,0.8,4,2,6,5,5,0,2,2,14,14.2,9.0,Tari Eason,5,13,0.38461538461538464
5163,11/12/2022,21.50958904109589,L,0,21.05,1,4,0.25,1,3,0.333,2,2,1.0,0,2,2,3,3,0,1,3,5,6.1,6.0,Tari Eason,0,1,0.0
5164,11/14/2022,21.515068493150686,L,0,14.733333333333333,4,7,0.571,1,3,0.333,0,0,,2,1,3,0,2,0,0,1,9,9.0,-7.0,Tari Eason,3,4,0.75
5165,11/16/2022,21.52054794520548,W,0,17.866666666666667,3,5,0.6,0,1,0.0,2,2,1.0,1,6,7,0,0,1,2,3,8,5.7,12.0,Tari Eason,3,4,0.75
5166,11/18/2022,21.526027397260275,L,0,18.883333333333333,1,9,0.111,0,1,0.0,2,2,1.0,3,3,6,0,0,0,2,2,4,-1.7,-12.0,Tari Eason,1,8,0.125
5167,11/20/2022,21.53150684931507,L,0,22.666666666666668,8,14,0.571,1,5,0.2,2,2,1.0,2,6,8,1,3,0,0,1,19,18.9,6.0,Tari Eason,7,9,0.7777777777777778
5168,11/25/2022,21.545205479452054,W,0,18.5,2,9,0.222,0,1,0.0,2,2,1.0,4,3,7,0,1,0,0,2,6,4.4,4.0,Tari Eason,2,8,0.25
5169,11/26/2022,21.54794520547945,W,0,16.583333333333332,3,8,0.375,1,1,1.0,0,0,,1,5,6,0,2,0,2,2,7,4.0,-10.0,Tari Eason,2,7,0.2857142857142857
5170,10/19/2022,20.69041095890411,L,1,32.21666666666667,7,20,0.35,1,7,0.143,1,1,1.0,1,4,5,3,1,1,3,3,16,6.3,-16.0,Jalen Green,6,13,0.46153846153846156
5171,10/21/2022,20.695890410958903,L,1,35.166666666666664,13,21,0.619,4,5,0.8,3,4,0.75,0,5,5,2,1,0,2,1,33,24.6,-12.0,Jalen Green,9,16,0.5625
5172,10/22/2022,20.698630136986303,L,1,31.65,6,19,0.316,4,7,0.571,6,6,1.0,1,3,4,2,1,0,2,3,22,11.9,-5.0,Jalen Green,2,12,0.16666666666666666
5173,10/24/2022,20.704109589041096,W,1,35.75,9,16,0.563,4,8,0.5,3,3,1.0,2,1,3,3,0,0,3,1,25,17.8,-1.0,Jalen Green,5,8,0.625
5174,10/26/2022,20.70958904109589,L,1,36.06666666666667,6,20,0.3,2,9,0.222,3,4,0.75,2,5,7,2,1,1,2,2,17,8.2,-19.0,Jalen Green,4,11,0.36363636363636365
5175,10/28/2022,20.715068493150685,L,1,31.5,4,19,0.211,2,10,0.2,1,2,0.5,0,6,6,2,1,0,1,1,11,1.7,-19.0,Jalen Green,2,9,0.2222222222222222
5176,10/30/2022,20.720547945205478,L,1,31.1,5,18,0.278,2,7,0.286,3,4,0.75,0,1,1,2,1,0,1,0,15,5.7,-7.0,Jalen Green,3,11,0.2727272727272727
5177,10/31/2022,20.723287671232878,L,1,36.166666666666664,4,17,0.235,1,5,0.2,4,7,0.571,0,4,4,1,1,1,1,2,13,3.3,1.0,Jalen Green,3,12,0.25
5178,11/2/2022,20.72876712328767,L,1,30.033333333333335,9,17,0.529,3,8,0.375,1,1,1.0,0,4,4,1,1,0,3,3,22,12.4,-13.0,Jalen Green,6,9,0.6666666666666666
5179,11/5/2022,20.736986301369864,L,1,29.2,6,16,0.375,4,11,0.364,5,7,0.714,1,1,2,4,0,0,5,1,21,9.8,-16.0,Jalen Green,2,5,0.4
5180,11/7/2022,20.742465753424657,W,1,37.916666666666664,12,18,0.667,5,11,0.455,5,7,0.714,0,3,3,3,2,1,3,3,34,26.9,13.0,Jalen Green,7,7,1.0
5181,11/9/2022,20.747945205479454,L,1,40.45,8,14,0.571,2,6,0.333,3,4,0.75,1,5,6,6,0,0,4,1,21,16.0,-8.0,Jalen Green,6,8,0.75
5182,11/12/2022,20.756164383561643,L,1,38.21666666666667,11,20,0.55,5,10,0.5,6,6,1.0,0,2,2,6,0,0,5,0,33,23.2,-12.0,Jalen Green,6,10,0.6
5183,11/14/2022,20.76164383561644,L,1,35.36666666666667,10,19,0.526,3,8,0.375,2,2,1.0,0,6,6,7,1,0,3,0,25,20.4,-16.0,Jalen Green,7,11,0.6363636363636364
5184,11/16/2022,20.767123287671232,W,1,35.93333333333333,5,15,0.333,1,4,0.25,6,7,0.857,1,6,7,6,0,1,5,2,17,9.7,9.0,Jalen Green,4,11,0.36363636363636365
5185,11/18/2022,20.77260273972603,L,1,31.666666666666668,2,10,0.2,0,4,0.0,12,15,0.8,0,5,5,5,2,0,6,4,16,8.0,0.0,Jalen Green,2,6,0.3333333333333333
5186,11/20/2022,20.778082191780822,L,1,37.9,4,15,0.267,1,8,0.125,7,8,0.875,2,3,5,4,2,0,0,1,16,13.4,-24.0,Jalen Green,3,7,0.42857142857142855
5187,11/25/2022,20.791780821917808,W,1,32.93333333333333,10,17,0.588,3,9,0.333,7,9,0.778,0,5,5,5,0,0,6,6,30,17.9,6.0,Jalen Green,7,8,0.875
5188,11/26/2022,20.794520547945204,W,1,34.36666666666667,11,19,0.579,6,9,0.667,0,0,,0,2,2,9,0,0,4,1,28,21.6,17.0,Jalen Green,5,10,0.5
5189,10/19/2022,21.783561643835615,L,0,22.7,1,7,0.143,0,2,0.0,4,4,1.0,0,5,5,0,1,0,1,4,6,1.4,-10.0,Kenyon Martin Jr.,1,5,0.2
5190,10/21/2022,21.78904109589041,L,0,24.783333333333335,3,5,0.6,1,2,0.5,1,2,0.5,1,4,5,3,1,1,3,2,8,7.2,12.0,Kenyon Martin Jr.,2,3,0.6666666666666666
5191,10/22/2022,21.791780821917808,L,1,29.883333333333333,6,11,0.545,2,5,0.4,0,1,0.0,2,3,5,2,0,0,1,1,14,10.6,-5.0,Kenyon Martin Jr.,4,6,0.6666666666666666
5192,10/24/2022,21.797260273972604,W,1,34.266666666666666,1,9,0.111,1,6,0.167,0,0,,1,3,4,3,1,1,1,4,3,-0.1,-4.0,Kenyon Martin Jr.,0,3,0.0
5193,10/26/2022,21.802739726027397,L,0,24.9,3,9,0.333,0,2,0.0,5,7,0.714,2,8,10,3,0,0,1,4,11,8.4,4.0,Kenyon Martin Jr.,3,7,0.42857142857142855
5194,10/28/2022,21.80821917808219,L,0,16.616666666666667,4,6,0.667,1,1,1.0,2,2,1.0,1,3,4,0,0,0,0,0,11,10.0,-11.0,Kenyon Martin Jr.,3,5,0.6
5195,10/30/2022,21.813698630136987,L,0,24.083333333333332,4,6,0.667,0,1,0.0,0,0,,2,1,3,1,0,0,1,1,8,6.4,-2.0,Kenyon Martin Jr.,4,5,0.8
5196,10/31/2022,21.816438356164383,L,0,28.75,9,17,0.529,2,8,0.25,3,6,0.5,0,6,6,1,1,2,1,3,23,16.2,3.0,Kenyon Martin Jr.,7,9,0.7777777777777778
5197,11/2/2022,21.82191780821918,L,0,20.233333333333334,1,2,0.5,0,1,0.0,0,0,,0,3,3,1,1,0,1,2,2,1.8,-2.0,Kenyon Martin Jr.,1,1,1.0
5198,11/5/2022,21.83013698630137,L,1,31.3,6,8,0.75,3,5,0.6,2,3,0.667,1,2,3,1,1,0,2,1,17,14.0,-19.0,Kenyon Martin Jr.,3,3,1.0
5199,11/7/2022,21.835616438356166,W,0,25.85,8,14,0.571,4,8,0.5,1,2,0.5,2,2,4,5,0,2,1,2,21,19.1,14.0,Kenyon Martin Jr.,4,6,0.6666666666666666
5200,11/9/2022,21.84109589041096,L,0,22.566666666666666,5,6,0.833,2,3,0.667,1,2,0.5,2,4,6,0,0,2,0,3,13,13.2,18.0,Kenyon Martin Jr.,3,3,1.0
5201,11/12/2022,21.84931506849315,L,0,25.716666666666665,4,7,0.571,0,3,0.0,1,1,1.0,3,4,7,1,0,0,3,2,9,5.9,1.0,Kenyon Martin Jr.,4,4,1.0
5202,11/14/2022,21.854794520547944,L,0,20.6,4,7,0.571,0,2,0.0,0,0,,1,4,5,1,0,0,1,0,8,6.3,-8.0,Kenyon Martin Jr.,4,5,0.8
5203,11/16/2022,21.86027397260274,W,0,24.816666666666666,4,5,0.8,1,1,1.0,1,1,1.0,0,1,1,1,0,2,1,1,10,9.1,0.0,Kenyon Martin Jr.,3,4,0.75
5204,11/18/2022,21.865753424657534,L,1,26.266666666666666,5,9,0.556,0,2,0.0,2,4,0.5,4,4,8,1,1,0,2,4,12,9.0,6.0,Kenyon Martin Jr.,5,7,0.7142857142857143
5205,11/20/2022,21.87123287671233,L,0,23.65,4,6,0.667,1,2,0.5,3,4,0.75,0,4,4,1,1,0,0,0,12,11.9,12.0,Kenyon Martin Jr.,3,4,0.75
5206,11/25/2022,21.884931506849316,W,1,33.7,10,13,0.769,1,1,1.0,0,0,,5,10,15,2,1,0,5,3,21,18.6,8.0,Kenyon Martin Jr.,9,12,0.75
5207,11/26/2022,21.887671232876713,W,0,14.166666666666666,1,5,0.2,0,2,0.0,1,2,0.5,1,4,5,1,0,0,2,0,3,0.1,-1.0,Kenyon Martin Jr.,1,3,0.3333333333333333
5208,10/19/2022,21.443835616438356,L,0,15.1,4,6,0.667,0,0,,0,0,,3,4,7,0,0,0,0,1,8,8.3,-1.0,Tari Eason,4,6,0.6666666666666666
5209,10/21/2022,21.44931506849315,L,0,19.516666666666666,2,6,0.333,1,2,0.5,1,1,1.0,1,6,7,1,0,1,0,1,6,6.1,11.0,Tari Eason,1,4,0.25
5210,10/22/2022,21.45205479452055,L,0,18.816666666666666,4,9,0.444,3,4,0.75,0,0,,0,2,2,1,1,3,1,3,11,8.5,-7.0,Tari Eason,1,5,0.2
5211,10/24/2022,21.457534246575342,W,0,18.75,4,12,0.333,0,2,0.0,3,4,0.75,5,4,9,0,3,0,1,3,11,9.3,7.0,Tari Eason,4,10,0.4
5212,10/26/2022,21.463013698630135,L,0,23.166666666666668,1,7,0.143,1,4,0.25,0,0,,3,3,6,1,1,0,0,4,3,1.6,-11.0,Tari Eason,0,3,0.0
5213,10/28/2022,21.46849315068493,L,0,15.3,2,4,0.5,0,0,,0,0,,1,2,3,0,1,0,0,1,4,3.9,-1.0,Tari Eason,2,4,0.5
5214,10/30/2022,21.473972602739725,L,0,11.833333333333334,4,4,1.0,1,1,1.0,0,0,,2,0,2,1,1,0,1,4,9,8.3,-4.0,Tari Eason,3,3,1.0
5215,10/31/2022,21.476712328767125,L,0,11.833333333333334,2,7,0.286,0,1,0.0,2,2,1.0,1,0,1,0,1,0,1,1,6,2.2,-3.0,Tari Eason,2,6,0.3333333333333333
5216,11/2/2022,21.482191780821918,L,0,18.15,3,7,0.429,0,1,0.0,0,0,,3,4,7,2,1,3,2,2,6,7.3,-4.0,Tari Eason,3,6,0.5
5217,11/5/2022,21.49041095890411,L,0,23.983333333333334,6,8,0.75,2,2,1.0,3,5,0.6,3,3,6,2,1,0,1,3,17,16.2,2.0,Tari Eason,4,6,0.6666666666666666
5218,11/7/2022,21.495890410958904,W,0,19.716666666666665,3,7,0.429,2,3,0.667,0,0,,2,4,6,0,2,0,1,3,8,6.7,13.0,Tari Eason,1,4,0.25
5219,11/9/2022,21.5013698630137,L,0,21.416666666666668,5,15,0.333,0,2,0.0,4,5,0.8,4,2,6,5,5,0,2,2,14,14.2,9.0,Tari Eason,5,13,0.38461538461538464
5220,11/12/2022,21.50958904109589,L,0,21.05,1,4,0.25,1,3,0.333,2,2,1.0,0,2,2,3,3,0,1,3,5,6.1,6.0,Tari Eason,0,1,0.0
5221,11/14/2022,21.515068493150686,L,0,14.733333333333333,4,7,0.571,1,3,0.333,0,0,,2,1,3,0,2,0,0,1,9,9.0,-7.0,Tari Eason,3,4,0.75
5222,11/16/2022,21.52054794520548,W,0,17.866666666666667,3,5,0.6,0,1,0.0,2,2,1.0,1,6,7,0,0,1,2,3,8,5.7,12.0,Tari Eason,3,4,0.75
5223,11/18/2022,21.526027397260275,L,0,18.883333333333333,1,9,0.111,0,1,0.0,2,2,1.0,3,3,6,0,0,0,2,2,4,-1.7,-12.0,Tari Eason,1,8,0.125
5224,11/20/2022,21.53150684931507,L,0,22.666666666666668,8,14,0.571,1,5,0.2,2,2,1.0,2,6,8,1,3,0,0,1,19,18.9,6.0,Tari Eason,7,9,0.7777777777777778
5225,11/25/2022,21.545205479452054,W,0,18.5,2,9,0.222,0,1,0.0,2,2,1.0,4,3,7,0,1,0,0,2,6,4.4,4.0,Tari Eason,2,8,0.25
5226,11/26/2022,21.54794520547945,W,0,16.583333333333332,3,8,0.375,1,1,1.0,0,0,,1,5,6,0,2,0,2,2,7,4.0,-10.0,Tari Eason,2,7,0.2857142857142857
5227,10/19/2022,22.46027397260274,L,1,33.95,9,19,0.474,3,5,0.6,0,0,,3,4,7,7,2,0,4,2,21,16.7,-13.0,Kevin Porter Jr.,6,14,0.42857142857142855
5228,10/21/2022,22.465753424657535,L,1,35.166666666666664,6,16,0.375,4,8,0.5,2,4,0.5,2,3,5,4,0,0,3,4,18,8.9,-12.0,Kevin Porter Jr.,2,8,0.25
5229,10/22/2022,22.46849315068493,L,1,33.733333333333334,5,15,0.333,2,4,0.5,6,7,0.857,2,3,5,7,2,0,2,4,18,14.7,-9.0,Kevin Porter Jr.,3,11,0.2727272727272727
5230,10/24/2022,22.473972602739725,W,1,34.71666666666667,8,19,0.421,1,4,0.25,9,9,1.0,1,9,10,4,2,1,4,1,26,20.4,3.0,Kevin Porter Jr.,7,15,0.4666666666666667
5231,10/26/2022,22.47945205479452,L,1,35.38333333333333,10,22,0.455,0,4,0.0,4,4,1.0,2,3,5,5,1,1,5,5,24,13.1,-3.0,Kevin Porter Jr.,10,18,0.5555555555555556
5232,10/28/2022,22.484931506849314,L,1,34.516666666666666,6,14,0.429,1,5,0.2,3,5,0.6,3,3,6,4,3,1,5,0,16,12.3,-10.0,Kevin Porter Jr.,5,9,0.5555555555555556
5233,10/30/2022,22.49041095890411,L,1,34.483333333333334,7,17,0.412,1,4,0.25,11,14,0.786,1,7,8,6,1,0,1,3,26,21.5,-7.0,Kevin Porter Jr.,6,13,0.46153846153846156
5234,10/31/2022,22.493150684931507,L,1,33.88333333333333,5,13,0.385,1,3,0.333,2,2,1.0,0,5,5,5,2,0,2,3,13,9.7,-14.0,Kevin Porter Jr.,4,10,0.4
5235,11/2/2022,22.4986301369863,L,1,38.18333333333333,7,19,0.368,3,9,0.333,5,8,0.625,3,4,7,7,1,0,6,1,22,13.1,-2.0,Kevin Porter Jr.,4,10,0.4
5236,11/5/2022,22.506849315068493,L,1,29.2,3,12,0.25,2,4,0.5,5,5,1.0,1,4,5,2,0,0,3,4,13,4.5,-16.0,Kevin Porter Jr.,1,8,0.125
5237,11/7/2022,22.512328767123286,W,1,37.95,7,14,0.5,3,8,0.375,0,1,0.0,1,7,8,11,2,1,7,5,17,13.8,13.0,Kevin Porter Jr.,4,6,0.6666666666666666
5238,11/9/2022,22.517808219178082,L,1,40.45,4,11,0.364,1,6,0.167,3,4,0.75,0,2,2,11,0,0,4,2,12,9.0,-8.0,Kevin Porter Jr.,3,5,0.6
5239,11/12/2022,22.526027397260275,L,1,33.53333333333333,9,16,0.563,3,9,0.333,2,4,0.5,0,1,1,3,0,0,7,4,23,8.4,-28.0,Kevin Porter Jr.,6,7,0.8571428571428571
5240,11/14/2022,22.53150684931507,L,1,31.616666666666667,6,18,0.333,0,4,0.0,8,15,0.533,2,5,7,3,3,0,2,4,20,11.4,-10.0,Kevin Porter Jr.,6,14,0.42857142857142855
5241,11/16/2022,22.536986301369865,W,1,36.5,6,14,0.429,2,3,0.667,3,4,0.75,1,10,11,8,1,3,5,2,17,15.8,16.0,Kevin Porter Jr.,4,11,0.36363636363636365
5242,11/20/2022,22.54794520547945,L,1,34.75,10,19,0.526,5,11,0.455,5,6,0.833,3,2,5,6,2,1,2,4,30,26.3,-14.0,Kevin Porter Jr.,5,8,0.625
5243,11/25/2022,22.561643835616437,W,1,36.583333333333336,5,16,0.313,0,6,0.0,2,3,0.667,3,4,7,10,1,0,4,0,12,9.7,5.0,Kevin Porter Jr.,5,10,0.5
5244,11/26/2022,22.564383561643837,W,1,33.333333333333336,6,13,0.462,1,5,0.2,3,5,0.6,0,3,3,6,1,0,5,2,16,8.8,17.0,Kevin Porter Jr.,5,8,0.625
5245,10/19/2022,19.435616438356163,L,1,32.9,6,17,0.353,3,11,0.273,2,2,1.0,1,6,7,1,0,0,0,4,17,9.1,-9.0,Jabari Smith Jr.,3,6,0.5
5246,10/21/2022,19.44109589041096,L,1,34.583333333333336,3,14,0.214,2,8,0.25,2,2,1.0,1,0,1,1,0,2,0,5,10,2.2,-31.0,Jabari Smith Jr.,1,6,0.16666666666666666
5247,10/22/2022,19.443835616438356,L,1,27.6,5,15,0.333,3,7,0.429,0,0,,2,9,11,1,0,2,0,3,13,9.5,-11.0,Jabari Smith Jr.,2,8,0.25
5248,10/24/2022,19.44931506849315,W,1,33.85,6,10,0.6,3,5,0.6,6,6,1.0,3,6,9,2,0,3,1,5,21,20.8,2.0,Jabari Smith Jr.,3,5,0.6
5249,10/26/2022,19.454794520547946,L,1,32.21666666666667,3,10,0.3,2,6,0.333,2,4,0.5,1,8,9,0,1,0,2,4,10,3.9,-3.0,Jabari Smith Jr.,1,4,0.25
5250,10/28/2022,19.46027397260274,L,1,32.2,4,13,0.308,2,5,0.4,2,2,1.0,0,2,2,1,1,1,1,4,12,4.9,-10.0,Jabari Smith Jr.,2,8,0.25
5251,10/30/2022,19.465753424657535,L,1,25.05,2,8,0.25,2,6,0.333,2,2,1.0,0,7,7,0,0,1,2,3,8,2.8,-13.0,Jabari Smith Jr.,0,2,0.0
5252,10/31/2022,19.46849315068493,L,1,30.316666666666666,2,8,0.25,0,3,0.0,0,0,,1,4,5,1,0,1,2,2,4,-0.3,-2.0,Jabari Smith Jr.,2,5,0.4
5253,11/2/2022,19.473972602739725,L,1,26.85,1,10,0.1,0,5,0.0,0,0,,1,3,4,0,0,1,2,2,2,-5.1,-6.0,Jabari Smith Jr.,1,5,0.2
5254,11/7/2022,19.487671232876714,W,1,21.883333333333333,1,4,0.25,1,4,0.25,0,0,,0,1,1,1,0,0,3,4,3,-3.0,-4.0,Jabari Smith Jr.,0,0,
5255,11/9/2022,19.493150684931507,L,1,30.733333333333334,4,11,0.364,2,8,0.25,5,6,0.833,2,8,10,0,0,0,1,4,15,9.7,-19.0,Jabari Smith Jr.,2,3,0.6666666666666666
5256,11/12/2022,19.5013698630137,L,1,27.75,4,10,0.4,0,2,0.0,1,2,0.5,6,9,15,2,0,2,1,4,9,10.3,-21.0,Jabari Smith Jr.,4,8,0.5
5257,11/14/2022,19.506849315068493,L,1,28.516666666666666,2,6,0.333,2,4,0.5,1,2,0.5,1,5,6,1,3,0,0,3,7,7.9,-14.0,Jabari Smith Jr.,0,2,0.0
5258,11/16/2022,19.512328767123286,W,1,30.133333333333333,3,10,0.3,2,5,0.4,2,2,1.0,1,8,9,0,0,2,0,4,10,7.1,-3.0,Jabari Smith Jr.,1,5,0.2
5259,11/18/2022,19.517808219178082,L,1,36.36666666666667,4,14,0.286,2,8,0.25,2,2,1.0,1,7,8,1,0,2,2,4,12,5.1,-2.0,Jabari Smith Jr.,2,6,0.3333333333333333
5260,11/20/2022,19.523287671232875,L,1,32.38333333333333,8,14,0.571,3,9,0.333,3,4,0.75,1,6,7,1,0,0,2,2,22,15.4,-14.0,Jabari Smith Jr.,5,5,1.0
5261,11/25/2022,19.536986301369865,W,1,38.05,6,17,0.353,5,11,0.455,4,4,1.0,2,7,9,1,1,1,0,3,21,16.2,14.0,Jabari Smith Jr.,1,6,0.16666666666666666
5262,11/26/2022,19.53972602739726,W,1,31.416666666666668,5,11,0.455,3,8,0.375,2,2,1.0,2,11,13,0,0,1,1,1,15,13.3,23.0,Jabari Smith Jr.,2,3,0.6666666666666666
5263,10/22/2022,20.621917808219177,L,1,25.033333333333335,2,3,0.667,1,1,1.0,1,2,0.5,4,4,8,2,4,0,2,2,6,10.9,-12.0,Usman Garuba,1,2,0.5
5264,10/24/2022,20.627397260273973,W,0,10.616666666666667,1,3,0.333,0,0,,0,2,0.0,3,1,4,1,0,0,2,2,2,-0.2,5.0,Usman Garuba,1,3,0.3333333333333333
5265,10/26/2022,20.632876712328766,L,0,8.483333333333333,1,1,1.0,0,0,,0,0,,2,3,5,0,0,0,2,3,2,0.8,-5.0,Usman Garuba,1,1,1.0
5266,10/28/2022,20.638356164383563,L,0,5.083333333333333,1,1,1.0,0,0,,0,0,,0,0,0,0,0,0,0,0,2,1.7,0.0,Usman Garuba,1,1,1.0
5267,10/30/2022,20.643835616438356,L,0,12.45,1,1,1.0,1,1,1.0,0,0,,3,4,7,1,1,0,0,1,3,7.3,-4.0,Usman Garuba,0,0,
5268,10/31/2022,20.646575342465752,L,0,10.433333333333334,1,2,0.5,0,0,,0,0,,2,6,8,1,0,1,1,0,2,4.6,4.0,Usman Garuba,1,2,0.5
5269,11/2/2022,20.65205479452055,L,0,12.416666666666666,3,5,0.6,0,1,0.0,0,1,0.0,4,2,6,1,2,0,2,4,6,5.8,6.0,Usman Garuba,3,4,0.75
5270,11/5/2022,20.660273972602738,L,0,24.533333333333335,2,4,0.5,0,0,,3,4,0.75,0,3,3,1,2,0,2,2,7,5.4,-16.0,Usman Garuba,2,4,0.5
5271,11/7/2022,20.665753424657535,W,0,18.95,1,2,0.5,1,1,1.0,0,0,,2,4,6,2,0,1,1,2,3,4.9,1.0,Usman Garuba,0,1,0.0
5272,11/9/2022,20.671232876712327,L,0,14.066666666666666,2,5,0.4,0,0,,0,0,,4,4,8,3,0,2,0,1,4,8.4,7.0,Usman Garuba,2,5,0.4
5273,11/12/2022,20.67945205479452,L,0,23.283333333333335,1,2,0.5,1,1,1.0,1,2,0.5,1,5,6,0,1,1,2,2,4,3.7,1.0,Usman Garuba,0,1,0.0
5274,11/14/2022,20.684931506849313,L,0,17.316666666666666,2,3,0.667,0,0,,1,2,0.5,2,2,4,2,1,3,0,3,5,8.6,-6.0,Usman Garuba,2,3,0.6666666666666666
5275,11/16/2022,20.69041095890411,W,0,21.783333333333335,5,5,1.0,2,2,1.0,0,0,,1,8,9,3,0,3,0,3,12,16.6,16.0,Usman Garuba,3,3,1.0
5276,11/18/2022,20.695890410958903,L,0,19.966666666666665,2,4,0.5,0,0,,0,0,,0,4,4,0,1,0,0,2,4,3.4,-12.0,Usman Garuba,2,4,0.5
5277,11/20/2022,20.7013698630137,L,0,22.25,1,4,0.25,1,1,1.0,0,0,,3,3,6,1,2,0,2,1,3,3.9,-8.0,Usman Garuba,0,3,0.0
5278,11/25/2022,20.715068493150685,W,0,19.4,1,2,0.5,0,1,0.0,7,8,0.875,5,0,5,3,1,2,0,5,9,13.6,5.0,Usman Garuba,1,1,1.0
5279,11/26/2022,20.71780821917808,W,0,13.3,0,0,,0,0,,0,0,,1,1,2,0,1,0,1,2,0,0.2,-4.0,Usman Garuba,0,0,
5280,10/22/2022,20.687671232876713,L,0,14.266666666666667,1,3,0.333,0,2,0.0,0,0,,0,1,1,1,0,0,1,2,2,-0.5,-11.0,Daishen Nix,1,1,1.0
5281,10/24/2022,20.693150684931506,W,0,21.583333333333332,2,3,0.667,0,0,,3,4,0.75,1,0,1,2,0,1,0,1,7,7.7,5.0,Daishen Nix,2,3,0.6666666666666666
5282,10/26/2022,20.698630136986303,L,0,11.516666666666667,0,3,0.0,0,2,0.0,0,0,,0,0,0,3,0,0,4,0,0,-4.0,-1.0,Daishen Nix,0,1,0.0
5283,10/28/2022,20.704109589041096,L,0,13.466666666666667,3,4,0.75,3,4,0.75,0,0,,0,0,0,2,1,0,0,0,9,9.8,-4.0,Daishen Nix,0,0,
5284,10/30/2022,20.70958904109589,L,0,12.116666666666667,0,2,0.0,0,1,0.0,0,0,,1,0,1,2,0,0,3,1,0,-2.7,-6.0,Daishen Nix,0,1,0.0
5285,10/31/2022,20.71232876712329,L,0,9.283333333333333,1,3,0.333,1,2,0.5,0,0,,1,1,2,2,1,0,0,0,3,4.7,14.0,Daishen Nix,0,1,0.0
5286,11/2/2022,20.71780821917808,L,0,20.883333333333333,4,8,0.5,4,6,0.667,0,0,,0,3,3,1,1,0,1,1,12,9.2,-2.0,Daishen Nix,0,2,0.0
5287,11/5/2022,20.726027397260275,L,0,18.8,0,4,0.0,0,2,0.0,0,0,,0,2,2,6,3,0,4,1,0,0.6,4.0,Daishen Nix,0,2,0.0
5288,11/7/2022,20.731506849315068,W,0,11.1,1,3,0.333,1,2,0.5,0,0,,0,1,1,1,0,0,0,1,3,1.9,0.0,Daishen Nix,0,1,0.0
5289,11/9/2022,20.736986301369864,L,0,7.55,1,1,1.0,1,1,1.0,0,0,,0,0,0,1,2,0,1,2,3,3.6,1.0,Daishen Nix,0,0,
5290,11/12/2022,20.745205479452054,L,0,11.283333333333333,0,0,,0,0,,0,0,,0,3,3,3,1,0,2,0,0,2.0,13.0,Daishen Nix,0,0,
5291,11/14/2022,20.75068493150685,L,0,15.083333333333334,1,3,0.333,1,3,0.333,0,0,,0,2,2,3,0,0,1,0,3,3.0,-13.0,Daishen Nix,0,0,
5292,11/16/2022,20.756164383561643,W,0,11.5,1,2,0.5,1,2,0.5,0,0,,0,1,1,1,0,2,0,2,3,3.6,-7.0,Daishen Nix,0,0,
5293,11/18/2022,20.76164383561644,L,0,24.6,1,5,0.2,1,3,0.333,0,0,,0,2,2,1,1,0,2,1,3,-0.2,-16.0,Daishen Nix,0,2,0.0
5294,11/20/2022,20.767123287671232,L,0,13.25,0,3,0.0,0,2,0.0,0,0,,0,1,1,5,1,0,1,0,0,1.7,7.0,Daishen Nix,0,1,0.0
5295,11/25/2022,20.78082191780822,W,0,16.166666666666668,0,2,0.0,0,1,0.0,2,4,0.5,0,3,3,2,2,0,3,3,2,-0.1,8.0,Daishen Nix,0,1,0.0
5296,11/26/2022,20.783561643835615,W,0,14.666666666666666,0,0,,0,0,,0,0,,0,1,1,0,1,0,2,0,0,-0.7,-4.0,Daishen Nix,0,0,
5297,10/19/2022,20.235616438356164,L,0,22.083333333333332,5,9,0.556,1,2,0.5,4,4,1.0,4,5,9,0,0,0,6,3,15,7.8,-6.0,Alperen Şengün,4,7,0.5714285714285714
5298,10/21/2022,20.24109589041096,L,0,27.0,9,13,0.692,1,2,0.5,4,10,0.4,5,7,12,1,1,2,1,3,23,21.6,13.0,Alperen Şengün,8,11,0.7272727272727273
5299,10/22/2022,20.243835616438357,L,0,22.966666666666665,4,9,0.444,0,3,0.0,1,2,0.5,3,6,9,2,1,1,1,2,9,9.1,-8.0,Alperen Şengün,4,6,0.6666666666666666
5300,10/28/2022,20.26027397260274,L,1,25.5,6,12,0.5,1,1,1.0,1,1,1.0,6,5,11,1,0,3,1,4,14,13.9,-8.0,Alperen Şengün,5,11,0.45454545454545453
5301,10/30/2022,20.265753424657536,L,1,29.183333333333334,6,10,0.6,0,2,0.0,4,4,1.0,3,6,9,2,1,0,1,3,16,15.5,-1.0,Alperen Şengün,6,8,0.75
5302,10/31/2022,20.268493150684932,L,1,29.783333333333335,4,8,0.5,0,0,,6,6,1.0,2,7,9,3,0,1,2,3,14,13.1,-8.0,Alperen Şengün,4,8,0.5
5303,11/2/2022,20.273972602739725,L,1,33.46666666666667,8,13,0.615,0,1,0.0,10,11,0.909,3,10,13,2,1,0,0,6,26,24.8,-13.0,Alperen Şengün,8,12,0.6666666666666666
5304,11/5/2022,20.28219178082192,L,1,20.383333333333333,8,9,0.889,0,0,,1,3,0.333,5,2,7,5,0,0,2,3,17,17.5,0.0,Alperen Şengün,8,9,0.8888888888888888
5305,11/7/2022,20.28767123287671,W,1,29.033333333333335,6,14,0.429,0,1,0.0,8,10,0.8,7,3,10,4,2,1,3,2,20,19.3,6.0,Alperen Şengün,6,13,0.46153846153846156
5306,11/9/2022,20.293150684931508,L,1,30.333333333333332,5,8,0.625,0,0,,7,7,1.0,3,5,8,1,1,3,3,2,17,17.0,-13.0,Alperen Şengün,5,8,0.625
5307,11/12/2022,20.301369863013697,L,1,18.966666666666665,3,6,0.5,0,1,0.0,0,0,,0,3,3,1,1,0,1,6,6,2.2,-5.0,Alperen Şengün,3,5,0.6
5308,11/14/2022,20.306849315068494,L,1,29.5,6,11,0.545,0,2,0.0,4,6,0.667,1,3,4,1,0,0,4,5,16,6.2,-11.0,Alperen Şengün,6,9,0.6666666666666666
5309,11/16/2022,20.312328767123287,W,1,26.216666666666665,5,10,0.5,0,0,,4,5,0.8,4,3,7,1,0,5,4,2,14,11.7,-7.0,Alperen Şengün,5,10,0.5
5310,11/18/2022,20.317808219178083,L,1,28.016666666666666,4,13,0.308,1,1,1.0,2,2,1.0,3,6,9,4,1,0,1,4,11,8.6,4.0,Alperen Şengün,3,12,0.25
5311,11/20/2022,20.323287671232876,L,1,23.416666666666668,1,3,0.333,0,0,,2,2,1.0,1,6,7,3,1,0,3,3,4,3.7,0.0,Alperen Şengün,1,3,0.3333333333333333
5312,11/26/2022,20.339726027397262,W,1,34.7,10,17,0.588,0,1,0.0,1,1,1.0,6,13,19,7,3,2,3,6,21,25.1,17.0,Alperen Şengün,10,16,0.625
5313,10/19/2022,33.81643835616438,L,1,29.3,4,9,0.444,1,4,0.25,2,2,1.0,0,1,1,4,0,0,1,2,11,7.6,8.0,Eric Gordon,3,5,0.6
5314,10/21/2022,33.821917808219176,L,1,35.75,5,12,0.417,2,5,0.4,5,7,0.714,1,3,4,4,0,0,4,2,17,9.4,-6.0,Eric Gordon,3,7,0.42857142857142855
5315,10/24/2022,33.83013698630137,W,1,31.016666666666666,5,11,0.455,1,4,0.25,2,2,1.0,0,2,2,2,1,0,2,0,13,8.3,8.0,Eric Gordon,4,7,0.5714285714285714
5316,10/26/2022,33.83561643835616,L,1,30.033333333333335,6,12,0.5,2,7,0.286,2,3,0.667,0,2,2,3,2,0,1,0,16,13.3,-6.0,Eric Gordon,4,5,0.8
5317,10/28/2022,33.84109589041096,L,1,33.25,6,10,0.6,4,7,0.571,2,2,1.0,0,3,3,5,1,1,5,1,18,14.1,1.0,Eric Gordon,2,3,0.6666666666666666
5318,10/31/2022,33.84931506849315,L,1,30.116666666666667,5,11,0.455,2,4,0.5,0,0,,0,2,2,2,2,2,2,1,12,9.3,-10.0,Eric Gordon,3,7,0.42857142857142855
5319,11/2/2022,33.85479452054795,L,1,32.81666666666667,0,4,0.0,0,3,0.0,0,0,,1,1,2,2,1,1,1,0,0,0.3,-7.0,Eric Gordon,0,1,0.0
5320,11/5/2022,33.863013698630134,L,1,26.633333333333333,4,9,0.444,2,6,0.333,1,2,0.5,0,1,1,4,0,0,1,1,11,7.6,-10.0,Eric Gordon,2,3,0.6666666666666666
5321,11/7/2022,33.868493150684934,W,1,29.466666666666665,5,9,0.556,5,8,0.625,4,5,0.8,0,1,1,4,1,0,1,0,19,17.4,-10.0,Eric Gordon,0,1,0.0
5322,11/9/2022,33.87397260273973,L,1,28.583333333333332,3,10,0.3,1,6,0.167,3,3,1.0,0,3,3,2,1,0,1,1,10,6.1,-14.0,Eric Gordon,2,4,0.5
5323,11/12/2022,33.88219178082192,L,1,30.0,6,11,0.545,2,6,0.333,1,1,1.0,0,1,1,5,0,1,2,2,15,11.4,-15.0,Eric Gordon,4,5,0.8
5324,11/14/2022,33.88767123287671,L,1,25.516666666666666,1,4,0.25,0,1,0.0,2,2,1.0,0,1,1,0,0,0,1,1,4,0.5,-8.0,Eric Gordon,1,3,0.3333333333333333
5325,11/16/2022,33.893150684931506,W,1,30.7,3,9,0.333,1,4,0.25,3,3,1.0,0,3,3,1,0,0,3,0,10,3.5,13.0,Eric Gordon,2,5,0.4
5326,11/18/2022,33.8986301369863,L,1,36.21666666666667,8,17,0.471,1,6,0.167,7,7,1.0,2,4,6,3,1,2,2,1,24,20.0,8.0,Eric Gordon,7,11,0.6363636363636364
5327,11/20/2022,33.9041095890411,L,1,29.716666666666665,5,12,0.417,3,7,0.429,1,1,1.0,0,2,2,2,1,0,2,0,14,8.6,0.0,Eric Gordon,2,5,0.4
5328,11/26/2022,33.92054794520548,W,1,27.05,5,7,0.714,4,6,0.667,1,1,1.0,0,0,0,2,1,0,3,1,15,11.1,17.0,Eric Gordon,1,1,1.0
5329,10/19/2022,25.986301369863014,L,0,14.05,0,2,0.0,0,2,0.0,0,0,,0,1,1,1,0,0,0,1,0,-0.8,3.0,Garrison Mathews,0,0,
5330,10/21/2022,25.991780821917807,L,0,12.833333333333334,1,2,0.5,1,2,0.5,0,0,,0,1,1,0,0,0,0,1,3,1.9,5.0,Garrison Mathews,0,0,
5331,10/22/2022,25.994520547945207,L,0,12.566666666666666,0,1,0.0,0,1,0.0,1,1,1.0,0,0,0,0,0,0,1,1,1,-1.1,-13.0,Garrison Mathews,0,0,
5332,10/24/2022,26.0,W,0,11.533333333333333,1,5,0.2,1,5,0.2,0,0,,0,2,2,0,0,1,0,2,3,0.4,10.0,Garrison Mathews,0,0,
5333,10/26/2022,26.005479452054793,L,0,16.116666666666667,3,5,0.6,3,5,0.6,2,2,1.0,0,0,0,1,1,0,0,3,11,9.2,0.0,Garrison Mathews,0,0,
5334,10/28/2022,26.01095890410959,L,0,13.733333333333333,0,2,0.0,0,2,0.0,3,3,1.0,0,1,1,2,0,0,0,1,3,2.9,-4.0,Garrison Mathews,0,0,
5335,10/30/2022,26.016438356164382,L,0,16.9,2,7,0.286,2,7,0.286,2,2,1.0,0,1,1,0,1,0,1,3,8,3.0,-8.0,Garrison Mathews,0,0,
5336,10/31/2022,26.019178082191782,L,0,15.133333333333333,1,2,0.5,1,2,0.5,0,0,,0,2,2,0,1,0,1,1,3,2.2,-2.0,Garrison Mathews,0,0,
5337,11/2/2022,26.024657534246575,L,0,6.966666666666667,1,3,0.333,1,3,0.333,0,0,,1,0,1,0,0,0,1,1,3,0.6,3.0,Garrison Mathews,0,0,
5338,11/5/2022,26.03287671232877,L,0,18.233333333333334,3,7,0.429,3,6,0.5,0,0,,0,1,1,1,0,0,1,0,9,5.3,7.0,Garrison Mathews,0,1,0.0
5339,11/7/2022,26.03835616438356,W,0,8.116666666666667,2,2,1.0,2,2,1.0,0,0,,0,0,0,0,0,0,0,1,6,5.0,-11.0,Garrison Mathews,0,0,
5340,11/9/2022,26.043835616438358,L,0,3.85,0,3,0.0,0,3,0.0,0,0,,0,0,0,0,0,0,0,0,0,-2.1,-8.0,Garrison Mathews,0,0,
5341,11/14/2022,26.057534246575344,L,0,4.25,0,1,0.0,0,1,0.0,0,0,,0,1,1,0,1,0,0,0,0,0.6,6.0,Garrison Mathews,0,0,
5342,11/18/2022,26.068493150684933,L,0,14.483333333333333,1,4,0.25,1,3,0.333,0,0,,0,0,0,0,1,0,0,2,3,0.8,-8.0,Garrison Mathews,0,1,0.0
5343,11/25/2022,26.087671232876712,W,0,22.75,4,6,0.667,3,5,0.6,9,9,1.0,1,3,4,2,2,0,1,3,20,20.2,5.0,Garrison Mathews,1,1,1.0
5344,11/26/2022,26.09041095890411,W,0,18.0,3,4,0.75,3,4,0.75,2,3,0.667,0,2,2,0,0,0,0,3,11,8.4,2.0,Garrison Mathews,0,0,
5345,10/19/2022,20.863013698630137,L,0,12.65,3,6,0.5,0,2,0.0,0,0,,0,3,3,2,0,0,0,0,6,5.3,-5.0,Josh Christopher,3,4,0.75
5346,10/21/2022,20.86849315068493,L,0,3.4333333333333336,0,1,0.0,0,1,0.0,0,0,,0,1,1,0,0,0,0,0,0,-0.4,-7.0,Josh Christopher,0,0,
5347,10/22/2022,20.87123287671233,L,0,15.916666666666666,1,5,0.2,0,2,0.0,1,2,0.5,1,1,2,1,0,0,1,1,3,-0.2,-15.0,Josh Christopher,1,3,0.3333333333333333
5348,10/24/2022,20.876712328767123,W,0,4.383333333333334,1,2,0.5,0,1,0.0,0,0,,0,0,0,0,0,0,0,1,2,0.6,-4.0,Josh Christopher,1,1,1.0
5349,10/28/2022,20.887671232876713,L,0,0.9666666666666667,1,1,1.0,0,0,,0,0,,0,0,0,0,0,0,1,0,2,0.7,0.0,Josh Christopher,1,1,1.0
5350,10/30/2022,20.893150684931506,L,0,12.8,3,7,0.429,1,3,0.333,0,0,,1,4,5,0,0,0,2,2,7,2.4,-12.0,Josh Christopher,2,4,0.5
5351,10/31/2022,20.895890410958906,L,0,4.3,0,0,,0,0,,0,0,,0,0,0,1,0,0,0,0,0,0.7,7.0,Josh Christopher,0,0,
5352,11/5/2022,20.90958904109589,L,0,14.65,2,6,0.333,0,2,0.0,0,0,,1,1,2,1,2,0,1,1,4,2.9,0.0,Josh Christopher,2,4,0.5
5353,11/12/2022,20.92876712328767,L,0,6.066666666666666,0,2,0.0,0,1,0.0,0,0,,0,1,1,0,1,0,1,0,0,-1.1,-4.0,Josh Christopher,0,1,0.0
5354,11/14/2022,20.934246575342467,L,0,10.25,3,7,0.429,2,2,1.0,0,0,,1,0,1,2,0,0,2,5,8,2.4,-6.0,Josh Christopher,1,5,0.2
5355,11/16/2022,20.93972602739726,W,0,4.55,0,0,,0,0,,0,0,,0,1,1,0,0,0,0,0,0,0.3,-4.0,Josh Christopher,0,0,
5356,11/18/2022,20.945205479452056,L,0,3.5166666666666666,1,1,1.0,0,0,,0,0,,1,0,1,0,0,0,0,0,2,2.4,-8.0,Josh Christopher,1,1,1.0
5357,11/25/2022,20.964383561643835,W,0,5.316666666666666,0,0,,0,0,,0,0,,0,1,1,0,0,0,1,1,0,-1.1,-10.0,Josh Christopher,0,0,
5358,11/26/2022,20.96712328767123,W,0,2.4166666666666665,1,2,0.5,0,0,,0,0,,0,0,0,0,0,0,1,1,2,-0.4,-9.0,Josh Christopher,1,2,0.5
5359,10/22/2022,34.18630136986302,L,0,3.783333333333333,1,2,0.5,0,0,,1,1,1.0,0,0,0,1,0,0,0,0,3,2.7,-2.0,Boban Marjanović,1,2,0.5
5360,10/24/2022,34.19178082191781,W,0,3.533333333333333,0,0,,0,0,,1,2,0.5,1,2,3,0,0,0,1,0,1,0.9,-1.0,Boban Marjanović,0,0,
5361,10/26/2022,34.1972602739726,L,0,1.8166666666666667,0,0,,0,0,,0,0,,0,0,0,0,0,0,0,0,0,0.0,-1.0,Boban Marjanović,0,0,
5362,11/5/2022,34.224657534246575,L,0,3.0833333333333335,0,1,0.0,0,0,,1,2,0.5,0,1,1,0,1,0,0,1,1,0.8,4.0,Boban Marjanović,0,1,0.0
5363,11/12/2022,34.24383561643835,L,0,4.133333333333334,1,1,1.0,0,0,,0,0,,0,2,2,0,0,0,1,0,2,1.3,-1.0,Boban Marjanović,1,1,1.0
5364,11/14/2022,34.24931506849315,L,0,2.966666666666667,0,0,,0,0,,0,0,,0,0,0,0,0,0,0,0,0,0.0,7.0,Boban Marjanović,0,0,
5365,10/26/2022,26.994520547945207,L,1,20.3,3,5,0.6,1,1,1.0,0,0,,2,3,5,1,0,0,2,5,7,3.7,5.0,Jae'Sean Tate,2,4,0.5
5366,10/28/2022,27.0,L,0,17.783333333333335,3,8,0.375,0,3,0.0,3,4,0.75,2,1,3,6,2,0,1,6,9,8.7,-4.0,Jae'Sean Tate,3,5,0.6
5367,10/30/2022,27.005479452054793,L,1,30.0,4,7,0.571,1,1,1.0,0,0,,4,1,5,3,1,0,2,4,9,8.3,-11.0,Jae'Sean Tate,3,6,0.5
5368,10/19/2022,24.17808219178082,L,1,25.05,3,3,1.0,0,0,,1,2,0.5,3,6,9,7,0,2,0,0,7,15.9,-1.0,Bruno Fernando,3,3,1.0
5369,10/21/2022,24.183561643835617,L,1,11.766666666666667,2,3,0.667,0,0,,0,0,,2,2,4,2,1,0,1,3,4,4.9,-8.0,Bruno Fernando,2,3,0.6666666666666666
5370,11/25/2022,24.279452054794522,W,1,16.6,3,5,0.6,0,0,,1,2,0.5,2,1,3,0,0,1,1,3,7,4.5,-15.0,Bruno Fernando,3,5,0.6
5371,10/22/2022,23.583561643835615,L,0,3.783333333333333,1,1,1.0,1,1,1.0,0,0,,0,0,0,0,0,0,0,0,3,2.7,-2.0,Trevor Hudgins,0,0,
5372,11/14/2022,20.997260273972604,L,0,4.25,0,0,,0,0,,1,2,0.5,0,0,0,0,0,0,0,0,1,0.6,6.0,TyTy Washington Jr.,0,0,
5373,10/20/2022,34.553424657534244,W,1,30.933333333333334,6,16,0.375,4,12,0.333,1,2,0.5,1,3,4,1,0,2,0,2,17,10.7,0.0,Brook Lopez,2,4,0.5
5374,10/22/2022,34.558904109589044,W,1,28.783333333333335,3,7,0.429,3,6,0.5,0,0,,0,5,5,2,2,5,1,3,9,11.5,4.0,Brook Lopez,0,1,0.0
5375,10/26/2022,34.56986301369863,W,1,27.85,3,10,0.3,1,5,0.2,0,0,,3,3,6,1,0,6,2,2,7,6.3,21.0,Brook Lopez,2,5,0.4
5376,10/28/2022,34.57534246575342,W,1,33.4,5,13,0.385,0,6,0.0,4,4,1.0,4,7,11,2,1,3,0,4,14,14.7,1.0,Brook Lopez,5,7,0.7142857142857143
5377,10/29/2022,34.57808219178082,W,1,34.0,8,12,0.667,5,8,0.625,0,0,,1,5,6,0,1,2,1,2,21,18.6,16.0,Brook Lopez,3,4,0.75
5378,10/31/2022,34.583561643835615,W,1,34.416666666666664,10,16,0.625,2,5,0.4,2,2,1.0,4,5,9,0,0,2,1,4,24,19.9,12.0,Brook Lopez,8,11,0.7272727272727273
5379,11/2/2022,34.58904109589041,W,1,27.033333333333335,5,8,0.625,0,2,0.0,1,1,1.0,2,5,7,2,1,1,3,1,11,10.0,29.0,Brook Lopez,5,6,0.8333333333333334
5380,11/4/2022,34.59452054794521,W,1,32.7,2,6,0.333,2,4,0.5,1,2,0.5,3,5,8,0,0,1,2,4,7,3.9,-2.0,Brook Lopez,0,2,0.0
5381,11/5/2022,34.5972602739726,W,1,23.7,10,16,0.625,4,9,0.444,1,1,1.0,2,1,3,1,1,1,3,3,25,17.7,13.0,Brook Lopez,6,7,0.8571428571428571
5382,11/7/2022,34.602739726027394,L,1,27.833333333333332,4,9,0.444,3,7,0.429,0,0,,1,1,2,0,0,2,1,2,11,6.9,-18.0,Brook Lopez,1,2,0.5
5383,11/9/2022,34.608219178082194,W,1,45.65,11,23,0.478,1,6,0.167,1,2,0.5,4,9,13,1,1,5,1,0,24,21.6,10.0,Brook Lopez,10,17,0.5882352941176471
5384,11/11/2022,34.61369863013699,L,1,29.55,6,14,0.429,3,7,0.429,4,5,0.8,1,2,3,2,1,2,5,4,19,9.7,-17.0,Brook Lopez,3,7,0.42857142857142855
5385,11/14/2022,34.62191780821918,L,1,33.1,3,8,0.375,0,4,0.0,6,7,0.857,1,4,5,1,0,0,1,2,12,8.0,-3.0,Brook Lopez,3,4,0.75
5386,11/16/2022,34.62739726027397,W,1,30.333333333333332,10,13,0.769,7,9,0.778,2,2,1.0,1,4,5,1,1,3,1,2,29,27.8,22.0,Brook Lopez,3,4,0.75
5387,11/18/2022,34.632876712328766,L,1,34.38333333333333,5,12,0.417,2,5,0.4,3,4,0.75,1,3,4,2,1,4,0,2,15,14.2,-5.0,Brook Lopez,3,7,0.42857142857142855
5388,11/21/2022,34.64109589041096,W,1,30.366666666666667,6,12,0.5,2,5,0.4,0,0,,2,2,4,2,1,5,1,1,14,14.5,-2.0,Brook Lopez,4,7,0.5714285714285714
5389,11/23/2022,34.64657534246575,L,1,31.983333333333334,8,16,0.5,3,7,0.429,1,3,0.333,1,6,7,0,1,1,0,0,20,15.4,-6.0,Brook Lopez,5,9,0.5555555555555556
5390,11/25/2022,34.652054794520545,W,1,27.533333333333335,3,3,1.0,2,2,1.0,0,0,,0,4,4,0,0,6,0,0,8,12.5,20.0,Brook Lopez,1,1,1.0
5391,11/27/2022,34.657534246575345,W,1,23.416666666666668,5,7,0.714,2,3,0.667,1,1,1.0,0,4,4,2,1,4,2,5,13,12.5,-1.0,Brook Lopez,3,4,0.75
5392,10/20/2022,27.69041095890411,W,0,22.7,5,10,0.5,1,4,0.25,0,0,,1,9,10,0,0,0,1,1,11,8.0,-2.0,Bobby Portis,4,6,0.6666666666666666
5393,10/22/2022,27.695890410958903,W,0,22.5,6,10,0.6,1,1,1.0,0,0,,3,5,8,1,1,1,2,2,13,11.6,8.0,Bobby Portis,5,9,0.5555555555555556
5394,10/26/2022,27.706849315068492,W,0,26.15,8,14,0.571,3,6,0.5,1,2,0.5,3,8,11,0,2,2,0,0,20,20.9,-4.0,Bobby Portis,5,8,0.625
5395,10/28/2022,27.71232876712329,W,0,25.233333333333334,4,13,0.308,0,2,0.0,4,4,1.0,8,4,12,1,0,0,0,4,12,10.4,-4.0,Bobby Portis,4,11,0.36363636363636365
5396,10/29/2022,27.715068493150685,W,0,24.233333333333334,4,12,0.333,1,5,0.2,0,0,,1,9,10,4,0,0,0,1,9,8.0,15.0,Bobby Portis,3,7,0.42857142857142855
5397,10/31/2022,27.720547945205478,W,0,27.766666666666666,6,11,0.545,2,4,0.5,1,3,0.333,3,9,12,2,0,0,1,1,15,13.7,-1.0,Bobby Portis,4,7,0.5714285714285714
5398,11/2/2022,27.726027397260275,W,0,24.033333333333335,5,9,0.556,0,3,0.0,0,0,,3,6,9,3,0,0,2,2,10,8.9,6.0,Bobby Portis,5,6,0.8333333333333334
5399,11/4/2022,27.731506849315068,W,0,30.433333333333334,7,14,0.5,2,6,0.333,2,2,1.0,0,8,8,5,0,0,1,1,18,15.5,8.0,Bobby Portis,5,8,0.625
5400,11/5/2022,27.734246575342464,W,1,29.266666666666666,5,15,0.333,2,5,0.4,0,0,,4,17,21,2,0,0,1,0,12,11.8,12.0,Bobby Portis,3,10,0.3
5401,11/7/2022,27.73972602739726,L,0,23.033333333333335,4,8,0.5,2,5,0.4,1,2,0.5,1,9,10,2,0,0,1,0,11,10.4,-4.0,Bobby Portis,2,3,0.6666666666666666
5402,11/9/2022,27.745205479452054,W,1,34.25,4,12,0.333,1,1,1.0,4,4,1.0,1,8,9,2,1,0,2,2,13,8.9,6.0,Bobby Portis,3,11,0.2727272727272727
5403,11/11/2022,27.75068493150685,L,1,31.0,6,15,0.4,1,4,0.25,3,3,1.0,5,7,12,2,1,0,2,0,16,13.9,-7.0,Bobby Portis,5,11,0.45454545454545453
5404,11/14/2022,27.75890410958904,L,0,22.983333333333334,6,15,0.4,0,5,0.0,2,3,0.667,3,7,10,2,0,0,1,5,14,8.1,0.0,Bobby Portis,6,10,0.6
5405,11/16/2022,27.764383561643836,W,1,29.716666666666665,4,8,0.5,0,1,0.0,2,2,1.0,0,11,11,2,1,0,1,1,10,10.3,18.0,Bobby Portis,4,7,0.5714285714285714
5406,11/18/2022,27.76986301369863,L,1,33.88333333333333,9,13,0.692,3,6,0.5,0,0,,4,7,11,3,1,0,0,4,21,21.9,-12.0,Bobby Portis,6,7,0.8571428571428571
5407,11/21/2022,27.778082191780822,W,0,24.066666666666666,6,11,0.545,1,3,0.333,0,0,,0,5,5,4,0,1,1,4,13,10.1,5.0,Bobby Portis,5,8,0.625
5408,11/23/2022,27.783561643835615,L,0,24.9,4,10,0.4,1,5,0.2,0,0,,3,9,12,1,1,2,3,3,9,7.3,-14.0,Bobby Portis,3,5,0.6
5409,11/25/2022,27.78904109589041,W,0,25.433333333333334,6,10,0.6,2,3,0.667,0,0,,1,7,8,4,0,1,3,1,14,12.3,4.0,Bobby Portis,4,7,0.5714285714285714
5410,11/27/2022,27.794520547945204,W,0,31.633333333333333,7,12,0.583,1,5,0.2,0,0,,1,9,10,1,0,0,0,3,15,12.3,10.0,Bobby Portis,6,7,0.8571428571428571
5411,10/20/2022,27.0986301369863,W,1,22.0,2,3,0.667,1,2,0.5,0,0,,1,3,4,1,1,0,3,2,5,3.2,3.0,Jevon Carter,1,1,1.0
5412,10/22/2022,27.104109589041094,W,1,25.25,0,4,0.0,0,3,0.0,0,0,,0,1,1,4,2,0,3,4,0,-2.3,7.0,Jevon Carter,0,1,0.0
5413,10/26/2022,27.115068493150684,W,1,15.7,1,1,1.0,0,0,,0,0,,1,1,2,1,2,0,1,4,2,2.8,-9.0,Jevon Carter,1,1,1.0
5414,10/28/2022,27.12054794520548,W,1,33.46666666666667,5,13,0.385,4,11,0.364,0,0,,1,2,3,1,1,2,0,3,14,10.1,-2.0,Jevon Carter,1,2,0.5
5415,10/29/2022,27.123287671232877,W,1,25.766666666666666,1,4,0.25,0,2,0.0,0,0,,0,0,0,1,1,0,0,2,2,0.5,-8.0,Jevon Carter,1,2,0.5
5416,10/31/2022,27.12876712328767,W,1,24.133333333333333,0,5,0.0,0,3,0.0,0,0,,3,3,6,1,2,0,0,3,0,1.0,1.0,Jevon Carter,0,2,0.0
5417,11/2/2022,27.134246575342466,W,1,18.45,1,5,0.2,0,2,0.0,2,2,1.0,0,1,1,3,4,1,0,2,4,7.2,5.0,Jevon Carter,1,3,0.3333333333333333
5418,11/4/2022,27.13972602739726,W,1,19.733333333333334,2,3,0.667,2,3,0.667,0,0,,0,1,1,2,1,1,1,4,6,5.5,17.0,Jevon Carter,0,0,
5419,11/5/2022,27.14246575342466,W,1,30.666666666666668,6,12,0.5,5,9,0.556,1,1,1.0,0,2,2,0,1,1,2,2,18,11.5,-2.0,Jevon Carter,1,3,0.3333333333333333
5420,11/7/2022,27.147945205479452,L,1,26.45,1,4,0.25,0,0,,0,0,,0,3,3,5,2,3,0,2,2,7.3,-23.0,Jevon Carter,1,4,0.25
5421,11/9/2022,27.153424657534245,W,1,44.75,15,27,0.556,5,10,0.5,1,2,0.5,0,4,4,12,1,0,5,5,36,26.3,3.0,Jevon Carter,10,17,0.5882352941176471
5422,11/11/2022,27.15890410958904,L,1,32.95,7,15,0.467,5,7,0.714,2,3,0.667,1,1,2,6,1,0,4,3,21,13.9,-5.0,Jevon Carter,2,8,0.25
5423,11/14/2022,27.167123287671235,L,1,33.416666666666664,4,11,0.364,0,3,0.0,4,4,1.0,3,0,3,6,2,1,1,4,12,12.3,-8.0,Jevon Carter,4,8,0.5
5424,11/16/2022,27.172602739726027,W,1,31.85,5,10,0.5,1,3,0.333,0,0,,1,3,4,8,1,2,1,2,11,13.8,27.0,Jevon Carter,4,7,0.5714285714285714
5425,11/18/2022,27.17808219178082,L,1,27.283333333333335,3,9,0.333,1,5,0.2,0,0,,0,2,2,3,2,0,0,2,7,5.8,-1.0,Jevon Carter,2,4,0.5
5426,11/21/2022,27.186301369863013,W,1,25.833333333333332,2,3,0.667,1,1,1.0,0,0,,1,2,3,3,1,1,2,2,5,6.0,14.0,Jevon Carter,1,2,0.5
5427,11/23/2022,27.19178082191781,L,1,24.266666666666666,1,4,0.25,0,2,0.0,0,0,,0,5,5,2,0,0,0,4,2,0.9,5.0,Jevon Carter,1,2,0.5
5428,11/25/2022,27.197260273972603,W,1,24.533333333333335,6,9,0.667,5,6,0.833,1,1,1.0,0,3,3,2,2,0,2,4,18,14.8,17.0,Jevon Carter,1,3,0.3333333333333333
5429,11/27/2022,27.202739726027396,W,1,30.783333333333335,6,11,0.545,2,5,0.4,0,0,,0,3,3,6,1,0,2,1,14,12.4,20.0,Jevon Carter,4,6,0.6666666666666666
5430,10/20/2022,24.112328767123287,W,0,15.866666666666667,2,5,0.4,2,4,0.5,0,0,,0,3,3,0,0,0,0,1,6,3.8,-1.0,Jordan Nwora,0,1,0.0
5431,10/22/2022,24.117808219178084,W,0,17.666666666666668,4,6,0.667,1,1,1.0,0,0,,0,3,3,0,0,0,3,1,9,3.9,15.0,Jordan Nwora,3,5,0.6
5432,10/26/2022,24.12876712328767,W,0,16.65,1,2,0.5,1,1,1.0,0,0,,1,5,6,1,0,0,0,0,3,4.9,6.0,Jordan Nwora,0,1,0.0
5433,10/28/2022,24.134246575342466,W,0,11.85,0,6,0.0,0,2,0.0,0,0,,2,2,4,0,0,0,1,3,0,-4.4,-14.0,Jordan Nwora,0,4,0.0
5434,10/29/2022,24.136986301369863,W,0,15.0,3,6,0.5,2,4,0.5,3,3,1.0,1,2,3,0,0,0,1,1,11,7.9,1.0,Jordan Nwora,1,2,0.5
5435,10/31/2022,24.14246575342466,W,0,13.183333333333334,0,4,0.0,0,3,0.0,0,0,,0,2,2,1,1,0,0,1,0,-0.9,-3.0,Jordan Nwora,0,1,0.0
5436,11/2/2022,24.147945205479452,W,0,25.516666666666666,4,9,0.444,2,5,0.4,2,2,1.0,2,2,4,1,2,0,4,1,12,7.6,8.0,Jordan Nwora,2,4,0.5
5437,11/4/2022,24.153424657534245,W,0,13.066666666666666,0,2,0.0,0,1,0.0,0,0,,0,1,1,1,0,0,1,2,0,-2.2,-12.0,Jordan Nwora,0,1,0.0
5438,11/5/2022,24.156164383561645,W,0,22.3,4,10,0.4,1,5,0.2,3,3,1.0,0,3,3,1,1,0,0,0,12,9.2,-1.0,Jordan Nwora,3,5,0.6
5439,11/7/2022,24.161643835616438,L,0,17.066666666666666,1,6,0.167,0,2,0.0,2,2,1.0,1,5,6,0,0,1,0,2,4,2.3,-2.0,Jordan Nwora,1,4,0.25
5440,11/9/2022,24.167123287671235,W,0,17.3,1,9,0.111,1,5,0.2,2,2,1.0,1,6,7,0,0,0,0,0,5,1.6,-14.0,Jordan Nwora,0,4,0.0
5441,11/11/2022,24.172602739726027,L,1,29.05,3,13,0.231,1,4,0.25,1,1,1.0,3,4,7,5,0,0,0,0,8,6.9,-28.0,Jordan Nwora,2,9,0.2222222222222222
5442,11/14/2022,24.18082191780822,L,0,21.316666666666666,3,8,0.375,2,6,0.333,2,2,1.0,0,5,5,3,0,0,0,4,10,7.6,-8.0,Jordan Nwora,1,2,0.5
5443,11/16/2022,24.186301369863013,W,0,28.666666666666668,6,10,0.6,5,9,0.556,4,6,0.667,0,3,3,1,1,1,3,0,21,15.9,10.0,Jordan Nwora,1,1,1.0
5444,11/18/2022,24.19178082191781,L,0,24.666666666666668,3,6,0.5,2,3,0.667,0,0,,0,2,2,2,0,1,0,1,8,7.3,8.0,Jordan Nwora,1,3,0.3333333333333333
5445,11/21/2022,24.2,W,0,18.2,2,4,0.5,1,2,0.5,1,2,0.5,1,2,3,2,0,0,3,0,6,3.3,0.0,Jordan Nwora,1,2,0.5
5446,11/23/2022,24.205479452054796,L,0,6.366666666666666,0,3,0.0,0,2,0.0,0,0,,0,0,0,0,0,0,0,0,0,-2.1,-5.0,Jordan Nwora,0,1,0.0
5447,11/25/2022,24.21095890410959,W,0,24.366666666666667,2,8,0.25,0,2,0.0,3,3,1.0,1,4,5,2,0,0,1,3,7,3.3,-7.0,Jordan Nwora,2,6,0.3333333333333333
5448,11/27/2022,24.216438356164385,W,0,11.033333333333333,1,3,0.333,1,2,0.5,0,0,,2,1,3,2,0,0,0,0,3,4.4,-7.0,Jordan Nwora,0,1,0.0
5449,10/20/2022,36.463013698630135,W,0,20.533333333333335,2,2,1.0,0,0,,0,0,,0,1,1,0,0,0,2,2,4,0.9,3.0,George Hill,2,2,1.0
5450,10/22/2022,36.46849315068493,W,0,23.65,3,4,0.75,2,3,0.667,1,2,0.5,0,2,2,6,0,0,0,2,9,11.0,20.0,George Hill,1,1,1.0
5451,10/26/2022,36.47945205479452,W,0,29.816666666666666,2,3,0.667,0,1,0.0,4,4,1.0,1,2,3,4,1,0,1,3,8,9.6,12.0,George Hill,2,2,1.0
5452,10/28/2022,36.484931506849314,W,0,26.616666666666667,4,10,0.4,2,6,0.333,2,3,0.667,2,2,4,2,0,0,0,2,12,8.8,6.0,George Hill,2,4,0.5
5453,10/29/2022,36.487671232876714,W,0,16.616666666666667,0,1,0.0,0,1,0.0,0,0,,0,0,0,2,0,0,0,2,0,-0.1,9.0,George Hill,0,0,
5454,10/31/2022,36.49315068493151,W,0,17.433333333333334,0,3,0.0,0,3,0.0,3,4,0.75,0,1,1,2,0,0,0,1,3,1.8,-10.0,George Hill,0,0,
5455,11/2/2022,36.4986301369863,W,0,18.35,2,6,0.333,1,3,0.333,2,3,0.667,0,4,4,3,0,0,0,1,7,6.1,6.0,George Hill,1,3,0.3333333333333333
5456,11/4/2022,36.50410958904109,W,0,17.866666666666667,1,3,0.333,0,1,0.0,0,0,,0,0,0,1,1,0,0,0,2,2.0,-5.0,George Hill,1,2,0.5
5457,11/5/2022,36.50684931506849,W,0,21.183333333333334,1,2,0.5,0,0,,0,2,0.0,0,2,2,2,0,0,3,3,2,-2.0,17.0,George Hill,1,2,0.5
5458,11/7/2022,36.512328767123286,L,0,16.766666666666666,1,4,0.25,0,2,0.0,0,0,,0,0,0,0,0,0,0,0,2,-0.4,-8.0,George Hill,1,2,0.5
5459,11/9/2022,36.51780821917808,W,0,35.4,3,6,0.5,1,1,1.0,5,6,0.833,0,2,2,5,3,0,1,1,12,14.3,-4.0,George Hill,2,5,0.4
5460,11/11/2022,36.52328767123288,L,0,27.65,1,9,0.111,0,5,0.0,3,4,0.75,2,0,2,4,0,1,1,1,5,2.2,-1.0,George Hill,1,4,0.25
5461,11/14/2022,36.53150684931507,L,0,25.883333333333333,0,1,0.0,0,0,,2,2,1.0,0,3,3,3,0,1,2,0,2,3.0,-3.0,George Hill,0,1,0.0
5462,11/16/2022,36.536986301369865,W,0,18.983333333333334,3,6,0.5,1,4,0.25,0,0,,1,2,3,3,0,0,2,4,7,3.8,-5.0,George Hill,2,2,1.0
5463,11/18/2022,36.54246575342466,L,0,13.883333333333333,2,5,0.4,2,4,0.5,1,2,0.5,0,0,0,2,1,0,0,1,7,5.9,-1.0,George Hill,0,1,0.0
5464,11/21/2022,36.55068493150685,W,0,19.75,0,1,0.0,0,1,0.0,0,0,,0,5,5,5,2,1,0,0,0,7.0,5.0,George Hill,0,0,
5465,11/23/2022,36.556164383561644,L,0,18.6,3,7,0.429,2,4,0.5,2,2,1.0,0,1,1,0,0,0,0,0,10,6.6,-13.0,George Hill,1,3,0.3333333333333333
5466,11/25/2022,36.56164383561644,W,0,20.033333333333335,2,5,0.4,1,3,0.333,0,2,0.0,0,2,2,2,0,0,1,2,5,1.7,4.0,George Hill,1,2,0.5
5467,11/27/2022,36.56712328767123,W,0,15.366666666666667,2,2,1.0,1,1,1.0,0,0,,0,2,2,2,0,0,1,2,5,4.6,0.0,George Hill,1,1,1.0
5468,10/20/2022,27.03287671232877,W,1,32.06666666666667,3,10,0.3,2,6,0.333,4,5,0.8,0,3,3,4,0,0,3,1,12,6.1,-1.0,Grayson Allen,1,4,0.25
5469,10/22/2022,27.03835616438356,W,1,27.866666666666667,3,11,0.273,2,7,0.286,3,4,0.75,2,3,5,2,1,0,0,2,11,8.0,4.0,Grayson Allen,1,4,0.25
5470,10/26/2022,27.04931506849315,W,1,28.133333333333333,1,8,0.125,1,6,0.167,2,2,1.0,0,5,5,4,0,0,1,0,5,3.1,17.0,Grayson Allen,0,2,0.0
5471,10/28/2022,27.054794520547944,W,1,28.783333333333335,6,10,0.6,4,6,0.667,1,1,1.0,1,3,4,2,1,0,1,2,17,14.6,23.0,Grayson Allen,2,4,0.5
5472,10/29/2022,27.057534246575344,W,1,20.1,1,5,0.2,0,3,0.0,0,0,,1,1,2,0,1,0,0,0,2,0.9,-4.0,Grayson Allen,1,2,0.5
5473,10/31/2022,27.063013698630137,W,1,19.883333333333333,2,4,0.5,1,3,0.333,4,4,1.0,0,2,2,2,1,0,4,1,9,5.6,11.0,Grayson Allen,1,1,1.0
5474,11/2/2022,27.068493150684933,W,1,24.983333333333334,2,6,0.333,1,4,0.25,0,0,,0,1,1,4,1,0,0,3,5,4.5,18.0,Grayson Allen,1,2,0.5
5475,11/4/2022,27.073972602739726,W,1,29.933333333333334,3,5,0.6,2,3,0.667,2,2,1.0,3,2,5,2,2,0,2,2,10,11.0,25.0,Grayson Allen,1,2,0.5
5476,11/5/2022,27.076712328767123,W,0,20.883333333333333,6,8,0.75,5,6,0.833,2,2,1.0,0,1,1,1,2,1,2,0,19,17.5,8.0,Grayson Allen,1,2,0.5
5477,11/7/2022,27.08219178082192,L,1,27.733333333333334,3,8,0.375,3,7,0.429,2,2,1.0,0,0,0,3,0,1,3,3,11,5.2,-17.0,Grayson Allen,0,1,0.0
5478,11/9/2022,27.087671232876712,W,1,35.03333333333333,5,8,0.625,2,3,0.667,6,6,1.0,1,2,3,6,0,1,3,5,18,15.6,10.0,Grayson Allen,3,5,0.6
5479,11/14/2022,27.101369863013698,L,1,9.616666666666667,0,2,0.0,0,0,,2,2,1.0,1,0,1,0,1,0,0,0,2,2.3,-6.0,Grayson Allen,0,2,0.0
5480,11/18/2022,27.112328767123287,L,0,26.6,3,6,0.5,1,3,0.333,0,0,,2,2,4,1,1,1,1,1,7,7.0,0.0,Grayson Allen,2,3,0.6666666666666666
5481,11/21/2022,27.12054794520548,W,1,31.8,5,8,0.625,2,5,0.4,5,5,1.0,2,6,8,2,0,0,0,2,17,17.2,9.0,Grayson Allen,3,3,1.0
5482,11/23/2022,27.126027397260273,L,1,32.8,4,8,0.5,2,4,0.5,3,3,1.0,3,1,4,2,0,0,1,2,13,11.0,2.0,Grayson Allen,2,4,0.5
5483,11/25/2022,27.13150684931507,W,1,28.25,2,8,0.25,1,6,0.167,3,3,1.0,0,5,5,5,2,0,1,0,8,9.2,9.0,Grayson Allen,1,2,0.5
5484,11/27/2022,27.136986301369863,W,1,31.9,8,10,0.8,7,8,0.875,2,4,0.5,0,2,2,5,2,1,0,2,25,26.4,20.0,Grayson Allen,1,2,0.5
5485,10/20/2022,27.87123287671233,W,1,36.083333333333336,9,16,0.563,1,3,0.333,2,5,0.4,0,13,13,8,1,3,1,4,21,22.2,13.0,Giannis Antetokounmpo,8,13,0.6153846153846154
5486,10/22/2022,27.876712328767123,W,1,27.633333333333333,17,21,0.81,2,3,0.667,8,13,0.615,2,10,12,3,0,0,4,2,44,35.8,23.0,Giannis Antetokounmpo,15,18,0.8333333333333334
5487,10/26/2022,27.887671232876713,W,1,37.86666666666667,16,25,0.64,1,4,0.25,10,14,0.714,2,12,14,5,1,3,7,4,43,33.3,5.0,Giannis Antetokounmpo,15,21,0.7142857142857143
5488,10/28/2022,27.893150684931506,W,1,38.916666666666664,11,22,0.5,1,6,0.167,7,11,0.636,0,14,14,9,1,1,2,0,30,27.6,27.0,Giannis Antetokounmpo,10,16,0.625
5489,10/29/2022,27.895890410958906,W,1,32.61666666666667,11,22,0.5,1,1,1.0,11,19,0.579,5,12,17,4,0,1,2,4,34,26.8,-10.0,Giannis Antetokounmpo,10,21,0.47619047619047616
5490,10/31/2022,27.9013698630137,W,1,31.733333333333334,12,23,0.522,0,4,0.0,7,9,0.778,2,5,7,2,0,2,4,5,31,18.6,-1.0,Giannis Antetokounmpo,12,19,0.631578947368421
5491,11/2/2022,27.90684931506849,W,1,29.516666666666666,11,24,0.458,0,4,0.0,10,12,0.833,5,7,12,4,5,2,1,1,32,32.2,12.0,Giannis Antetokounmpo,11,20,0.55
5492,11/4/2022,27.912328767123288,W,1,33.583333333333336,7,17,0.412,2,4,0.5,10,20,0.5,0,14,14,11,0,0,4,3,26,19.6,25.0,Giannis Antetokounmpo,5,13,0.38461538461538464
5493,11/7/2022,27.92054794520548,L,1,26.783333333333335,9,20,0.45,0,1,0.0,7,8,0.875,1,6,7,2,2,1,5,3,25,14.6,-22.0,Giannis Antetokounmpo,9,19,0.47368421052631576
5494,11/14/2022,27.93972602739726,L,1,30.916666666666668,8,21,0.381,0,3,0.0,11,18,0.611,1,7,8,4,1,0,8,6,27,8.9,-13.0,Giannis Antetokounmpo,8,18,0.4444444444444444
5495,11/16/2022,27.945205479452056,W,1,31.533333333333335,6,18,0.333,0,2,0.0,4,11,0.364,2,10,12,8,0,0,2,1,16,10.6,10.0,Giannis Antetokounmpo,6,16,0.375
5496,11/18/2022,27.95068493150685,L,1,34.266666666666666,10,22,0.455,1,5,0.2,4,15,0.267,0,14,14,4,1,1,5,4,25,11.3,-12.0,Giannis Antetokounmpo,9,17,0.5294117647058824
5497,11/21/2022,27.958904109589042,W,1,35.083333333333336,16,24,0.667,0,1,0.0,5,12,0.417,2,5,7,6,2,0,1,3,37,30.7,19.0,Giannis Antetokounmpo,16,23,0.6956521739130435
5498,11/23/2022,27.964383561643835,L,1,34.0,15,27,0.556,0,2,0.0,6,9,0.667,3,8,11,7,0,0,8,5,36,21.3,5.0,Giannis Antetokounmpo,15,25,0.6
5499,11/25/2022,27.96986301369863,W,1,30.966666666666665,13,20,0.65,2,3,0.667,10,14,0.714,3,6,9,6,0,2,3,3,38,32.9,15.0,Giannis Antetokounmpo,11,17,0.6470588235294118
5500,11/27/2022,27.975342465753425,W,1,29.4,11,19,0.579,0,2,0.0,8,10,0.8,3,8,11,4,1,0,3,5,30,23.6,16.0,Giannis Antetokounmpo,11,17,0.6470588235294118
5501,10/20/2022,36.016438356164386,W,0,20.383333333333333,3,6,0.5,2,4,0.5,0,0,,3,2,5,2,0,1,0,1,8,9.4,2.0,Wesley Matthews,1,2,0.5
5502,10/22/2022,36.02191780821918,W,0,12.066666666666666,0,1,0.0,0,1,0.0,0,0,,0,1,1,0,0,0,0,1,0,-0.8,10.0,Wesley Matthews,0,0,
5503,10/26/2022,36.032876712328765,W,0,21.9,2,7,0.286,2,7,0.286,1,2,0.5,0,0,0,1,0,0,1,5,7,0.2,-3.0,Wesley Matthews,0,0,
5504,10/28/2022,36.038356164383565,W,0,4.233333333333333,0,1,0.0,0,0,,2,2,1.0,0,1,1,0,2,0,0,0,2,3.6,-1.0,Wesley Matthews,0,1,0.0
5505,10/29/2022,36.04109589041096,W,0,17.55,2,5,0.4,1,3,0.333,0,0,,4,3,7,1,1,1,2,1,5,6.0,14.0,Wesley Matthews,1,2,0.5
5506,10/31/2022,36.04657534246575,W,0,20.95,1,3,0.333,1,3,0.333,0,0,,1,2,3,0,0,0,0,3,3,1.4,-3.0,Wesley Matthews,0,0,
5507,11/2/2022,36.05205479452055,W,0,14.8,1,4,0.25,1,4,0.25,0,0,,0,0,0,0,2,0,2,1,3,0.2,6.0,Wesley Matthews,0,0,
5508,11/4/2022,36.057534246575344,W,0,10.15,1,1,1.0,1,1,1.0,0,0,,0,1,1,1,1,0,0,3,3,3.5,-7.0,Wesley Matthews,0,0,
5509,11/5/2022,36.06027397260274,W,0,13.25,0,3,0.0,0,2,0.0,0,0,,4,1,5,1,0,0,0,0,0,1.7,2.0,Wesley Matthews,0,1,0.0
5510,11/7/2022,36.06575342465754,L,0,13.433333333333334,2,5,0.4,2,4,0.5,0,0,,0,1,1,1,0,0,0,2,6,3.5,-11.0,Wesley Matthews,0,1,0.0
5511,11/9/2022,36.07123287671233,W,0,29.116666666666667,2,4,0.5,1,1,1.0,0,0,,1,3,4,0,0,0,1,3,5,2.4,-3.0,Wesley Matthews,1,3,0.3333333333333333
5512,11/11/2022,36.07671232876712,L,0,22.483333333333334,0,5,0.0,0,5,0.0,2,2,1.0,0,2,2,1,3,2,0,1,2,3.8,4.0,Wesley Matthews,0,0,
5513,11/14/2022,36.084931506849315,L,0,12.116666666666667,0,3,0.0,0,2,0.0,0,0,,0,0,0,0,0,0,0,1,0,-2.5,-12.0,Wesley Matthews,0,1,0.0
5514,11/23/2022,36.10958904109589,L,0,16.85,2,3,0.667,2,3,0.667,0,0,,0,0,0,0,0,0,0,2,6,3.9,-12.0,Wesley Matthews,0,0,
5515,11/25/2022,36.11506849315069,W,0,17.266666666666666,2,4,0.5,1,3,0.333,0,0,,1,0,1,1,0,0,0,2,5,3.6,25.0,Wesley Matthews,1,1,1.0
5516,11/27/2022,36.12054794520548,W,0,8.883333333333333,0,1,0.0,0,1,0.0,0,0,,1,0,1,0,0,0,0,2,0,-0.8,1.0,Wesley Matthews,0,0,
5517,10/20/2022,32.35616438356164,W,1,35.78333333333333,2,15,0.133,0,6,0.0,2,2,1.0,1,3,4,8,2,0,1,1,6,4.1,-6.0,Jrue Holiday,2,9,0.2222222222222222
5518,10/22/2022,32.36164383561644,W,1,32.15,8,15,0.533,3,4,0.75,0,0,,0,5,5,10,0,3,2,2,19,19.5,8.0,Jrue Holiday,5,11,0.45454545454545453
5519,10/26/2022,32.37260273972603,W,1,35.93333333333333,5,18,0.278,1,6,0.167,4,5,0.8,3,4,7,4,2,1,5,4,15,6.2,10.0,Jrue Holiday,4,12,0.3333333333333333
5520,10/28/2022,32.37808219178082,W,1,31.95,6,19,0.316,2,6,0.333,2,2,1.0,0,5,5,6,2,1,1,3,16,11.3,17.0,Jrue Holiday,4,13,0.3076923076923077
5521,10/29/2022,32.38082191780822,W,1,36.666666666666664,13,22,0.591,3,7,0.429,5,7,0.714,0,2,2,12,4,1,3,3,34,32.5,12.0,Jrue Holiday,10,15,0.6666666666666666
5522,10/31/2022,32.38630136986301,W,1,37.31666666666667,7,15,0.467,5,11,0.455,6,7,0.857,1,6,7,10,1,0,4,1,25,23.0,10.0,Jrue Holiday,2,4,0.5
5523,11/2/2022,32.391780821917806,W,1,29.966666666666665,11,16,0.688,4,7,0.571,0,0,,2,5,7,3,0,0,2,1,26,21.8,25.0,Jrue Holiday,7,9,0.7777777777777778
5524,11/4/2022,32.397260273972606,W,1,33.61666666666667,12,24,0.5,4,11,0.364,1,1,1.0,1,7,8,6,2,0,0,0,29,26.0,15.0,Jrue Holiday,8,13,0.6153846153846154
5525,11/5/2022,32.4,W,1,28.833333333333332,3,10,0.3,0,3,0.0,4,4,1.0,4,2,6,13,1,0,3,0,10,14.7,8.0,Jrue Holiday,3,7,0.42857142857142855
5526,11/7/2022,32.40547945205479,L,1,28.816666666666666,7,14,0.5,2,6,0.333,0,0,,1,5,6,7,1,1,8,2,16,9.0,-3.0,Jrue Holiday,5,8,0.625
5527,11/18/2022,32.43561643835616,L,0,23.2,5,12,0.417,0,4,0.0,0,0,,1,2,3,4,1,0,5,2,10,2.9,-9.0,Jrue Holiday,5,8,0.625
5528,11/21/2022,32.443835616438356,W,1,27.933333333333334,7,14,0.5,1,6,0.167,2,2,1.0,1,3,4,6,3,0,5,1,17,13.4,7.0,Jrue Holiday,6,8,0.75
5529,11/23/2022,32.44931506849315,L,1,35.833333333333336,3,6,0.5,1,4,0.25,7,8,0.875,1,4,5,11,2,0,7,1,14,14.8,12.0,Jrue Holiday,2,2,1.0
5530,11/25/2022,32.45479452054794,W,1,23.033333333333335,4,13,0.308,1,3,0.333,0,0,,2,1,3,5,0,0,1,4,9,4.1,13.0,Jrue Holiday,3,10,0.3
5531,11/27/2022,32.46027397260274,W,1,34.45,7,16,0.438,2,6,0.333,0,0,,1,0,1,6,3,0,3,2,16,11.7,17.0,Jrue Holiday,5,10,0.5
5532,10/22/2022,22.027397260273972,W,0,2.2333333333333334,1,1,1.0,0,0,,0,0,,0,0,0,0,0,0,0,0,2,1.7,-2.0,MarJon Beauchamp,1,1,1.0
5533,10/29/2022,22.046575342465754,W,0,6.8,1,1,1.0,1,1,1.0,0,0,,0,0,0,0,0,0,2,1,3,0.3,1.0,MarJon Beauchamp,0,0,
5534,10/31/2022,22.052054794520547,W,0,3.6666666666666665,0,2,0.0,0,1,0.0,0,0,,0,1,1,0,0,1,0,0,0,-0.4,-3.0,MarJon Beauchamp,0,1,0.0
5535,11/2/2022,22.057534246575344,W,0,16.1,0,3,0.0,0,3,0.0,3,4,0.75,1,3,4,1,2,0,2,2,3,2.0,12.0,MarJon Beauchamp,0,0,
5536,11/4/2022,22.063013698630137,W,0,18.383333333333333,6,10,0.6,2,4,0.5,0,1,0.0,0,5,5,0,0,0,2,2,14,7.7,2.0,MarJon Beauchamp,4,6,0.6666666666666666
5537,11/5/2022,22.065753424657533,W,1,24.8,1,9,0.111,0,6,0.0,0,0,,3,2,5,0,1,0,2,6,2,-4.6,12.0,MarJon Beauchamp,1,3,0.3333333333333333
5538,11/7/2022,22.07123287671233,L,0,10.55,1,4,0.25,1,4,0.25,1,2,0.5,0,2,2,0,0,0,0,1,4,1.4,4.0,MarJon Beauchamp,0,0,
5539,11/9/2022,22.076712328767123,W,1,29.916666666666668,7,13,0.538,5,8,0.625,0,0,,3,5,8,0,2,0,2,5,19,14.3,14.0,MarJon Beauchamp,2,5,0.4
5540,11/11/2022,22.08219178082192,L,1,34.38333333333333,4,13,0.308,0,6,0.0,0,0,,1,3,4,2,1,0,0,2,8,3.7,-24.0,MarJon Beauchamp,4,7,0.5714285714285714
5541,11/14/2022,22.09041095890411,L,1,34.18333333333333,7,9,0.778,3,4,0.75,3,3,1.0,2,6,8,1,0,1,2,2,20,18.3,-14.0,MarJon Beauchamp,4,5,0.8
5542,11/16/2022,22.095890410958905,W,1,26.633333333333333,1,8,0.125,0,3,0.0,0,0,,4,1,5,1,0,0,2,2,2,-2.2,7.0,MarJon Beauchamp,1,5,0.2
5543,11/18/2022,22.101369863013698,L,1,14.583333333333334,0,3,0.0,0,1,0.0,0,0,,0,2,2,1,0,0,1,1,0,-2.2,-4.0,MarJon Beauchamp,0,2,0.0
5544,11/21/2022,22.10958904109589,W,0,5.2,0,1,0.0,0,0,,0,0,,0,0,0,0,1,0,1,1,0,-1.1,-9.0,MarJon Beauchamp,0,1,0.0
5545,11/25/2022,22.12054794520548,W,0,3.05,1,1,1.0,0,0,,0,0,,0,0,0,0,0,0,1,1,2,0.3,-7.0,MarJon Beauchamp,1,1,1.0
5546,11/27/2022,22.126027397260273,W,0,1.9666666666666668,0,0,,0,0,,0,0,,0,0,0,0,0,0,1,0,0,-1.0,-5.0,MarJon Beauchamp,0,0,
5547,10/20/2022,33.087671232876716,W,0,3.65,0,1,0.0,0,1,0.0,0,0,,0,1,1,0,0,0,1,1,0,-1.8,-1.0,Serge Ibaka,0,0,
5548,10/22/2022,33.09315068493151,W,0,14.85,3,5,0.6,2,2,1.0,1,2,0.5,1,4,5,0,0,1,0,3,9,7.7,7.0,Serge Ibaka,1,3,0.3333333333333333
5549,10/28/2022,33.10958904109589,W,0,5.483333333333333,1,2,0.5,0,0,,0,0,,1,1,2,0,0,1,1,2,2,0.9,2.0,Serge Ibaka,1,2,0.5
5550,10/29/2022,33.11232876712329,W,0,10.65,1,2,0.5,0,1,0.0,0,0,,1,1,2,0,0,0,0,1,2,1.6,-6.0,Serge Ibaka,1,1,1.0
5551,10/31/2022,33.11780821917808,W,0,9.516666666666667,0,1,0.0,0,0,,0,0,,0,0,0,0,0,0,2,1,0,-3.1,-3.0,Serge Ibaka,0,1,0.0
5552,11/2/2022,33.12328767123287,W,0,5.616666666666667,1,2,0.5,1,1,1.0,0,0,,0,2,2,0,0,1,0,1,3,2.9,-1.0,Serge Ibaka,0,1,0.0
5553,11/5/2022,33.131506849315066,W,0,24.083333333333332,2,5,0.4,0,2,0.0,4,4,1.0,1,5,6,2,0,2,2,2,8,7.5,1.0,Serge Ibaka,2,3,0.6666666666666666
5554,11/7/2022,33.136986301369866,L,0,11.533333333333333,2,2,1.0,0,0,,0,0,,1,3,4,0,0,0,0,1,4,4.6,2.0,Serge Ibaka,2,2,1.0
5555,11/9/2022,33.14246575342466,W,0,12.25,2,2,1.0,0,0,,0,0,,0,2,2,1,0,1,1,1,4,4.0,-4.0,Serge Ibaka,2,2,1.0
5556,11/11/2022,33.14794520547945,L,0,18.7,4,9,0.444,1,3,0.333,2,5,0.4,5,4,9,0,0,0,0,2,11,9.0,-3.0,Serge Ibaka,3,6,0.5
5557,11/14/2022,33.156164383561645,L,0,13.3,2,3,0.667,1,2,0.5,0,0,,0,3,3,0,0,0,0,2,5,3.8,-8.0,Serge Ibaka,1,1,1.0
5558,11/16/2022,33.16164383561644,W,0,17.55,4,6,0.667,1,2,0.5,0,0,,2,2,4,1,0,0,1,1,9,7.7,-6.0,Serge Ibaka,3,4,0.75
5559,11/18/2022,33.16712328767123,L,0,7.25,1,2,0.5,0,0,,0,0,,0,0,0,0,0,0,0,0,2,1.0,-4.0,Serge Ibaka,1,2,0.5
5560,11/21/2022,33.175342465753424,W,0,4.183333333333334,0,2,0.0,0,0,,1,2,0.5,0,0,0,0,0,0,0,2,1,-1.6,0.0,Serge Ibaka,0,2,0.0
5561,10/22/2022,30.263013698630136,W,0,0.8666666666666667,0,0,,0,0,,0,0,,0,0,0,0,0,0,0,0,0,0.0,0.0,Thanasis Antetokounmpo,0,0,
5562,11/2/2022,30.293150684931508,W,0,5.616666666666667,0,0,,0,0,,0,0,,0,1,1,0,0,0,0,0,0,0.3,-1.0,Thanasis Antetokounmpo,0,0,
5563,11/4/2022,30.2986301369863,W,0,0.5333333333333333,0,0,,0,0,,0,0,,0,0,0,0,0,0,0,1,0,-0.4,-1.0,Thanasis Antetokounmpo,0,0,
5564,11/5/2022,30.301369863013697,W,0,0.9666666666666667,0,0,,0,0,,0,0,,0,1,1,0,0,1,0,0,0,1.0,0.0,Thanasis Antetokounmpo,0,0,
5565,11/7/2022,30.306849315068494,L,0,3.85,0,0,,0,0,,0,0,,0,0,0,1,0,0,0,0,0,0.7,4.0,Thanasis Antetokounmpo,0,0,
5566,11/11/2022,30.317808219178083,L,0,5.766666666666667,0,1,0.0,0,0,,0,0,,1,2,3,0,0,0,1,1,0,-0.8,-7.0,Thanasis Antetokounmpo,0,1,0.0
5567,11/14/2022,30.326027397260273,L,0,1.5833333333333335,0,0,,0,0,,0,0,,0,0,0,0,0,0,0,0,0,0.0,0.0,Thanasis Antetokounmpo,0,0,
5568,11/16/2022,30.33150684931507,W,0,1.9166666666666665,0,0,,0,0,,0,0,,1,1,2,1,0,0,1,0,0,0.7,0.0,Thanasis Antetokounmpo,0,0,
5569,11/25/2022,30.356164383561644,W,0,3.05,0,0,,0,0,,0,0,,0,1,1,0,0,0,0,0,0,0.3,-7.0,Thanasis Antetokounmpo,0,0,
5570,11/27/2022,30.361643835616437,W,0,1.1333333333333333,0,0,,0,0,,0,0,,0,0,0,0,0,0,0,0,0,0.0,-3.0,Thanasis Antetokounmpo,0,0,
5571,10/22/2022,23.416438356164385,W,0,2.2333333333333334,0,0,,0,0,,0,0,,0,0,0,0,0,0,1,0,0,-1.0,-2.0,Sandro Mamukelashvili,0,0,
5572,11/7/2022,23.46027397260274,L,0,6.15,1,3,0.333,0,2,0.0,0,0,,0,0,0,0,0,0,0,0,2,0.3,3.0,Sandro Mamukelashvili,1,1,1.0
5573,11/9/2022,23.465753424657535,W,0,6.25,0,2,0.0,0,1,0.0,0,0,,0,3,3,0,0,0,0,1,0,-0.9,2.0,Sandro Mamukelashvili,0,1,0.0
5574,11/11/2022,23.471232876712328,L,0,8.466666666666667,1,4,0.25,1,2,0.5,0,0,,2,2,4,0,0,0,0,0,3,2.6,-2.0,Sandro Mamukelashvili,0,2,0.0
5575,11/14/2022,23.47945205479452,L,0,1.5833333333333335,1,1,1.0,0,0,,0,0,,0,0,0,1,0,0,0,0,2,2.4,0.0,Sandro Mamukelashvili,1,1,1.0
5576,11/16/2022,23.484931506849314,W,0,7.566666666666666,1,3,0.333,0,2,0.0,3,6,0.5,0,0,0,0,0,0,0,1,5,1.7,3.0,Sandro Mamukelashvili,1,1,1.0
5577,11/21/2022,23.4986301369863,W,0,1.3833333333333333,1,1,1.0,0,0,,0,0,,1,0,1,0,0,0,0,0,2,2.4,-6.0,Sandro Mamukelashvili,1,1,1.0
5578,11/25/2022,23.50958904109589,W,0,9.433333333333334,1,2,0.5,0,1,0.0,1,2,0.5,0,1,1,0,0,0,0,1,3,1.5,-4.0,Sandro Mamukelashvili,1,1,1.0
5579,11/27/2022,23.515068493150686,W,0,7.2,0,1,0.0,0,0,,0,0,,0,2,2,0,0,0,1,1,0,-1.5,-9.0,Sandro Mamukelashvili,0,1,0.0
5580,10/22/2022,23.068493150684933,W,0,2.2333333333333334,0,0,,0,0,,0,0,,0,0,0,1,0,0,0,0,0,0.7,-2.0,A.J. Green,0,0,
5581,11/16/2022,23.136986301369863,W,0,15.25,1,4,0.25,1,4,0.25,0,0,,1,2,3,0,1,0,0,2,3,2.1,-11.0,A.J. Green,0,0,
5582,11/21/2022,23.15068493150685,W,0,0.65,0,0,,0,0,,0,0,,0,0,0,0,0,0,0,0,0,0.0,-5.0,A.J. Green,0,0,
5583,11/25/2022,23.161643835616438,W,0,3.05,0,0,,0,0,,0,0,,0,1,1,0,0,0,0,1,0,-0.1,-7.0,A.J. Green,0,0,
5584,11/27/2022,23.167123287671235,W,0,1.9666666666666668,0,1,0.0,0,1,0.0,0,0,,0,0,0,0,0,0,0,1,0,-1.1,-5.0,A.J. Green,0,0,
5585,11/21/2022,29.873972602739727,W,0,15.516666666666667,2,5,0.4,1,4,0.25,2,2,1.0,0,2,2,1,2,0,0,1,7,7.2,3.0,Pat Connaughton,1,1,1.0
5586,11/23/2022,29.87945205479452,L,0,14.4,1,6,0.167,1,5,0.2,0,0,,0,3,3,1,1,0,0,0,3,1.8,1.0,Pat Connaughton,0,1,0.0
5587,11/27/2022,29.89041095890411,W,0,10.866666666666667,1,3,0.333,1,3,0.333,0,0,,0,1,1,0,0,0,0,0,3,1.6,-9.0,Pat Connaughton,0,0,
5588,10/19/2022,21.336986301369862,L,1,35.583333333333336,5,9,0.556,1,3,0.333,3,4,0.75,0,6,6,1,1,1,3,1,14,10.1,-14.0,Evan Mobley,4,6,0.6666666666666666
5589,10/22/2022,21.345205479452055,W,1,24.766666666666666,7,9,0.778,0,0,,2,2,1.0,1,2,3,1,1,1,3,1,16,12.8,7.0,Evan Mobley,7,9,0.7777777777777778
5590,10/23/2022,21.34794520547945,W,1,36.583333333333336,2,7,0.286,0,0,,6,6,1.0,2,5,7,2,2,1,2,3,10,9.7,-3.0,Evan Mobley,2,7,0.2857142857142857
5591,10/26/2022,21.356164383561644,W,1,34.43333333333333,9,15,0.6,0,0,,2,4,0.5,0,3,3,3,1,1,3,4,20,12.4,3.0,Evan Mobley,9,15,0.6
5592,10/28/2022,21.361643835616437,W,1,41.983333333333334,7,12,0.583,1,3,0.333,4,6,0.667,3,7,10,3,1,2,2,4,19,17.7,2.0,Evan Mobley,6,9,0.6666666666666666
5593,10/30/2022,21.367123287671234,W,1,34.25,6,13,0.462,0,2,0.0,4,4,1.0,2,5,7,3,1,1,2,5,16,12.0,18.0,Evan Mobley,6,11,0.5454545454545454
5594,11/2/2022,21.375342465753423,W,1,32.0,7,8,0.875,0,1,0.0,1,2,0.5,2,5,7,2,0,0,3,3,15,11.9,15.0,Evan Mobley,7,7,1.0
5595,11/4/2022,21.38082191780822,W,1,30.2,5,14,0.357,0,1,0.0,1,2,0.5,2,6,8,2,0,8,1,0,11,12.0,0.0,Evan Mobley,5,13,0.38461538461538464
5596,11/6/2022,21.386301369863013,W,1,30.45,2,7,0.286,0,1,0.0,1,2,0.5,2,5,7,3,2,1,1,3,5,6.0,1.0,Evan Mobley,2,6,0.3333333333333333
5597,11/7/2022,21.389041095890413,L,1,33.68333333333333,12,18,0.667,0,0,,2,2,1.0,3,5,8,1,0,0,3,6,26,17.1,-20.0,Evan Mobley,12,18,0.6666666666666666
5598,11/9/2022,21.394520547945206,L,1,35.75,7,10,0.7,0,0,,2,3,0.667,1,5,6,0,1,0,2,3,16,11.4,-1.0,Evan Mobley,7,10,0.7
5599,11/11/2022,21.4,L,1,38.75,8,15,0.533,0,0,,4,5,0.8,8,5,13,4,0,2,3,3,20,19.4,1.0,Evan Mobley,8,15,0.5333333333333333
5600,11/13/2022,21.405479452054795,L,1,32.2,1,4,0.25,0,0,,2,6,0.333,5,8,13,3,2,0,3,4,4,5.4,-14.0,Evan Mobley,1,4,0.25
5601,11/16/2022,21.413698630136988,L,1,31.15,9,14,0.643,0,0,,2,4,0.5,3,4,7,2,1,2,0,3,20,18.9,-13.0,Evan Mobley,9,14,0.6428571428571429
5602,11/18/2022,21.41917808219178,W,1,45.43333333333333,9,14,0.643,0,1,0.0,3,4,0.75,5,13,18,5,1,2,1,4,21,25.1,15.0,Evan Mobley,9,13,0.6923076923076923
5603,11/20/2022,21.424657534246574,W,1,30.0,7,12,0.583,0,0,,1,2,0.5,4,6,10,5,1,0,3,2,15,14.3,15.0,Evan Mobley,7,12,0.5833333333333334
5604,11/21/2022,21.427397260273974,W,1,35.55,4,6,0.667,0,0,,2,2,1.0,2,7,9,3,1,1,4,2,10,9.9,5.0,Evan Mobley,4,6,0.6666666666666666
5605,11/23/2022,21.432876712328767,W,1,35.1,4,10,0.4,0,0,,2,4,0.5,4,8,12,3,0,3,2,2,10,10.4,0.0,Evan Mobley,4,10,0.4
5606,11/25/2022,21.438356164383563,L,1,29.083333333333332,2,12,0.167,0,1,0.0,4,4,1.0,1,7,8,0,3,0,2,0,8,4.2,-16.0,Evan Mobley,2,11,0.18181818181818182
5607,11/27/2022,21.443835616438356,W,1,39.63333333333333,8,12,0.667,2,2,1.0,2,5,0.4,6,7,13,1,0,1,3,3,20,17.1,4.0,Evan Mobley,6,10,0.6
5608,10/19/2022,27.53150684931507,L,0,27.683333333333334,6,12,0.5,3,6,0.5,2,2,1.0,0,3,3,1,0,0,1,3,17,10.4,7.0,Cedi Osman,3,6,0.5
5609,10/22/2022,27.53972602739726,W,0,25.733333333333334,5,8,0.625,2,3,0.667,3,3,1.0,0,2,2,4,0,0,1,5,15,11.8,41.0,Cedi Osman,3,5,0.6
5610,10/23/2022,27.542465753424658,W,0,31.666666666666668,6,10,0.6,3,5,0.6,1,1,1.0,0,0,0,3,1,0,0,3,16,13.3,3.0,Cedi Osman,3,5,0.6
5611,10/26/2022,27.55068493150685,W,0,31.216666666666665,5,12,0.417,1,5,0.2,3,5,0.6,2,5,7,3,0,1,1,2,14,10.7,5.0,Cedi Osman,4,7,0.5714285714285714
5612,10/28/2022,27.556164383561644,W,0,22.4,1,6,0.167,1,5,0.2,1,2,0.5,1,1,2,1,0,0,1,4,4,-1.1,-10.0,Cedi Osman,0,1,0.0
5613,10/30/2022,27.561643835616437,W,0,15.2,1,7,0.143,1,6,0.167,0,0,,0,0,0,0,0,0,1,2,3,-3.3,-4.0,Cedi Osman,0,1,0.0
5614,11/2/2022,27.56986301369863,W,0,12.616666666666667,0,3,0.0,0,3,0.0,0,0,,0,4,4,0,0,0,0,1,0,-1.3,2.0,Cedi Osman,0,0,
5615,11/4/2022,27.575342465753426,W,0,25.283333333333335,5,9,0.556,4,6,0.667,1,1,1.0,0,4,4,6,0,0,4,1,15,11.7,24.0,Cedi Osman,1,3,0.3333333333333333
5616,11/6/2022,27.58082191780822,W,0,19.25,3,5,0.6,1,3,0.333,2,2,1.0,0,1,1,1,0,0,0,1,9,7.3,19.0,Cedi Osman,2,2,1.0
5617,11/7/2022,27.583561643835615,L,0,3.4,1,1,1.0,0,0,,0,0,,0,0,0,0,0,0,0,0,2,1.7,-5.0,Cedi Osman,1,1,1.0
5618,11/9/2022,27.589041095890412,L,0,15.233333333333333,3,4,0.75,1,1,1.0,0,0,,0,3,3,2,0,0,1,1,7,6.3,1.0,Cedi Osman,2,3,0.6666666666666666
5619,11/11/2022,27.594520547945205,L,0,20.65,0,4,0.0,0,2,0.0,0,2,0.0,0,1,1,1,0,0,0,1,0,-3.0,-9.0,Cedi Osman,0,2,0.0
5620,11/13/2022,27.6,L,0,27.683333333333334,4,10,0.4,2,4,0.5,4,6,0.667,0,4,4,2,0,0,1,4,14,7.8,-1.0,Cedi Osman,2,6,0.3333333333333333
5621,11/16/2022,27.60821917808219,L,0,13.2,2,2,1.0,0,0,,0,0,,0,2,2,2,0,0,1,1,4,4.0,-4.0,Cedi Osman,2,2,1.0
5622,11/18/2022,27.613698630136987,W,0,7.4,0,0,,0,0,,0,0,,0,1,1,1,0,0,0,1,0,0.6,2.0,Cedi Osman,0,0,
5623,11/20/2022,27.61917808219178,W,0,37.0,8,17,0.471,4,11,0.364,0,0,,4,8,12,3,1,1,1,3,20,18.1,39.0,Cedi Osman,4,6,0.6666666666666666
5624,11/21/2022,27.621917808219177,W,0,28.933333333333334,8,10,0.8,3,4,0.75,4,5,0.8,0,3,3,0,0,0,1,4,23,17.1,9.0,Cedi Osman,5,6,0.8333333333333334
5625,11/23/2022,27.627397260273973,W,0,27.116666666666667,1,6,0.167,1,5,0.2,0,0,,0,4,4,3,0,0,1,2,3,0.7,17.0,Cedi Osman,0,1,0.0
5626,11/25/2022,27.632876712328766,L,0,32.13333333333333,3,8,0.375,2,5,0.4,0,0,,0,4,4,2,3,0,1,1,8,7.8,-13.0,Cedi Osman,1,3,0.3333333333333333
5627,11/27/2022,27.638356164383563,W,0,26.683333333333334,4,8,0.5,1,4,0.25,1,1,1.0,0,3,3,0,0,1,3,2,10,3.8,12.0,Cedi Osman,3,4,0.75
5628,10/19/2022,21.72876712328767,L,0,11.75,0,1,0.0,0,1,0.0,0,0,,0,0,0,0,0,0,1,4,0,-3.3,0.0,Isaac Okoro,0,0,
5629,10/22/2022,21.736986301369864,W,1,26.933333333333334,1,5,0.2,0,2,0.0,0,0,,0,1,1,0,0,0,3,1,2,-4.2,-4.0,Isaac Okoro,1,3,0.3333333333333333
5630,10/23/2022,21.73972602739726,W,1,20.316666666666666,1,4,0.25,0,2,0.0,0,0,,0,2,2,0,1,0,0,2,2,0.4,-5.0,Isaac Okoro,1,2,0.5
5631,10/26/2022,21.747945205479454,W,0,11.483333333333333,1,2,0.5,0,1,0.0,0,0,,1,0,1,0,0,0,0,1,2,1.3,-10.0,Isaac Okoro,1,1,1.0
5632,10/28/2022,21.753424657534246,W,0,5.366666666666666,1,3,0.333,0,2,0.0,0,0,,0,0,0,0,0,0,1,3,2,-1.9,-12.0,Isaac Okoro,1,1,1.0
5633,10/30/2022,21.75890410958904,W,0,21.55,0,3,0.0,0,2,0.0,2,2,1.0,0,4,4,2,1,1,1,1,2,2.8,24.0,Isaac Okoro,0,1,0.0
5634,11/2/2022,21.767123287671232,W,0,7.866666666666667,0,0,,0,0,,0,0,,0,0,0,0,0,0,1,2,0,-1.8,-6.0,Isaac Okoro,0,0,
5635,11/4/2022,21.77260273972603,W,1,22.716666666666665,4,6,0.667,0,1,0.0,1,1,1.0,0,4,4,0,1,0,0,1,9,8.2,0.0,Isaac Okoro,4,5,0.8
5636,11/6/2022,21.778082191780822,W,0,5.933333333333334,0,1,0.0,0,0,,0,0,,0,0,0,0,0,0,0,1,0,-1.1,-2.0,Isaac Okoro,0,1,0.0
5637,11/7/2022,21.78082191780822,L,0,17.55,0,2,0.0,0,0,,3,4,0.75,0,3,3,2,1,0,2,3,3,1.3,0.0,Isaac Okoro,0,2,0.0
5638,11/9/2022,21.786301369863015,L,0,6.383333333333334,0,0,,0,0,,0,0,,0,0,0,0,0,0,0,0,0,0.0,-5.0,Isaac Okoro,0,0,
5639,11/11/2022,21.791780821917808,L,0,18.45,1,5,0.2,0,1,0.0,2,3,0.667,1,0,1,0,1,0,1,5,4,-0.8,-9.0,Isaac Okoro,1,4,0.25
5640,11/13/2022,21.797260273972604,L,0,28.833333333333332,3,4,0.75,1,2,0.5,1,2,0.5,3,0,3,1,2,0,1,2,8,9.0,15.0,Isaac Okoro,2,2,1.0
5641,11/16/2022,21.805479452054794,L,0,24.833333333333332,2,3,0.667,0,0,,0,0,,0,0,0,1,2,0,1,3,4,3.2,-9.0,Isaac Okoro,2,3,0.6666666666666666
5642,11/18/2022,21.81095890410959,W,0,16.383333333333333,1,2,0.5,1,2,0.5,0,0,,0,1,1,0,0,0,1,5,3,-0.7,2.0,Isaac Okoro,0,0,
5643,11/20/2022,21.816438356164383,W,0,29.133333333333333,4,8,0.5,2,5,0.4,3,5,0.6,0,4,4,2,0,0,1,2,13,9.0,26.0,Isaac Okoro,2,3,0.6666666666666666
5644,11/21/2022,21.81917808219178,W,0,15.1,1,3,0.333,0,1,0.0,2,2,1.0,0,1,1,0,0,1,1,4,4,0.7,8.0,Isaac Okoro,1,2,0.5
5645,11/23/2022,21.824657534246576,W,0,20.716666666666665,1,1,1.0,0,0,,1,1,1.0,1,2,3,1,1,1,0,1,3,6.0,16.0,Isaac Okoro,1,1,1.0
5646,11/25/2022,21.83013698630137,L,0,31.7,3,6,0.5,1,4,0.25,6,6,1.0,1,3,4,1,0,0,0,1,13,11.9,3.0,Isaac Okoro,2,2,1.0
5647,11/27/2022,21.835616438356166,W,0,29.966666666666665,2,2,1.0,1,1,1.0,2,2,1.0,1,6,7,0,1,0,0,3,7,8.7,14.0,Isaac Okoro,1,1,1.0
5648,10/19/2022,26.115068493150684,L,1,34.53333333333333,12,21,0.571,2,8,0.25,5,6,0.833,0,2,2,9,2,0,3,4,31,25.0,10.0,Donovan Mitchell,10,13,0.7692307692307693
5649,10/22/2022,26.123287671232877,W,1,34.516666666666666,10,19,0.526,4,6,0.667,8,9,0.889,3,6,9,8,1,0,4,3,32,27.6,19.0,Donovan Mitchell,6,13,0.46153846153846156
5650,10/23/2022,26.126027397260273,W,1,44.56666666666667,12,29,0.414,5,12,0.417,8,9,0.889,2,3,5,4,3,1,6,2,37,23.1,4.0,Donovan Mitchell,7,17,0.4117647058823529
5651,10/26/2022,26.134246575342466,W,1,37.2,5,19,0.263,1,7,0.143,3,4,0.75,2,2,4,8,2,0,1,3,14,9.7,9.0,Donovan Mitchell,4,12,0.3333333333333333
5652,10/28/2022,26.13972602739726,W,1,45.7,15,25,0.6,5,9,0.556,6,6,1.0,0,4,4,3,1,0,7,4,41,25.2,18.0,Donovan Mitchell,10,16,0.625
5653,10/30/2022,26.145205479452056,W,1,37.166666666666664,12,20,0.6,8,13,0.615,6,8,0.75,0,3,3,12,1,2,4,4,38,34.1,18.0,Donovan Mitchell,4,7,0.5714285714285714
5654,11/2/2022,26.153424657534245,W,1,43.916666666666664,11,27,0.407,3,9,0.333,0,0,,0,4,4,6,1,2,0,3,25,17.1,-3.0,Donovan Mitchell,8,18,0.4444444444444444
5655,11/6/2022,26.164383561643834,W,1,37.13333333333333,10,17,0.588,1,7,0.143,12,13,0.923,1,4,5,2,1,1,3,1,33,26.3,6.0,Donovan Mitchell,9,10,0.9
5656,11/7/2022,26.167123287671235,L,1,38.6,10,15,0.667,8,11,0.727,2,3,0.667,0,1,1,2,0,0,3,5,30,19.8,-2.0,Donovan Mitchell,2,4,0.5
5657,11/9/2022,26.172602739726027,L,1,38.983333333333334,16,28,0.571,6,14,0.429,0,0,,3,2,5,4,1,0,3,3,38,27.1,-8.0,Donovan Mitchell,10,14,0.7142857142857143
5658,11/11/2022,26.17808219178082,L,1,37.266666666666666,10,20,0.5,3,10,0.3,6,6,1.0,0,10,10,9,2,1,3,0,29,28.0,7.0,Donovan Mitchell,7,10,0.7
5659,11/16/2022,26.19178082191781,L,1,34.43333333333333,7,19,0.368,3,9,0.333,6,6,1.0,0,2,2,3,2,0,2,1,23,14.8,-17.0,Donovan Mitchell,4,10,0.4
5660,11/18/2022,26.197260273972603,W,1,43.56666666666667,11,22,0.5,2,9,0.222,10,11,0.909,1,3,4,6,1,0,6,2,34,22.6,10.0,Donovan Mitchell,9,13,0.6923076923076923
5661,11/20/2022,26.202739726027396,W,1,26.783333333333335,5,12,0.417,2,7,0.286,1,2,0.5,1,2,3,5,2,0,1,4,13,10.4,15.0,Donovan Mitchell,3,5,0.6
5662,11/21/2022,26.205479452054796,W,1,38.65,11,22,0.5,4,8,0.5,3,4,0.75,0,4,4,9,3,0,3,2,29,24.3,14.0,Donovan Mitchell,7,14,0.5
5663,11/23/2022,26.21095890410959,W,1,31.383333333333333,11,18,0.611,6,10,0.6,6,7,0.857,0,2,2,1,2,0,4,1,34,24.3,-5.0,Donovan Mitchell,5,8,0.625
5664,11/25/2022,26.216438356164385,L,1,32.35,11,24,0.458,5,11,0.455,2,2,1.0,2,1,3,1,1,0,2,2,29,17.2,-20.0,Donovan Mitchell,6,13,0.46153846153846156
5665,11/27/2022,26.221917808219178,W,1,38.65,9,23,0.391,2,8,0.25,12,13,0.923,1,4,5,1,1,0,3,2,32,18.9,11.0,Donovan Mitchell,7,15,0.4666666666666667
5666,10/19/2022,24.495890410958904,L,1,33.86666666666667,5,8,0.625,0,0,,3,4,0.75,5,5,10,0,0,2,1,2,13,13.6,2.0,Jarrett Allen,5,8,0.625
5667,10/22/2022,24.504109589041096,W,1,28.6,4,6,0.667,0,0,,0,0,,3,3,6,2,0,1,2,2,8,7.7,5.0,Jarrett Allen,4,6,0.6666666666666666
5668,10/23/2022,24.506849315068493,W,1,37.5,6,13,0.462,0,0,,3,4,0.75,6,8,14,3,0,2,0,2,15,17.2,-1.0,Jarrett Allen,6,13,0.46153846153846156
5669,10/26/2022,24.515068493150686,W,1,29.65,7,11,0.636,0,0,,4,5,0.8,7,9,16,1,1,1,1,5,18,19.7,11.0,Jarrett Allen,7,11,0.6363636363636364
5670,10/28/2022,24.52054794520548,W,1,39.65,5,9,0.556,0,1,0.0,2,4,0.5,3,8,11,2,0,0,0,2,12,12.0,25.0,Jarrett Allen,5,8,0.625
5671,10/30/2022,24.526027397260275,W,1,25.816666666666666,3,8,0.375,0,1,0.0,0,0,,3,10,13,1,0,0,2,0,6,5.4,5.0,Jarrett Allen,3,7,0.42857142857142855
5672,11/2/2022,24.534246575342465,W,1,36.38333333333333,6,11,0.545,0,0,,2,2,1.0,3,11,14,0,0,2,3,2,14,11.7,-17.0,Jarrett Allen,6,11,0.5454545454545454
5673,11/4/2022,24.53972602739726,W,1,31.516666666666666,11,16,0.688,0,0,,1,2,0.5,2,5,7,0,0,2,4,2,23,15.3,20.0,Jarrett Allen,11,16,0.6875
5674,11/6/2022,24.545205479452054,W,1,27.75,5,13,0.385,0,0,,6,6,1.0,3,8,11,0,2,2,1,4,16,14.2,5.0,Jarrett Allen,5,13,0.38461538461538464
5675,11/7/2022,24.54794520547945,L,1,32.86666666666667,4,10,0.4,0,0,,2,3,0.667,4,16,20,3,2,2,0,0,10,17.3,3.0,Jarrett Allen,4,10,0.4
5676,11/9/2022,24.553424657534247,L,1,32.833333333333336,7,11,0.636,0,0,,6,7,0.857,2,5,7,1,0,1,1,4,20,16.4,-13.0,Jarrett Allen,7,11,0.6363636363636364
5677,11/11/2022,24.55890410958904,L,1,33.18333333333333,6,8,0.75,0,0,,1,2,0.5,1,8,9,1,0,0,2,2,13,10.4,0.0,Jarrett Allen,6,8,0.75
5678,11/18/2022,24.578082191780823,W,1,45.6,8,11,0.727,0,0,,4,5,0.8,1,11,12,2,0,4,2,3,20,20.1,6.0,Jarrett Allen,8,11,0.7272727272727273
5679,11/20/2022,24.583561643835615,W,1,27.15,4,6,0.667,0,0,,0,0,,1,5,6,2,0,0,3,3,8,4.8,13.0,Jarrett Allen,4,6,0.6666666666666666
5680,11/21/2022,24.586301369863016,W,1,33.166666666666664,3,5,0.6,0,0,,2,2,1.0,0,11,11,1,2,1,1,0,8,11.4,11.0,Jarrett Allen,3,5,0.6
5681,11/23/2022,24.59178082191781,W,1,36.06666666666667,10,12,0.833,0,0,,4,4,1.0,5,8,13,2,1,0,6,3,24,20.7,19.0,Jarrett Allen,10,12,0.8333333333333334
5682,11/25/2022,24.5972602739726,L,1,12.066666666666666,0,2,0.0,0,0,,1,2,0.5,1,2,3,1,1,1,0,2,1,2.1,4.0,Jarrett Allen,0,2,0.0
5683,10/19/2022,28.15068493150685,L,1,34.68333333333333,2,7,0.286,2,2,1.0,4,4,1.0,0,5,5,7,0,0,1,3,10,10.1,5.0,Caris LeVert,0,5,0.0
5684,10/22/2022,28.15890410958904,W,1,33.45,4,12,0.333,3,6,0.5,3,4,0.75,0,4,4,8,1,1,2,1,14,12.9,17.0,Caris LeVert,1,6,0.16666666666666666
5685,10/23/2022,28.161643835616438,W,1,35.9,4,14,0.286,2,6,0.333,0,0,,0,3,3,4,2,0,2,4,10,3.9,15.0,Caris LeVert,2,8,0.25
5686,10/26/2022,28.16986301369863,W,1,33.43333333333333,3,12,0.25,3,7,0.429,3,6,0.5,0,2,2,6,1,0,5,3,12,3.2,20.0,Caris LeVert,0,5,0.0
5687,10/28/2022,28.175342465753424,W,1,42.8,12,21,0.571,6,8,0.75,11,12,0.917,2,2,4,7,3,0,2,4,41,37.0,21.0,Caris LeVert,6,13,0.46153846153846156
5688,10/30/2022,28.18082191780822,W,1,29.266666666666666,0,9,0.0,0,4,0.0,1,1,1.0,1,2,3,8,0,0,3,2,1,-2.2,-12.0,Caris LeVert,0,5,0.0
5689,11/2/2022,28.18904109589041,W,1,46.13333333333333,4,12,0.333,3,7,0.429,4,6,0.667,2,6,8,4,0,0,1,4,15,10.8,1.0,Caris LeVert,1,5,0.2
5690,11/4/2022,28.194520547945206,W,1,30.216666666666665,6,10,0.6,1,4,0.25,2,2,1.0,1,5,6,6,0,0,2,3,15,13.6,27.0,Caris LeVert,5,6,0.8333333333333334
5691,11/6/2022,28.2,W,1,29.566666666666666,5,10,0.5,1,2,0.5,1,2,0.5,1,3,4,3,1,0,1,1,12,9.9,-2.0,Caris LeVert,4,8,0.5
5692,11/7/2022,28.202739726027396,L,1,36.4,2,8,0.25,0,2,0.0,0,0,,1,5,6,5,0,0,1,3,4,2.7,1.0,Caris LeVert,2,6,0.3333333333333333
5693,11/9/2022,28.208219178082192,L,1,38.35,9,18,0.5,1,3,0.333,2,2,1.0,4,6,10,6,2,0,5,3,21,16.6,-10.0,Caris LeVert,8,15,0.5333333333333333
5694,11/11/2022,28.213698630136985,L,1,33.666666666666664,4,11,0.364,2,6,0.333,1,2,0.5,1,1,2,0,0,0,0,2,11,4.7,-1.0,Caris LeVert,2,5,0.4
5695,11/13/2022,28.21917808219178,L,1,27.583333333333332,6,12,0.5,1,2,0.5,0,0,,3,2,5,5,0,1,2,1,13,11.5,-13.0,Caris LeVert,5,10,0.5
5696,11/16/2022,28.22739726027397,L,1,19.6,1,5,0.2,0,2,0.0,0,0,,0,2,2,3,0,0,1,2,2,-0.2,-8.0,Caris LeVert,1,3,0.3333333333333333
5697,11/18/2022,28.232876712328768,W,0,30.316666666666666,1,8,0.125,0,2,0.0,2,2,1.0,0,3,3,2,0,0,0,0,4,1.1,8.0,Caris LeVert,1,6,0.16666666666666666
5698,11/20/2022,28.23835616438356,W,0,14.283333333333333,0,4,0.0,0,4,0.0,0,0,,1,4,5,4,1,0,0,2,0,2.1,22.0,Caris LeVert,0,0,
5699,10/19/2022,34.11506849315069,L,0,20.9,3,6,0.5,1,4,0.25,1,1,1.0,0,7,7,2,0,0,1,2,8,6.7,4.0,Kevin Love,2,2,1.0
5700,10/22/2022,34.12328767123287,W,0,22.833333333333332,5,9,0.556,5,6,0.833,0,0,,0,12,12,4,0,1,0,1,15,17.4,27.0,Kevin Love,0,3,0.0
5701,10/23/2022,34.12602739726027,W,0,14.366666666666667,2,6,0.333,1,4,0.25,0,0,,0,7,7,0,0,0,1,1,5,2.3,2.0,Kevin Love,1,2,0.5
5702,10/26/2022,34.134246575342466,W,0,18.983333333333334,1,7,0.143,0,5,0.0,2,2,1.0,0,7,7,4,0,0,1,1,4,3.0,5.0,Kevin Love,1,2,0.5
5703,10/28/2022,34.13972602739726,W,0,20.883333333333333,3,7,0.429,2,4,0.5,1,2,0.5,0,5,5,0,0,0,1,2,9,4.6,-10.0,Kevin Love,1,3,0.3333333333333333
5704,10/30/2022,34.14520547945205,W,0,22.483333333333334,9,14,0.643,8,13,0.615,3,3,1.0,2,6,8,1,0,0,1,1,29,25.3,16.0,Kevin Love,1,1,1.0
5705,11/2/2022,34.153424657534245,W,0,14.566666666666666,2,10,0.2,0,5,0.0,4,5,0.8,1,4,5,0,0,0,1,1,8,1.9,-4.0,Kevin Love,2,5,0.4
5706,11/4/2022,34.15890410958904,W,0,23.433333333333334,7,10,0.7,4,7,0.571,3,4,0.75,4,4,8,10,0,1,1,0,21,27.1,30.0,Kevin Love,3,3,1.0
5707,11/6/2022,34.16438356164384,W,0,20.066666666666666,4,10,0.4,2,8,0.25,0,0,,0,10,10,1,0,1,1,1,10,7.6,22.0,Kevin Love,2,2,1.0
5708,11/7/2022,34.16712328767123,L,0,25.083333333333332,4,8,0.5,4,8,0.5,5,6,0.833,1,7,8,4,1,0,3,1,17,15.8,16.0,Kevin Love,0,0,
5709,11/9/2022,34.172602739726024,L,0,21.15,2,5,0.4,1,3,0.333,4,4,1.0,1,7,8,2,0,0,2,2,9,7.7,2.0,Kevin Love,1,2,0.5
5710,11/11/2022,34.178082191780824,L,0,22.016666666666666,3,10,0.3,2,6,0.333,1,2,0.5,2,5,7,2,1,0,1,1,9,6.7,-11.0,Kevin Love,1,4,0.25
5711,11/13/2022,34.18356164383562,L,1,29.133333333333333,3,11,0.273,3,8,0.375,5,5,1.0,2,3,5,4,0,0,1,3,14,10.4,4.0,Kevin Love,0,3,0.0
5712,11/16/2022,34.19178082191781,L,0,19.716666666666665,1,3,0.333,1,3,0.333,2,2,1.0,0,7,7,3,0,0,1,2,5,5.7,-4.0,Kevin Love,0,0,
5713,11/18/2022,34.1972602739726,W,0,24.05,2,4,0.5,2,4,0.5,0,0,,0,7,7,2,0,0,1,2,6,5.7,-1.0,Kevin Love,0,0,
5714,11/21/2022,34.205479452054796,W,0,11.716666666666667,0,2,0.0,0,1,0.0,0,0,,0,4,4,1,0,0,0,1,0,0.1,-1.0,Kevin Love,0,1,0.0
5715,10/19/2022,22.72876712328767,L,1,13.3,2,8,0.25,0,1,0.0,0,0,,0,1,1,3,2,1,5,1,4,-1.1,-10.0,Darius Garland,2,7,0.2857142857142857
5716,11/2/2022,22.767123287671232,W,1,42.35,9,20,0.45,5,11,0.455,6,7,0.857,0,5,5,12,3,0,1,3,29,28.9,10.0,Darius Garland,4,9,0.4444444444444444
5717,11/6/2022,22.778082191780822,W,1,38.95,7,18,0.389,3,9,0.333,7,7,1.0,1,3,4,7,0,0,5,4,24,14.1,6.0,Darius Garland,4,9,0.4444444444444444
5718,11/7/2022,22.78082191780822,L,1,37.78333333333333,8,17,0.471,2,9,0.222,1,3,0.333,1,0,1,12,1,0,5,1,19,14.2,-2.0,Darius Garland,6,8,0.75
5719,11/9/2022,22.786301369863015,L,1,33.56666666666667,1,9,0.111,1,4,0.25,3,4,0.75,0,0,0,8,0,0,4,3,6,0.1,-6.0,Darius Garland,0,5,0.0
5720,11/11/2022,22.791780821917808,L,1,35.983333333333334,5,19,0.263,1,5,0.2,4,4,1.0,1,2,3,8,2,0,0,3,15,11.4,-3.0,Darius Garland,4,14,0.2857142857142857
5721,11/13/2022,22.797260273972604,L,1,40.016666666666666,16,31,0.516,10,15,0.667,9,13,0.692,1,1,2,6,2,0,2,3,51,38.1,6.0,Darius Garland,6,16,0.375
5722,11/16/2022,22.805479452054794,L,1,34.78333333333333,8,20,0.4,5,9,0.556,2,3,0.667,0,4,4,8,1,1,1,1,23,18.9,-1.0,Darius Garland,3,11,0.2727272727272727
5723,11/18/2022,22.81095890410959,W,1,48.21666666666667,16,26,0.615,3,8,0.375,6,8,0.75,0,1,1,6,5,1,8,5,41,28.6,23.0,Darius Garland,13,18,0.7222222222222222
5724,11/20/2022,22.816438356164383,W,1,27.883333333333333,7,12,0.583,4,7,0.571,7,7,1.0,0,2,2,7,0,0,5,2,25,19.1,12.0,Darius Garland,3,5,0.6
5725,11/21/2022,22.81917808219178,W,1,38.1,9,14,0.643,2,4,0.5,6,6,1.0,0,0,0,9,1,0,8,1,26,18.7,8.0,Darius Garland,7,10,0.7
5726,11/23/2022,22.824657534246576,W,1,35.583333333333336,9,19,0.474,4,9,0.444,2,2,1.0,0,0,0,12,0,0,2,1,24,20.3,26.0,Darius Garland,5,10,0.5
5727,11/25/2022,22.83013698630137,L,1,38.1,7,18,0.389,1,5,0.2,5,5,1.0,0,4,4,3,0,0,2,3,20,10.3,-26.0,Darius Garland,6,13,0.46153846153846156
5728,11/27/2022,22.835616438356166,W,1,40.2,4,19,0.211,0,5,0.0,11,12,0.917,0,3,3,10,0,0,2,1,19,12.4,1.0,Darius Garland,4,14,0.2857142857142857
5729,10/19/2022,25.912328767123288,L,0,21.666666666666668,3,4,0.75,1,2,0.5,1,2,0.5,1,2,3,2,0,1,0,1,8,9.0,-11.0,Dean Wade,2,2,1.0
5730,10/22/2022,25.92054794520548,W,0,4.116666666666666,2,3,0.667,1,2,0.5,0,0,,0,2,2,1,0,0,1,0,5,4.0,6.0,Dean Wade,1,1,1.0
5731,10/23/2022,25.923287671232877,W,0,21.3,3,4,0.75,2,3,0.667,4,5,0.8,1,2,3,2,0,1,0,1,12,13.0,19.0,Dean Wade,1,1,1.0
5732,10/26/2022,25.931506849315067,W,1,29.716666666666665,4,7,0.571,4,7,0.571,0,0,,0,3,3,0,1,0,0,2,12,9.8,9.0,Dean Wade,0,0,
5733,10/28/2022,25.936986301369863,W,1,38.916666666666664,1,3,0.333,1,2,0.5,1,2,0.5,0,6,6,1,0,0,1,4,4,1.8,20.0,Dean Wade,0,1,0.0
5734,10/30/2022,25.942465753424656,W,1,33.483333333333334,8,11,0.727,6,8,0.75,0,0,,1,3,4,3,0,0,0,4,22,19.6,20.0,Dean Wade,2,3,0.6666666666666666
5735,11/2/2022,25.95068493150685,W,0,24.3,2,7,0.286,0,3,0.0,2,2,1.0,1,3,4,0,2,0,1,4,6,2.9,2.0,Dean Wade,2,4,0.5
5736,11/4/2022,25.956164383561642,W,1,23.433333333333334,0,4,0.0,0,3,0.0,0,0,,0,2,2,1,1,1,1,2,0,-1.6,2.0,Dean Wade,0,1,0.0
5737,11/6/2022,25.96164383561644,W,0,24.833333333333332,1,3,0.333,0,2,0.0,0,0,,1,5,6,1,1,1,0,4,2,3.3,13.0,Dean Wade,1,1,1.0
5738,11/7/2022,25.964383561643835,L,0,14.566666666666666,2,4,0.5,2,3,0.667,0,0,,0,1,1,0,1,0,0,2,6,4.5,-1.0,Dean Wade,0,1,0.0
5739,11/9/2022,25.96986301369863,L,0,14.4,1,1,1.0,1,1,1.0,0,0,,0,2,2,0,0,0,0,3,3,2.1,8.0,Dean Wade,0,0,
5740,11/23/2022,26.008219178082193,W,0,18.083333333333332,2,3,0.667,0,1,0.0,0,0,,0,3,3,0,0,0,0,1,4,3.2,17.0,Dean Wade,2,2,1.0
5741,11/25/2022,26.013698630136986,L,1,36.28333333333333,2,7,0.286,2,6,0.333,1,2,0.5,2,10,12,2,1,1,0,4,7,8.4,-22.0,Dean Wade,0,1,0.0
5742,11/27/2022,26.019178082191782,W,1,34.5,1,5,0.2,1,5,0.2,0,0,,0,7,7,1,0,0,1,4,3,0.1,-6.0,Dean Wade,0,0,
5743,10/22/2022,34.558904109589044,W,0,15.616666666666667,6,7,0.857,0,0,,0,0,,1,2,3,0,0,1,0,1,12,11.1,19.0,Robin Lopez,6,7,0.8571428571428571
5744,10/23/2022,34.56164383561644,W,0,14.666666666666666,3,4,0.75,0,0,,0,0,,4,2,6,1,0,0,2,2,6,5.7,8.0,Robin Lopez,3,4,0.75
5745,10/30/2022,34.58082191780822,W,0,9.35,1,1,1.0,0,0,,0,1,0.0,0,0,0,0,0,1,0,0,2,2.0,-11.0,Robin Lopez,1,1,1.0
5746,11/2/2022,34.58904109589041,W,0,4.8,1,2,0.5,0,0,,0,0,,0,0,0,0,0,0,0,0,2,1.0,5.0,Robin Lopez,1,2,0.5
5747,11/4/2022,34.59452054794521,W,0,5.15,0,0,,0,0,,0,0,,1,0,1,0,0,0,2,1,0,-1.7,-1.0,Robin Lopez,0,0,
5748,11/6/2022,34.6,W,0,6.066666666666666,0,0,,0,0,,3,4,0.75,0,0,0,1,0,0,0,0,3,3.3,2.0,Robin Lopez,0,0,
5749,11/9/2022,34.608219178082194,L,0,3.35,0,0,,0,0,,0,0,,1,0,1,1,0,0,0,1,0,1.0,-3.0,Robin Lopez,0,0,
5750,11/13/2022,34.61917808219178,L,0,16.233333333333334,2,4,0.5,0,0,,1,1,1.0,0,2,2,0,0,0,0,2,5,2.8,6.0,Robin Lopez,2,4,0.5
5751,11/16/2022,34.62739726027397,L,0,13.683333333333334,0,2,0.0,0,0,,0,0,,0,1,1,0,0,0,0,1,0,-1.5,-3.0,Robin Lopez,0,2,0.0
5752,11/20/2022,34.63835616438356,W,0,7.883333333333333,1,1,1.0,0,0,,0,0,,1,0,1,1,0,0,1,2,2,1.3,-4.0,Robin Lopez,1,1,1.0
5753,11/21/2022,34.64109589041096,W,0,10.25,3,3,1.0,0,0,,0,0,,1,1,2,1,1,0,0,1,6,7.4,5.0,Robin Lopez,3,3,1.0
5754,11/23/2022,34.64657534246575,W,0,5.183333333333334,0,0,,0,0,,0,0,,0,0,0,0,0,0,0,2,0,-0.8,-1.0,Robin Lopez,0,0,
5755,11/25/2022,34.652054794520545,L,0,19.133333333333333,3,6,0.5,0,0,,2,3,0.667,3,0,3,1,0,0,2,4,8,3.8,-6.0,Robin Lopez,3,6,0.5
5756,11/27/2022,34.657534246575345,W,1,3.8,1,2,0.5,0,0,,0,0,,1,0,1,0,0,0,0,2,2,0.9,-8.0,Robin Lopez,1,2,0.5
5757,10/19/2022,30.41917808219178,L,0,6.033333333333333,0,1,0.0,0,1,0.0,0,0,,0,1,1,0,0,0,1,0,0,-1.4,-8.0,Raul Neto,0,0,
5758,10/22/2022,30.427397260273974,W,0,15.2,3,5,0.6,0,1,0.0,0,0,,0,4,4,4,1,0,1,1,6,7.3,11.0,Raul Neto,3,4,0.75
5759,10/23/2022,30.43013698630137,W,0,8.1,2,5,0.4,0,1,0.0,0,0,,1,0,1,0,1,0,0,0,4,3.0,8.0,Raul Neto,2,4,0.5
5760,10/26/2022,30.438356164383563,W,0,13.883333333333333,1,2,0.5,1,1,1.0,4,4,1.0,0,0,0,0,0,0,0,1,7,5.6,3.0,Raul Neto,0,1,0.0
5761,10/28/2022,30.443835616438356,W,0,7.3,0,1,0.0,0,1,0.0,0,0,,0,0,0,1,0,0,0,1,0,-0.4,-9.0,Raul Neto,0,0,
5762,10/30/2022,30.44931506849315,W,0,10.833333333333334,1,3,0.333,0,1,0.0,0,0,,1,0,1,3,0,0,0,3,2,1.9,-5.0,Raul Neto,1,2,0.5
5763,11/4/2022,30.463013698630135,W,0,24.383333333333333,3,7,0.429,2,3,0.667,2,2,1.0,0,5,5,5,2,0,2,0,10,11.3,6.0,Raul Neto,1,4,0.25
5764,11/13/2022,30.487671232876714,L,0,5.4,0,1,0.0,0,0,,0,0,,0,0,0,0,0,0,0,0,0,-0.7,-17.0,Raul Neto,0,1,0.0
5765,11/16/2022,30.495890410958904,L,0,4.95,0,1,0.0,0,1,0.0,0,0,,0,0,0,0,0,0,0,0,0,-0.7,0.0,Raul Neto,0,0,
5766,11/20/2022,30.506849315068493,W,0,7.883333333333333,2,3,0.667,0,0,,0,0,,0,0,0,1,1,0,2,1,4,2.0,-4.0,Raul Neto,2,3,0.6666666666666666
5767,11/23/2022,30.515068493150686,W,0,1.5666666666666667,0,0,,0,0,,0,0,,0,0,0,0,0,0,0,0,0,0.0,1.0,Raul Neto,0,0,
5768,11/25/2022,30.52054794520548,L,0,3.05,0,0,,0,0,,1,2,0.5,0,0,0,1,0,0,0,0,1,1.3,7.0,Raul Neto,0,0,
5769,11/27/2022,30.526027397260275,W,0,12.933333333333334,2,3,0.667,1,2,0.5,0,0,,0,0,0,1,1,0,0,1,5,5.0,7.0,Raul Neto,1,1,1.0
5770,10/22/2022,25.28767123287671,W,0,4.116666666666666,0,1,0.0,0,0,,0,0,,0,1,1,0,0,0,0,0,0,-0.4,6.0,Lamar Stevens,0,1,0.0
5771,10/30/2022,25.30958904109589,W,0,0.3,0,0,,0,0,,0,0,,0,0,0,0,0,0,0,0,0,0.0,-2.0,Lamar Stevens,0,0,
5772,11/4/2022,25.323287671232876,W,0,18.516666666666666,2,4,0.5,0,1,0.0,2,2,1.0,0,0,0,0,0,1,1,4,6,2.1,13.0,Lamar Stevens,2,3,0.6666666666666666
5773,11/13/2022,25.34794520547945,L,1,30.3,5,10,0.5,0,1,0.0,5,6,0.833,2,4,6,1,0,0,0,2,15,12.1,-2.0,Lamar Stevens,5,9,0.5555555555555556
5774,11/16/2022,25.356164383561644,L,1,33.75,3,10,0.3,2,3,0.667,2,2,1.0,3,2,5,0,0,4,0,3,10,8.5,-16.0,Lamar Stevens,1,7,0.14285714285714285
5775,11/18/2022,25.361643835616437,W,1,28.983333333333334,1,5,0.2,0,2,0.0,1,2,0.5,0,3,3,1,1,1,0,3,3,1.6,-15.0,Lamar Stevens,1,3,0.3333333333333333
5776,11/20/2022,25.367123287671234,W,1,22.0,5,6,0.833,1,2,0.5,0,0,,1,3,4,1,1,0,2,1,11,9.7,-8.0,Lamar Stevens,4,4,1.0
5777,11/21/2022,25.36986301369863,W,1,28.516666666666666,3,5,0.6,1,1,1.0,1,2,0.5,0,3,3,0,0,0,1,2,8,4.4,1.0,Lamar Stevens,2,4,0.5
5778,11/23/2022,25.375342465753423,W,1,27.633333333333333,3,5,0.6,1,2,0.5,5,5,1.0,1,0,1,0,0,0,1,1,12,9.0,-1.0,Lamar Stevens,2,3,0.6666666666666666
5779,10/30/2022,25.77260273972603,W,0,0.3,0,0,,0,0,,0,0,,0,0,0,0,0,0,0,0,0,0.0,-2.0,Mamadi Diakite,0,0,
5780,11/4/2022,25.786301369863015,W,0,5.15,1,1,1.0,0,0,,0,0,,0,2,2,0,1,0,0,1,2,2.9,-1.0,Mamadi Diakite,1,1,1.0
5781,11/13/2022,25.81095890410959,L,0,2.55,0,2,0.0,0,2,0.0,0,0,,0,0,0,0,0,0,0,1,0,-1.8,-9.0,Mamadi Diakite,0,0,
5782,11/16/2022,25.81917808219178,L,0,4.95,2,3,0.667,1,1,1.0,0,0,,0,1,1,0,0,0,1,0,5,3.0,0.0,Mamadi Diakite,1,2,0.5
5783,11/20/2022,25.83013698630137,W,0,5.516666666666667,1,1,1.0,0,0,,0,0,,0,0,0,0,0,0,0,1,2,1.3,0.0,Mamadi Diakite,1,1,1.0
5784,11/25/2022,25.843835616438355,L,0,3.05,2,2,1.0,1,1,1.0,0,0,,0,0,0,0,0,0,0,0,5,4.4,7.0,Mamadi Diakite,1,1,1.0
5785,11/27/2022,25.84931506849315,W,0,13.583333333333334,2,3,0.667,0,1,0.0,0,0,,1,1,2,0,0,2,2,2,4,2.3,5.0,Mamadi Diakite,2,2,1.0
5786,10/22/2022,23.076712328767123,W,0,4.116666666666666,1,1,1.0,1,1,1.0,0,0,,0,1,1,0,0,0,0,1,3,2.6,6.0,Isaiah Mobley,0,0,
5787,11/16/2022,23.145205479452056,L,0,4.95,1,2,0.5,0,0,,0,0,,0,3,3,0,1,0,0,1,2,2.5,0.0,Isaiah Mobley,1,2,0.5
5788,11/20/2022,23.156164383561645,W,0,4.466666666666667,0,1,0.0,0,1,0.0,0,0,,0,2,2,0,0,0,0,0,0,-0.1,4.0,Isaiah Mobley,0,0,
5789,11/23/2022,23.164383561643834,W,0,1.5666666666666667,0,0,,0,0,,0,0,,0,1,1,0,0,0,0,0,0,0.3,1.0,Isaiah Mobley,0,0,
5790,11/25/2022,23.16986301369863,L,0,3.05,1,2,0.5,0,0,,0,0,,0,0,0,0,0,0,0,0,2,1.0,7.0,Isaiah Mobley,1,2,0.5
5791,11/27/2022,23.175342465753424,W,0,0.05,0,0,,0,0,,0,0,,0,0,0,0,0,0,0,0,0,0.0,0.0,Isaiah Mobley,0,0,
5792,10/19/2022,22.635616438356166,L,1,35.666666666666664,10,18,0.556,3,6,0.5,3,3,1.0,2,2,4,7,0,0,3,1,26,20.9,-5.0,Tyrese Haliburton,7,12,0.5833333333333334
5793,10/21/2022,22.64109589041096,L,1,27.15,9,18,0.5,1,5,0.2,8,8,1.0,1,2,3,12,1,0,4,4,27,23.1,-10.0,Tyrese Haliburton,8,13,0.6153846153846154
5794,10/22/2022,22.643835616438356,W,1,32.05,7,16,0.438,3,6,0.5,7,8,0.875,2,2,4,10,5,0,1,2,24,27.4,1.0,Tyrese Haliburton,4,10,0.4
5795,10/24/2022,22.649315068493152,L,1,31.433333333333334,7,11,0.636,3,6,0.5,2,2,1.0,2,4,6,10,0,0,4,0,19,19.7,-8.0,Tyrese Haliburton,4,5,0.8
5796,10/26/2022,22.654794520547945,L,1,38.2,6,15,0.4,2,6,0.333,3,4,0.75,0,4,4,11,1,1,6,0,17,13.1,-2.0,Tyrese Haliburton,4,9,0.4444444444444444
5797,10/28/2022,22.660273972602738,W,1,36.0,9,16,0.563,3,6,0.5,4,4,1.0,0,2,2,12,1,0,1,1,25,26.0,12.0,Tyrese Haliburton,6,10,0.6
5798,10/29/2022,22.663013698630138,W,1,33.25,7,16,0.438,6,10,0.6,6,6,1.0,2,4,6,8,3,0,3,1,26,25.4,6.0,Tyrese Haliburton,1,6,0.16666666666666666
5799,10/31/2022,22.66849315068493,L,1,33.31666666666667,4,11,0.364,1,4,0.25,2,2,1.0,1,7,8,5,2,0,7,1,11,5.8,-3.0,Tyrese Haliburton,3,7,0.42857142857142855
5800,11/4/2022,22.67945205479452,W,1,36.13333333333333,9,16,0.563,3,8,0.375,1,4,0.25,0,9,9,9,2,0,1,1,22,22.8,-12.0,Tyrese Haliburton,6,8,0.75
5801,11/7/2022,22.687671232876713,W,1,34.11666666666667,7,14,0.5,6,10,0.6,0,0,,2,2,4,13,2,0,2,3,20,22.9,7.0,Tyrese Haliburton,1,4,0.25
5802,11/9/2022,22.693150684931506,L,1,33.2,9,15,0.6,3,8,0.375,0,0,,0,1,1,12,3,0,1,0,21,24.8,-12.0,Tyrese Haliburton,6,7,0.8571428571428571
5803,11/12/2022,22.7013698630137,W,1,39.166666666666664,3,14,0.214,2,9,0.222,0,1,0.0,1,5,6,15,2,1,3,2,8,10.6,26.0,Tyrese Haliburton,1,5,0.2
5804,11/16/2022,22.71232876712329,W,1,32.03333333333333,9,15,0.6,3,8,0.375,1,1,1.0,0,2,2,11,3,0,3,1,22,23.0,11.0,Tyrese Haliburton,6,7,0.8571428571428571
5805,11/18/2022,22.71780821917808,W,1,36.46666666666667,7,16,0.438,2,9,0.222,3,3,1.0,0,6,6,8,1,0,1,1,19,17.6,0.0,Tyrese Haliburton,5,7,0.7142857142857143
5806,11/19/2022,22.720547945205478,W,1,33.96666666666667,9,16,0.563,3,8,0.375,1,2,0.5,1,3,4,14,2,3,3,3,22,25.3,4.0,Tyrese Haliburton,6,8,0.75
5807,11/21/2022,22.726027397260275,W,1,27.416666666666668,7,12,0.583,1,5,0.2,3,3,1.0,0,4,4,14,0,0,7,0,18,16.4,13.0,Tyrese Haliburton,6,7,0.8571428571428571
5808,11/23/2022,22.731506849315068,L,1,35.05,4,15,0.267,2,7,0.286,0,0,,1,1,2,14,1,0,3,0,10,9.9,-19.0,Tyrese Haliburton,2,8,0.25
5809,11/25/2022,22.736986301369864,W,1,34.416666666666664,7,15,0.467,1,6,0.167,6,6,1.0,0,6,6,15,4,0,0,0,21,29.6,0.0,Tyrese Haliburton,6,9,0.6666666666666666
5810,11/27/2022,22.742465753424657,L,1,30.9,6,16,0.375,3,8,0.375,0,0,,0,5,5,11,2,0,0,0,15,17.4,-9.0,Tyrese Haliburton,3,8,0.375
5811,10/19/2022,20.334246575342465,L,0,27.833333333333332,7,15,0.467,3,7,0.429,2,5,0.4,2,5,7,2,2,0,3,3,19,12.2,9.0,Bennedict Mathurin,4,8,0.5
5812,10/21/2022,20.339726027397262,L,0,28.0,8,15,0.533,3,6,0.5,7,8,0.875,1,4,5,2,0,0,0,3,26,20.4,9.0,Bennedict Mathurin,5,9,0.5555555555555556
5813,10/22/2022,20.34246575342466,W,0,30.65,10,18,0.556,5,8,0.625,2,2,1.0,1,6,7,2,0,0,2,3,27,19.1,0.0,Bennedict Mathurin,5,10,0.5
5814,10/24/2022,20.34794520547945,L,0,24.733333333333334,6,16,0.375,1,7,0.143,4,4,1.0,2,2,4,2,0,0,3,3,17,7.4,-18.0,Bennedict Mathurin,5,9,0.5555555555555556
5815,10/26/2022,20.353424657534248,L,0,26.533333333333335,3,11,0.273,0,3,0.0,9,10,0.9,1,1,2,4,2,0,2,2,15,11.1,-18.0,Bennedict Mathurin,3,8,0.375
5816,10/28/2022,20.35890410958904,W,0,23.066666666666666,4,11,0.364,1,4,0.25,2,2,1.0,1,1,2,2,0,0,1,1,11,5.9,5.0,Bennedict Mathurin,3,7,0.42857142857142855
5817,10/29/2022,20.361643835616437,W,0,33.1,8,16,0.5,6,9,0.667,10,10,1.0,2,3,5,2,0,0,2,4,32,24.1,9.0,Bennedict Mathurin,2,7,0.2857142857142857
5818,10/31/2022,20.367123287671234,L,0,22.183333333333334,6,12,0.5,2,5,0.4,2,3,0.667,2,0,2,1,0,0,4,1,16,7.3,-5.0,Bennedict Mathurin,4,7,0.5714285714285714
5819,11/4/2022,20.378082191780823,W,0,36.7,5,11,0.455,3,7,0.429,10,12,0.833,0,1,1,2,0,1,3,1,23,15.5,4.0,Bennedict Mathurin,2,4,0.5
5820,11/7/2022,20.386301369863013,W,0,30.133333333333333,2,8,0.25,1,6,0.167,3,3,1.0,0,2,2,5,0,0,4,1,8,2.9,-4.0,Bennedict Mathurin,1,2,0.5
5821,11/9/2022,20.39178082191781,L,0,24.7,10,17,0.588,6,9,0.667,4,6,0.667,0,2,2,0,1,0,4,3,30,17.7,5.0,Bennedict Mathurin,4,8,0.5
5822,11/12/2022,20.4,W,0,30.0,4,10,0.4,3,4,0.75,4,6,0.667,3,5,8,3,0,0,1,2,15,12.7,7.0,Bennedict Mathurin,1,6,0.16666666666666666
5823,11/16/2022,20.410958904109588,W,0,21.733333333333334,7,13,0.538,1,2,0.5,5,6,0.833,2,1,3,0,0,0,1,1,20,13.6,-13.0,Bennedict Mathurin,6,11,0.5454545454545454
5824,11/18/2022,20.416438356164385,W,0,29.016666666666666,4,14,0.286,1,5,0.2,6,8,0.75,1,3,4,2,2,0,2,3,15,7.8,21.0,Bennedict Mathurin,3,9,0.3333333333333333
5825,11/19/2022,20.41917808219178,W,0,26.8,4,12,0.333,2,7,0.286,2,2,1.0,1,3,4,1,0,0,2,1,12,5.1,-6.0,Bennedict Mathurin,2,5,0.4
5826,11/21/2022,20.424657534246574,W,0,26.516666666666666,6,13,0.462,2,6,0.333,8,10,0.8,3,2,5,1,0,0,3,3,22,13.7,13.0,Bennedict Mathurin,4,7,0.5714285714285714
5827,11/23/2022,20.43013698630137,L,0,33.03333333333333,5,11,0.455,2,2,1.0,9,12,0.75,2,1,3,0,1,0,2,1,21,14.4,-3.0,Bennedict Mathurin,3,9,0.3333333333333333
5828,11/25/2022,20.435616438356163,W,0,29.666666666666668,6,15,0.4,2,7,0.286,6,9,0.667,1,3,4,0,2,1,0,0,20,15.0,5.0,Bennedict Mathurin,4,8,0.5
5829,11/27/2022,20.44109589041096,L,0,25.3,4,11,0.364,1,3,0.333,0,0,,0,3,3,0,1,0,0,2,9,4.0,-14.0,Bennedict Mathurin,3,8,0.375
5830,10/19/2022,29.838356164383562,L,1,31.55,6,16,0.375,4,11,0.364,0,0,,4,6,10,3,0,0,1,2,16,12.1,0.0,Buddy Hield,2,5,0.4
5831,10/21/2022,29.843835616438355,L,1,24.483333333333334,5,9,0.556,3,6,0.5,0,0,,2,3,5,2,2,1,3,5,13,10.1,-8.0,Buddy Hield,2,3,0.6666666666666666
5832,10/22/2022,29.846575342465755,W,1,15.533333333333333,2,8,0.25,2,6,0.333,0,0,,1,1,2,1,0,1,2,1,6,1.2,0.0,Buddy Hield,0,2,0.0
5833,10/24/2022,29.852054794520548,L,1,27.766666666666666,6,14,0.429,3,10,0.3,3,3,1.0,0,6,6,6,0,0,1,3,18,14.4,-4.0,Buddy Hield,3,4,0.75
5834,10/26/2022,29.85753424657534,L,1,32.083333333333336,8,16,0.5,7,12,0.583,2,3,0.667,1,2,3,4,0,0,2,0,25,18.7,-3.0,Buddy Hield,1,4,0.25
5835,10/28/2022,29.863013698630137,W,1,33.36666666666667,10,17,0.588,5,9,0.556,0,0,,0,5,5,2,0,0,1,1,25,18.6,10.0,Buddy Hield,5,8,0.625
5836,10/29/2022,29.865753424657534,W,1,38.15,6,14,0.429,5,11,0.455,0,0,,1,8,9,8,1,0,1,3,17,17.1,7.0,Buddy Hield,1,3,0.3333333333333333
5837,10/31/2022,29.87123287671233,L,1,35.65,8,16,0.5,3,10,0.3,3,3,1.0,1,2,3,7,2,0,3,2,22,18.4,-4.0,Buddy Hield,5,6,0.8333333333333334
5838,11/4/2022,29.882191780821916,W,1,40.28333333333333,10,18,0.556,5,12,0.417,0,0,,1,8,9,0,2,0,5,1,25,16.1,5.0,Buddy Hield,5,6,0.8333333333333334
5839,11/7/2022,29.89041095890411,W,1,36.2,6,16,0.375,5,13,0.385,3,3,1.0,2,3,5,3,2,2,0,3,20,17.8,9.0,Buddy Hield,1,3,0.3333333333333333
5840,11/9/2022,29.895890410958906,L,1,34.13333333333333,7,16,0.438,2,9,0.222,1,1,1.0,0,1,1,0,0,0,0,2,17,8.1,-14.0,Buddy Hield,5,7,0.7142857142857143
5841,11/12/2022,29.904109589041095,W,1,28.366666666666667,8,15,0.533,5,11,0.455,1,2,0.5,2,6,8,2,0,1,4,3,22,14.4,10.0,Buddy Hield,3,4,0.75
5842,11/16/2022,29.915068493150685,W,1,30.966666666666665,5,13,0.385,3,5,0.6,6,6,1.0,0,2,2,4,2,1,1,2,19,16.2,18.0,Buddy Hield,2,8,0.25
5843,11/18/2022,29.92054794520548,W,1,32.65,3,15,0.2,3,13,0.231,1,1,1.0,1,3,4,1,1,1,4,2,10,-0.1,6.0,Buddy Hield,0,2,0.0
5844,11/19/2022,29.923287671232877,W,1,30.466666666666665,5,12,0.417,5,11,0.455,0,0,,0,2,2,2,1,1,1,1,15,10.9,7.0,Buddy Hield,0,1,0.0
5845,11/21/2022,29.92876712328767,W,1,21.816666666666666,3,13,0.231,1,10,0.1,2,2,1.0,1,4,5,0,1,0,2,1,9,1.6,3.0,Buddy Hield,2,3,0.6666666666666666
5846,11/23/2022,29.934246575342467,L,1,34.0,5,16,0.313,3,11,0.273,0,0,,2,1,3,2,2,0,4,3,13,3.7,-3.0,Buddy Hield,2,5,0.4
5847,11/25/2022,29.93972602739726,W,1,38.81666666666667,9,15,0.6,5,8,0.625,3,3,1.0,0,3,3,3,3,0,4,4,26,19.5,21.0,Buddy Hield,4,7,0.5714285714285714
5848,11/27/2022,29.945205479452056,L,1,31.083333333333332,3,14,0.214,1,9,0.111,3,4,0.75,1,3,4,3,2,0,3,1,10,3.3,-17.0,Buddy Hield,2,5,0.4
5849,10/19/2022,22.594520547945205,L,1,22.05,6,14,0.429,1,6,0.167,3,5,0.6,1,7,8,1,0,1,0,2,16,11.2,0.0,Jalen Smith,5,8,0.625
5850,10/21/2022,22.6,L,1,6.783333333333333,1,3,0.333,0,1,0.0,0,0,,0,2,2,0,0,0,1,1,2,-0.5,-11.0,Jalen Smith,1,2,0.5
5851,10/22/2022,22.602739726027398,W,1,27.516666666666666,9,16,0.563,1,5,0.2,0,1,0.0,3,12,15,1,0,3,1,2,19,17.7,-1.0,Jalen Smith,8,11,0.7272727272727273
5852,10/24/2022,22.60821917808219,L,1,25.366666666666667,6,12,0.5,2,5,0.4,3,4,0.75,4,6,10,1,1,1,1,2,17,15.8,-5.0,Jalen Smith,4,7,0.5714285714285714
5853,10/26/2022,22.613698630136987,L,1,29.15,6,10,0.6,3,5,0.6,0,0,,2,7,9,2,0,2,2,2,15,13.9,5.0,Jalen Smith,3,5,0.6
5854,10/28/2022,22.61917808219178,W,1,31.083333333333332,4,6,0.667,0,0,,7,8,0.875,0,7,7,0,0,0,1,2,15,12.3,14.0,Jalen Smith,4,6,0.6666666666666666
5855,10/29/2022,22.621917808219177,W,1,33.68333333333333,3,14,0.214,1,4,0.25,1,2,0.5,7,7,14,1,0,0,2,3,8,3.5,8.0,Jalen Smith,2,10,0.2
5856,10/31/2022,22.627397260273973,L,1,26.05,1,4,0.25,0,2,0.0,1,2,0.5,0,4,4,1,1,1,2,4,3,0.2,-5.0,Jalen Smith,1,2,0.5
5857,11/4/2022,22.638356164383563,W,1,11.416666666666666,0,3,0.0,0,2,0.0,0,0,,0,1,1,2,0,0,3,2,0,-4.2,-14.0,Jalen Smith,0,1,0.0
5858,11/7/2022,22.646575342465752,W,1,29.316666666666666,6,11,0.545,3,7,0.429,0,0,,3,8,11,1,0,1,1,3,15,13.4,14.0,Jalen Smith,3,4,0.75
5859,11/9/2022,22.65205479452055,L,1,18.066666666666666,2,9,0.222,2,5,0.4,0,0,,1,4,5,1,0,0,2,1,6,0.7,-6.0,Jalen Smith,0,4,0.0
5860,11/12/2022,22.660273972602738,W,1,25.25,6,11,0.545,3,7,0.429,1,2,0.5,0,5,5,2,0,0,3,3,16,9.0,9.0,Jalen Smith,3,4,0.75
5861,11/16/2022,22.671232876712327,W,1,25.85,4,11,0.364,0,4,0.0,3,4,0.75,2,5,7,1,0,1,1,1,11,7.4,12.0,Jalen Smith,4,7,0.5714285714285714
5862,11/18/2022,22.676712328767124,W,1,30.35,4,10,0.4,0,2,0.0,2,2,1.0,4,14,18,4,1,3,1,3,10,15.3,3.0,Jalen Smith,4,8,0.5
5863,11/19/2022,22.67945205479452,W,1,24.75,6,14,0.429,1,6,0.167,1,2,0.5,2,3,5,0,0,0,1,2,14,6.7,2.0,Jalen Smith,5,8,0.625
5864,11/21/2022,22.684931506849313,W,1,17.666666666666668,3,8,0.375,0,4,0.0,0,0,,2,2,4,1,0,1,0,1,6,4.6,4.0,Jalen Smith,3,4,0.75
5865,11/23/2022,22.69041095890411,L,1,22.2,1,6,0.167,0,3,0.0,0,0,,2,1,3,1,2,1,1,1,2,1.9,-15.0,Jalen Smith,1,3,0.3333333333333333
5866,11/25/2022,22.695890410958903,W,1,20.583333333333332,2,6,0.333,1,4,0.25,5,6,0.833,0,5,5,0,0,0,0,3,10,6.5,3.0,Jalen Smith,1,2,0.5
5867,11/27/2022,22.7013698630137,L,1,28.866666666666667,8,14,0.571,3,7,0.429,4,4,1.0,3,6,9,0,0,1,1,2,23,19.2,-12.0,Jalen Smith,5,7,0.7142857142857143
5868,10/19/2022,20.77260273972603,L,0,15.85,1,3,0.333,0,0,,1,2,0.5,1,2,3,0,0,1,1,0,3,1.9,-13.0,Isaiah Jackson,1,3,0.3333333333333333
5869,10/21/2022,20.778082191780822,L,0,16.416666666666668,6,9,0.667,0,1,0.0,4,4,1.0,2,4,6,2,1,1,2,3,16,14.6,6.0,Isaiah Jackson,6,8,0.75
5870,10/22/2022,20.78082191780822,W,1,21.55,2,6,0.333,0,0,,4,5,0.8,2,3,5,1,0,5,0,3,8,9.5,3.0,Isaiah Jackson,2,6,0.3333333333333333
5871,10/24/2022,20.786301369863015,L,1,17.6,1,2,0.5,0,0,,3,6,0.5,0,1,1,0,1,0,0,5,5,2.1,0.0,Isaiah Jackson,1,2,0.5
5872,10/26/2022,20.791780821917808,L,0,19.733333333333334,4,4,1.0,0,0,,0,2,0.0,0,7,7,1,0,1,0,3,8,8.3,-4.0,Isaiah Jackson,4,4,1.0
5873,10/28/2022,20.797260273972604,W,0,12.316666666666666,0,3,0.0,0,0,,0,0,,1,3,4,2,0,2,3,4,0,-2.3,-4.0,Isaiah Jackson,0,3,0.0
5874,10/29/2022,20.8,W,1,31.766666666666666,8,13,0.615,0,0,,2,2,1.0,4,6,10,4,2,1,0,4,18,20.6,25.0,Isaiah Jackson,8,13,0.6153846153846154
5875,10/31/2022,20.805479452054794,L,0,12.683333333333334,4,6,0.667,0,0,,0,1,0.0,3,2,5,1,1,0,0,0,8,9.4,3.0,Isaiah Jackson,4,6,0.6666666666666666
5876,11/4/2022,20.816438356164383,W,0,16.55,2,5,0.4,0,0,,2,2,1.0,1,3,4,0,0,1,2,4,6,2.0,5.0,Isaiah Jackson,2,5,0.4
5877,11/7/2022,20.824657534246576,W,0,17.766666666666666,1,2,0.5,0,0,,2,3,0.667,0,5,5,2,0,1,3,2,4,2.4,-4.0,Isaiah Jackson,1,2,0.5
5878,11/9/2022,20.83013698630137,L,0,17.683333333333334,6,7,0.857,0,0,,5,6,0.833,4,6,10,1,0,1,2,3,17,16.9,5.0,Isaiah Jackson,6,7,0.8571428571428571
5879,11/12/2022,20.838356164383562,W,0,21.033333333333335,5,5,1.0,0,0,,0,0,,2,3,5,0,1,1,2,1,10,10.1,0.0,Isaiah Jackson,5,5,1.0
5880,11/16/2022,20.84931506849315,W,0,17.0,2,3,0.667,0,0,,2,4,0.5,0,1,1,2,0,3,0,2,6,6.9,1.0,Isaiah Jackson,2,3,0.6666666666666666
5881,11/18/2022,20.854794520547944,W,0,17.516666666666666,1,2,0.5,0,0,,2,2,1.0,3,2,5,1,0,1,0,2,4,6.3,7.0,Isaiah Jackson,1,2,0.5
5882,11/19/2022,20.85753424657534,W,0,7.1,0,1,0.0,0,0,,2,4,0.5,1,2,3,1,0,1,1,1,2,1.8,-5.0,Isaiah Jackson,0,1,0.0
5883,11/21/2022,20.863013698630137,W,0,21.583333333333332,5,5,1.0,0,0,,0,0,,4,4,8,1,1,1,0,5,10,12.9,3.0,Isaiah Jackson,5,5,1.0
5884,11/25/2022,20.873972602739727,W,0,14.0,2,6,0.333,0,0,,2,4,0.5,0,4,4,0,0,0,1,1,6,1.6,-15.0,Isaiah Jackson,2,6,0.3333333333333333
5885,11/27/2022,20.87945205479452,L,0,16.15,1,5,0.2,0,2,0.0,6,6,1.0,0,0,0,0,4,1,1,3,8,7.4,6.0,Isaiah Jackson,1,3,0.3333333333333333
5886,10/19/2022,30.56986301369863,L,0,16.633333333333333,4,9,0.444,0,0,,0,0,,0,1,1,4,1,1,2,3,8,4.9,-8.0,T.J. McConnell,4,9,0.4444444444444444
5887,10/21/2022,30.575342465753426,L,0,16.916666666666668,2,6,0.333,0,0,,0,0,,2,1,3,4,2,0,3,1,4,3.7,7.0,T.J. McConnell,2,6,0.3333333333333333
5888,10/22/2022,30.578082191780823,W,0,13.05,1,3,0.333,0,0,,0,0,,1,3,4,2,1,0,1,0,2,3.3,6.0,T.J. McConnell,1,3,0.3333333333333333
5889,10/24/2022,30.583561643835615,L,0,14.966666666666667,1,3,0.333,0,0,,0,0,,0,1,1,2,1,0,1,0,2,2.0,-10.0,T.J. McConnell,1,3,0.3333333333333333
5890,10/26/2022,30.589041095890412,L,0,11.633333333333333,0,5,0.0,0,0,,0,0,,0,0,0,2,0,1,0,0,0,-1.4,-14.0,T.J. McConnell,0,5,0.0
5891,10/28/2022,30.594520547945205,W,0,12.0,1,3,0.333,0,0,,0,0,,0,1,1,3,2,0,2,0,2,2.7,-2.0,T.J. McConnell,1,3,0.3333333333333333
5892,10/31/2022,30.602739726027398,L,0,15.616666666666667,3,6,0.5,0,1,0.0,0,0,,1,0,1,2,2,0,1,2,6,5.3,-6.0,T.J. McConnell,3,5,0.6
5893,11/4/2022,30.613698630136987,W,0,22.966666666666665,2,6,0.333,0,1,0.0,0,0,,0,6,6,4,2,0,1,1,4,5.8,12.0,T.J. McConnell,2,5,0.4
5894,11/7/2022,30.621917808219177,W,0,16.65,4,5,0.8,0,0,,2,3,0.667,0,3,3,3,0,1,3,0,10,8.4,-2.0,T.J. McConnell,4,5,0.8
5895,11/9/2022,30.627397260273973,L,0,16.733333333333334,1,4,0.25,0,0,,0,0,,2,1,3,4,1,0,1,4,2,2.5,3.0,T.J. McConnell,1,4,0.25
5896,11/12/2022,30.635616438356166,W,0,17.883333333333333,1,3,0.333,0,0,,0,0,,0,2,2,6,1,0,3,2,2,2.3,2.0,T.J. McConnell,1,3,0.3333333333333333
5897,11/16/2022,30.646575342465752,W,0,21.183333333333334,3,5,0.6,0,0,,0,0,,1,2,3,5,0,1,4,1,6,4.8,4.0,T.J. McConnell,3,5,0.6
5898,11/18/2022,30.65205479452055,W,0,16.016666666666666,1,3,0.333,0,1,0.0,0,0,,0,0,0,3,2,0,2,1,2,2.0,1.0,T.J. McConnell,1,2,0.5
5899,11/19/2022,30.654794520547945,W,0,14.033333333333333,1,2,0.5,0,1,0.0,0,0,,0,2,2,7,0,0,2,1,2,4.1,-3.0,T.J. McConnell,1,1,1.0
5900,11/21/2022,30.660273972602738,W,0,31.616666666666667,7,8,0.875,3,4,0.75,2,2,1.0,1,4,5,10,3,0,3,2,19,24.3,22.0,T.J. McConnell,4,4,1.0
5901,11/23/2022,30.665753424657535,L,0,18.9,4,8,0.5,0,1,0.0,2,2,1.0,1,0,1,4,1,0,2,1,10,8.1,-3.0,T.J. McConnell,4,7,0.5714285714285714
5902,11/25/2022,30.671232876712327,W,0,21.3,3,6,0.5,0,0,,2,2,1.0,2,2,4,5,1,0,2,0,8,9.5,11.0,T.J. McConnell,3,6,0.5
5903,11/27/2022,30.676712328767124,L,0,21.6,6,10,0.6,0,0,,2,2,1.0,2,1,3,5,2,0,1,3,14,14.4,-4.0,T.J. McConnell,6,10,0.6
5904,10/19/2022,23.008219178082193,L,0,22.5,1,8,0.125,1,5,0.2,0,0,,0,4,4,1,0,0,0,4,3,-1.9,5.0,Aaron Nesmith,0,3,0.0
5905,10/21/2022,23.013698630136986,L,0,21.116666666666667,4,9,0.444,1,3,0.333,0,0,,2,2,4,2,0,1,1,2,9,6.6,0.0,Aaron Nesmith,3,6,0.5
5906,10/22/2022,23.016438356164382,W,1,23.25,2,5,0.4,1,3,0.333,2,2,1.0,0,1,1,0,0,3,1,3,7,4.5,-3.0,Aaron Nesmith,1,2,0.5
5907,10/24/2022,23.02191780821918,L,1,17.333333333333332,4,9,0.444,1,4,0.25,0,0,,0,2,2,1,0,0,1,3,9,3.4,6.0,Aaron Nesmith,3,5,0.6
5908,10/26/2022,23.027397260273972,L,1,17.516666666666666,4,6,0.667,1,3,0.333,0,0,,0,3,3,2,0,1,2,4,9,5.8,-10.0,Aaron Nesmith,3,3,1.0
5909,10/28/2022,23.03287671232877,W,1,29.733333333333334,4,6,0.667,2,4,0.5,5,7,0.714,1,6,7,3,1,0,1,2,15,15.4,9.0,Aaron Nesmith,2,2,1.0
5910,11/9/2022,23.065753424657533,L,0,22.416666666666668,0,5,0.0,0,3,0.0,0,0,,0,3,3,3,1,1,2,1,0,-1.2,3.0,Aaron Nesmith,0,2,0.0
5911,11/12/2022,23.073972602739726,W,0,14.733333333333333,3,5,0.6,2,3,0.667,2,2,1.0,0,2,2,2,0,1,1,3,10,8.2,-4.0,Aaron Nesmith,1,2,0.5
5912,11/16/2022,23.084931506849315,W,0,18.016666666666666,0,4,0.0,0,3,0.0,0,0,,0,2,2,0,1,0,0,1,0,-1.6,-3.0,Aaron Nesmith,0,1,0.0
5913,11/18/2022,23.09041095890411,W,0,8.666666666666666,0,1,0.0,0,1,0.0,0,2,0.0,0,0,0,1,0,0,1,0,0,-1.8,-3.0,Aaron Nesmith,0,0,
5914,11/19/2022,23.09315068493151,W,0,25.4,5,10,0.5,5,8,0.625,4,4,1.0,1,2,3,0,0,0,1,4,19,12.7,17.0,Aaron Nesmith,0,2,0.0
5915,11/21/2022,23.0986301369863,W,1,30.883333333333333,3,7,0.429,2,6,0.333,1,1,1.0,0,8,8,2,1,0,4,4,9,4.5,14.0,Aaron Nesmith,1,1,1.0
5916,11/23/2022,23.104109589041094,L,1,25.783333333333335,1,9,0.111,1,5,0.2,0,0,,2,1,3,1,0,0,0,3,3,-1.7,-13.0,Aaron Nesmith,0,4,0.0
5917,11/25/2022,23.10958904109589,W,1,25.633333333333333,3,7,0.429,1,4,0.25,3,4,0.75,1,1,2,1,2,1,1,0,10,9.3,0.0,Aaron Nesmith,2,3,0.6666666666666666
5918,11/27/2022,23.115068493150684,L,1,22.616666666666667,1,7,0.143,0,3,0.0,0,0,,0,3,3,2,1,0,1,4,2,-1.8,-6.0,Aaron Nesmith,1,4,0.25
5919,10/26/2022,26.59178082191781,L,1,24.3,1,7,0.143,0,4,0.0,3,3,1.0,2,4,6,2,1,4,2,2,5,5.5,-8.0,Myles Turner,1,3,0.3333333333333333
5920,10/28/2022,26.5972602739726,W,1,32.35,7,14,0.5,3,4,0.75,10,10,1.0,1,9,10,2,0,5,2,4,27,24.7,20.0,Myles Turner,4,10,0.4
5921,10/31/2022,26.605479452054794,L,1,20.2,2,8,0.25,0,3,0.0,3,6,0.5,0,5,5,2,0,2,4,3,7,0.1,-21.0,Myles Turner,2,5,0.4
5922,11/4/2022,26.616438356164384,W,1,31.433333333333334,7,9,0.778,1,2,0.5,1,3,0.333,2,5,7,1,0,3,3,4,16,12.8,-4.0,Myles Turner,6,7,0.8571428571428571
5923,11/7/2022,26.624657534246577,W,1,36.61666666666667,11,18,0.611,4,7,0.571,11,11,1.0,2,10,12,1,0,3,1,4,37,33.4,10.0,Myles Turner,7,11,0.6363636363636364
5924,11/9/2022,26.63013698630137,L,1,25.683333333333334,5,11,0.455,0,4,0.0,4,5,0.8,2,9,11,2,1,3,0,5,14,14.5,-4.0,Myles Turner,5,7,0.7142857142857143
5925,11/12/2022,26.638356164383563,W,1,26.966666666666665,5,8,0.625,2,3,0.667,7,8,0.875,2,8,10,0,0,2,1,4,19,17.6,14.0,Myles Turner,3,5,0.6
5926,11/16/2022,26.649315068493152,W,1,31.0,7,10,0.7,1,2,0.5,5,6,0.833,1,9,10,3,1,3,2,3,20,20.8,11.0,Myles Turner,6,8,0.75
5927,11/18/2022,26.654794520547945,W,1,26.15,5,8,0.625,0,0,,7,9,0.778,3,4,7,1,0,4,2,4,17,15.8,3.0,Myles Turner,5,8,0.625
5928,11/19/2022,26.65753424657534,W,1,34.28333333333333,8,13,0.615,1,1,1.0,3,4,0.75,4,7,11,0,1,1,2,4,20,16.7,3.0,Myles Turner,7,12,0.5833333333333334
5929,11/21/2022,26.663013698630138,W,1,26.416666666666668,3,9,0.333,0,3,0.0,4,4,1.0,0,5,5,1,1,3,1,3,10,8.0,18.0,Myles Turner,3,6,0.5
5930,11/23/2022,26.66849315068493,L,1,32.55,12,17,0.706,7,9,0.778,0,0,,0,7,7,2,4,1,1,4,31,29.5,-15.0,Myles Turner,5,8,0.625
5931,11/25/2022,26.673972602739727,W,1,34.0,9,11,0.818,2,3,0.667,3,4,0.75,0,8,8,3,0,2,1,0,23,23.4,26.0,Myles Turner,7,8,0.875
5932,11/27/2022,26.67945205479452,L,1,20.316666666666666,3,9,0.333,1,6,0.167,2,3,0.667,0,5,5,0,0,0,3,4,9,0.4,-17.0,Myles Turner,2,3,0.6666666666666666
5933,10/21/2022,22.76164383561644,L,0,30.333333333333332,5,12,0.417,2,7,0.286,2,2,1.0,1,2,3,3,2,0,0,4,14,11.4,11.0,Andrew Nembhard,3,5,0.6
5934,10/22/2022,22.764383561643836,W,0,9.266666666666667,3,6,0.5,2,3,0.667,0,0,,1,1,2,3,0,0,1,1,8,6.7,8.0,Andrew Nembhard,1,3,0.3333333333333333
5935,10/24/2022,22.76986301369863,L,0,21.883333333333333,2,6,0.333,1,5,0.2,0,0,,0,3,3,4,0,0,0,0,5,5.3,-2.0,Andrew Nembhard,1,1,1.0
5936,10/26/2022,22.775342465753425,L,0,8.666666666666666,1,1,1.0,1,1,1.0,0,0,,0,1,1,2,1,0,0,1,3,5.0,-5.0,Andrew Nembhard,0,0,
5937,10/28/2022,22.78082191780822,W,0,16.033333333333335,1,2,0.5,1,1,1.0,0,0,,0,1,1,2,0,0,1,2,3,1.9,-12.0,Andrew Nembhard,0,1,0.0
5938,10/29/2022,22.783561643835615,W,0,16.55,1,6,0.167,1,3,0.333,2,2,1.0,0,2,2,5,0,0,0,3,5,4.1,-2.0,Andrew Nembhard,0,3,0.0
5939,10/31/2022,22.78904109589041,L,0,6.75,0,1,0.0,0,1,0.0,0,0,,1,0,1,0,1,1,1,1,0,0.3,-13.0,Andrew Nembhard,0,0,
5940,11/4/2022,22.8,W,0,27.766666666666666,2,8,0.25,0,4,0.0,0,0,,0,3,3,6,0,0,1,4,4,1.7,13.0,Andrew Nembhard,2,4,0.5
5941,11/7/2022,22.80821917808219,W,1,33.56666666666667,6,11,0.545,3,4,0.75,0,0,,1,2,3,5,2,0,3,3,15,12.3,6.0,Andrew Nembhard,3,7,0.42857142857142855
5942,11/9/2022,22.813698630136987,L,1,28.933333333333334,3,6,0.5,1,3,0.333,1,1,1.0,0,4,4,4,2,0,4,2,8,6.2,-12.0,Andrew Nembhard,2,3,0.6666666666666666
5943,11/12/2022,22.82191780821918,W,1,21.55,3,5,0.6,2,3,0.667,0,0,,0,2,2,3,0,0,1,3,8,6.2,5.0,Andrew Nembhard,1,2,0.5
5944,11/16/2022,22.832876712328765,W,1,21.5,5,6,0.833,1,2,0.5,2,2,1.0,0,2,2,0,3,0,0,4,13,12.8,20.0,Andrew Nembhard,4,4,1.0
5945,11/18/2022,22.838356164383562,W,1,21.45,3,6,0.5,2,4,0.5,0,0,,0,1,1,4,0,0,0,4,8,6.5,0.0,Andrew Nembhard,1,2,0.5
5946,11/19/2022,22.84109589041096,W,1,17.9,0,2,0.0,0,1,0.0,0,0,,1,1,2,2,1,0,0,1,0,1.6,-16.0,Andrew Nembhard,0,1,0.0
5947,10/19/2022,24.33150684931507,L,0,14.35,1,4,0.25,1,2,0.5,0,0,,0,0,0,0,0,0,1,1,3,-0.8,-8.0,Oshae Brissett,0,2,0.0
5948,10/24/2022,24.345205479452055,L,0,6.75,0,2,0.0,0,2,0.0,0,0,,1,2,3,0,0,0,1,0,0,-1.1,-3.0,Oshae Brissett,0,0,
5949,10/29/2022,24.35890410958904,W,0,2.7,0,0,,0,0,,0,0,,0,0,0,0,0,0,0,0,0,0.0,-8.0,Oshae Brissett,0,0,
5950,10/31/2022,24.364383561643837,L,0,3.65,0,1,0.0,0,1,0.0,0,0,,0,0,0,0,0,0,0,1,0,-1.1,-9.0,Oshae Brissett,0,0,
5951,11/4/2022,24.375342465753423,W,0,11.95,0,2,0.0,0,2,0.0,1,2,0.5,1,1,2,2,1,0,0,0,1,2.6,6.0,Oshae Brissett,0,0,
5952,11/9/2022,24.389041095890413,L,0,11.8,1,2,0.5,0,0,,0,0,,1,2,3,0,0,0,0,0,2,2.3,21.0,Oshae Brissett,1,2,0.5
5953,11/12/2022,24.397260273972602,W,0,14.85,3,6,0.5,0,3,0.0,2,2,1.0,1,2,3,0,0,0,2,0,8,4.3,3.0,Oshae Brissett,3,3,1.0
5954,11/16/2022,24.40821917808219,W,0,20.716666666666665,2,2,1.0,2,2,1.0,2,2,1.0,1,1,2,1,1,0,0,2,8,9.3,-1.0,Oshae Brissett,0,0,
5955,11/18/2022,24.413698630136988,W,0,17.65,5,7,0.714,4,6,0.667,0,0,,0,0,0,0,1,0,0,4,14,10.5,5.0,Oshae Brissett,1,1,1.0
5956,11/19/2022,24.416438356164385,W,0,19.933333333333334,2,7,0.286,1,3,0.333,0,0,,0,4,4,0,0,0,1,0,5,1.1,-6.0,Oshae Brissett,1,4,0.25
5957,11/21/2022,24.421917808219177,W,0,26.716666666666665,5,9,0.556,4,7,0.571,4,5,0.8,1,2,3,1,2,0,0,1,18,16.9,19.0,Oshae Brissett,1,2,0.5
5958,11/23/2022,24.427397260273974,L,0,19.733333333333334,2,7,0.286,1,5,0.2,0,2,0.0,1,3,4,0,2,0,0,2,5,2.9,0.0,Oshae Brissett,1,2,0.5
5959,11/25/2022,24.432876712328767,W,0,11.766666666666667,1,3,0.333,0,1,0.0,0,0,,1,3,4,0,1,0,0,1,2,2.5,-8.0,Oshae Brissett,1,2,0.5
5960,11/27/2022,24.438356164383563,L,0,22.8,0,3,0.0,0,3,0.0,1,2,0.5,2,3,5,1,1,2,0,2,1,3.1,-6.0,Oshae Brissett,0,0,
5961,10/19/2022,23.24931506849315,L,0,10.1,0,1,0.0,0,0,,0,0,,1,1,2,2,1,1,2,3,0,0.2,6.0,Goga Bitadze,0,1,0.0
5962,10/21/2022,23.254794520547946,L,0,18.1,4,7,0.571,0,2,0.0,0,0,,1,0,1,0,0,0,1,4,8,2.8,-7.0,Goga Bitadze,4,5,0.8
5963,10/22/2022,23.257534246575343,W,0,25.4,6,8,0.75,1,3,0.333,1,4,0.25,8,7,15,4,1,1,1,3,14,19.6,8.0,Goga Bitadze,5,5,1.0
5964,10/24/2022,23.263013698630136,L,0,20.733333333333334,0,2,0.0,0,1,0.0,3,4,0.75,0,3,3,1,0,2,0,3,3,3.0,-8.0,Goga Bitadze,0,1,0.0
5965,10/28/2022,23.273972602739725,W,0,2.4333333333333336,0,0,,0,0,,2,2,1.0,0,0,0,1,0,0,0,1,2,2.3,-1.0,Goga Bitadze,0,0,
5966,10/29/2022,23.276712328767122,W,0,13.416666666666666,2,2,1.0,0,0,,1,4,0.25,1,1,2,1,1,0,0,1,5,5.5,-10.0,Goga Bitadze,2,2,1.0
5967,10/31/2022,23.28219178082192,L,0,7.8,1,3,0.333,0,0,,0,0,,1,2,3,2,1,0,0,1,2,3.6,10.0,Goga Bitadze,1,3,0.3333333333333333
5968,11/9/2022,23.306849315068494,L,0,6.65,1,4,0.25,0,1,0.0,0,0,,1,0,1,1,0,0,2,2,2,-1.8,-4.0,Goga Bitadze,1,3,0.3333333333333333
5969,11/18/2022,23.33150684931507,W,0,2.1333333333333333,0,0,,0,0,,0,0,,0,0,0,0,0,1,1,1,0,-0.7,-1.0,Goga Bitadze,0,0,
5970,11/21/2022,23.339726027397262,W,0,4.566666666666666,0,1,0.0,0,1,0.0,0,0,,0,1,1,0,0,0,1,2,0,-2.2,-2.0,Goga Bitadze,0,0,
5971,11/23/2022,23.345205479452055,L,0,15.45,2,5,0.4,0,1,0.0,0,0,,1,2,3,1,2,3,0,1,4,7.0,1.0,Goga Bitadze,2,4,0.5
5972,11/27/2022,23.356164383561644,L,0,7.866666666666667,2,2,1.0,0,0,,1,2,0.5,1,0,1,0,0,0,1,4,5,2.1,1.0,Goga Bitadze,2,2,1.0
5973,10/19/2022,23.07123287671233,L,1,24.05,2,6,0.333,1,3,0.333,3,4,0.75,1,1,2,1,2,1,1,1,8,7.2,-8.0,Terry Taylor,1,3,0.3333333333333333
5974,10/21/2022,23.076712328767123,L,1,22.166666666666668,4,7,0.571,1,2,0.5,0,0,,2,5,7,2,0,0,0,5,9,8.0,-7.0,Terry Taylor,3,5,0.6
5975,10/22/2022,23.07945205479452,W,0,20.483333333333334,0,3,0.0,0,1,0.0,0,0,,1,1,2,2,0,1,0,0,0,1.0,10.0,Terry Taylor,0,2,0.0
5976,10/24/2022,23.084931506849315,L,0,15.083333333333334,1,4,0.25,0,1,0.0,0,0,,2,2,4,0,0,1,0,2,2,1.5,-11.0,Terry Taylor,1,3,0.3333333333333333
5977,10/26/2022,23.09041095890411,L,0,6.416666666666667,0,0,,0,0,,0,0,,0,0,0,0,0,1,0,1,0,0.3,-14.0,Terry Taylor,0,0,
5978,10/29/2022,23.0986301369863,W,0,0.21666666666666667,0,0,,0,0,,0,0,,0,0,0,0,0,0,0,0,0,0.0,0.0,Terry Taylor,0,0,
5979,11/7/2022,23.123287671232877,W,0,5.633333333333333,0,1,0.0,0,1,0.0,0,0,,0,0,0,0,0,0,0,0,0,-0.7,-1.0,Terry Taylor,0,0,
5980,11/12/2022,23.136986301369863,W,0,0.2,0,0,,0,0,,0,0,,0,0,0,0,0,0,0,0,0,0.0,-2.0,Terry Taylor,0,0,
5981,11/19/2022,23.156164383561645,W,0,5.366666666666666,1,1,1.0,0,0,,1,1,1.0,1,1,2,0,0,0,1,0,3,2.7,8.0,Terry Taylor,1,1,1.0
5982,11/21/2022,23.161643835616438,W,0,4.8,1,1,1.0,0,0,,0,0,,0,0,0,1,0,0,0,1,2,2.0,-2.0,Terry Taylor,1,1,1.0
5983,11/23/2022,23.167123287671235,L,0,1.65,0,1,0.0,0,0,,0,0,,1,0,1,0,0,0,0,0,0,0.0,0.0,Terry Taylor,0,1,0.0
5984,11/27/2022,23.17808219178082,L,0,6.25,2,3,0.667,0,1,0.0,0,0,,0,1,1,0,0,0,0,1,4,2.6,4.0,Terry Taylor,2,2,1.0
5985,10/19/2022,25.350684931506848,L,1,19.416666666666668,1,3,0.333,1,2,0.5,2,2,1.0,0,1,1,0,1,0,1,0,5,3.6,-13.0,Chris Duarte,0,1,0.0
5986,10/21/2022,25.356164383561644,L,1,16.616666666666667,2,6,0.333,0,1,0.0,0,0,,0,1,1,2,0,1,1,1,4,1.6,-6.0,Chris Duarte,2,5,0.4
5987,10/22/2022,25.35890410958904,W,0,21.25,3,14,0.214,1,7,0.143,2,2,1.0,0,2,2,2,0,1,1,3,9,0.9,13.0,Chris Duarte,2,7,0.2857142857142857
5988,10/24/2022,25.364383561643837,L,0,16.35,4,9,0.444,1,3,0.333,0,0,,3,1,4,0,0,0,1,2,9,4.9,-7.0,Chris Duarte,3,6,0.5
5989,10/26/2022,25.36986301369863,L,0,25.766666666666666,4,11,0.364,2,6,0.333,2,2,1.0,0,3,3,1,0,1,0,3,12,7.0,-2.0,Chris Duarte,2,5,0.4
5990,10/28/2022,25.375342465753423,W,0,11.616666666666667,1,3,0.333,0,1,0.0,0,0,,1,1,2,1,0,0,0,1,2,1.6,-1.0,Chris Duarte,1,2,0.5
5991,10/29/2022,25.378082191780823,W,1,22.85,3,8,0.375,3,7,0.429,0,0,,0,3,3,0,0,0,2,3,9,2.3,9.0,Chris Duarte,0,1,0.0
5992,10/31/2022,25.383561643835616,L,1,37.833333333333336,10,15,0.667,5,10,0.5,5,6,0.833,0,3,3,1,0,1,2,2,30,22.6,4.0,Chris Duarte,5,5,1.0
5993,11/4/2022,25.394520547945206,W,1,4.8,0,2,0.0,0,1,0.0,0,0,,0,0,0,2,0,0,0,1,0,-0.4,-5.0,Chris Duarte,0,1,0.0
5994,10/21/2022,35.66575342465753,L,0,11.916666666666666,1,3,0.333,0,1,0.0,0,0,,0,2,2,1,0,2,0,1,2,2.6,1.0,James Johnson,1,2,0.5
5995,10/29/2022,35.68767123287671,W,0,14.316666666666666,2,5,0.4,1,2,0.5,0,0,,0,2,2,2,0,0,0,3,5,3.1,1.0,James Johnson,1,3,0.3333333333333333
5996,10/31/2022,35.69315068493151,L,0,18.233333333333334,2,4,0.5,0,2,0.0,0,0,,0,3,3,1,1,0,0,6,4,2.2,14.0,James Johnson,2,2,1.0
5997,11/18/2022,35.74246575342466,W,0,1.8833333333333333,0,0,,0,0,,0,0,,0,0,0,0,0,0,1,1,0,-1.4,-2.0,James Johnson,0,0,
5998,11/25/2022,35.76164383561644,W,0,9.816666666666666,1,2,0.5,0,1,0.0,0,0,,0,1,1,1,0,0,0,2,2,1.2,12.0,James Johnson,1,1,1.0
5999,11/23/2022,19.536986301369865,L,0,1.65,1,1,1.0,0,0,,0,0,,0,0,0,0,1,0,0,0,2,2.7,0.0,Kendall Brown,1,1,1.0
6000,11/27/2022,19.54794520547945,L,0,6.25,0,0,,0,0,,0,0,,0,0,0,1,1,0,0,2,0,0.9,4.0,Kendall Brown,0,0,
6001,10/19/2022,33.2,W,1,36.13333333333333,14,22,0.636,2,3,0.667,7,11,0.636,1,5,6,9,2,1,1,3,37,34.6,13.0,DeMar DeRozan,12,19,0.631578947368421
6002,10/21/2022,33.205479452054796,L,1,36.78333333333333,11,23,0.478,0,2,0.0,10,11,0.909,1,5,6,6,1,0,3,1,32,23.9,1.0,DeMar DeRozan,11,21,0.5238095238095238
6003,10/22/2022,33.20821917808219,L,1,32.516666666666666,3,9,0.333,0,0,,7,7,1.0,0,2,2,1,2,0,0,2,13,10.4,-6.0,DeMar DeRozan,3,9,0.3333333333333333
6004,10/24/2022,33.21369863013699,W,1,32.75,10,17,0.588,0,0,,5,5,1.0,0,5,5,5,1,0,3,1,25,19.7,1.0,DeMar DeRozan,10,17,0.5882352941176471
6005,10/26/2022,33.21917808219178,W,1,32.28333333333333,6,14,0.429,0,1,0.0,5,5,1.0,0,1,1,6,0,0,3,5,17,9.1,-3.0,DeMar DeRozan,6,13,0.46153846153846156
6006,10/28/2022,33.224657534246575,L,1,35.55,11,20,0.55,0,1,0.0,11,12,0.917,0,1,1,1,1,0,0,1,33,24.6,-15.0,DeMar DeRozan,11,19,0.5789473684210527
6007,10/29/2022,33.227397260273975,L,1,34.25,7,12,0.583,1,2,0.5,9,10,0.9,0,3,3,4,0,0,4,2,24,16.9,2.0,DeMar DeRozan,6,10,0.6
6008,11/1/2022,33.23561643835617,W,1,32.75,8,21,0.381,1,2,0.5,3,3,1.0,0,4,4,1,3,0,1,2,20,11.6,-1.0,DeMar DeRozan,7,19,0.3684210526315789
6009,11/2/2022,33.23835616438356,W,1,28.283333333333335,2,11,0.182,0,1,0.0,5,5,1.0,2,6,8,5,1,1,5,2,9,4.7,-9.0,DeMar DeRozan,2,10,0.2
6010,11/4/2022,33.24383561643835,L,1,35.86666666666667,13,23,0.565,0,3,0.0,20,22,0.909,0,3,3,5,2,1,2,3,46,38.2,10.0,DeMar DeRozan,13,20,0.65
6011,11/6/2022,33.24931506849315,L,1,37.483333333333334,7,9,0.778,0,1,0.0,6,6,1.0,1,4,5,2,1,1,5,2,20,15.7,-8.0,DeMar DeRozan,7,8,0.875
6012,11/7/2022,33.25205479452055,W,1,35.63333333333333,2,6,0.333,0,1,0.0,5,6,0.833,0,6,6,7,1,0,2,4,9,9.3,7.0,DeMar DeRozan,2,5,0.4
6013,11/9/2022,33.25753424657534,L,1,36.63333333333333,14,26,0.538,0,2,0.0,5,6,0.833,0,3,3,3,1,1,3,5,33,19.7,-3.0,DeMar DeRozan,14,24,0.5833333333333334
6014,11/13/2022,33.26849315068493,L,1,25.666666666666668,6,11,0.545,0,1,0.0,4,6,0.667,0,2,2,4,0,1,0,3,16,12.8,-26.0,DeMar DeRozan,6,10,0.6
6015,11/16/2022,33.276712328767125,L,1,30.883333333333333,11,15,0.733,0,1,0.0,6,7,0.857,1,3,4,7,0,0,0,3,28,26.8,-14.0,DeMar DeRozan,11,14,0.7857142857142857
6016,11/18/2022,33.28219178082192,L,1,43.63333333333333,16,30,0.533,1,2,0.5,8,9,0.889,1,3,4,2,0,0,2,2,41,26.2,13.0,DeMar DeRozan,15,28,0.5357142857142857
6017,11/21/2022,33.29041095890411,W,1,35.05,11,24,0.458,3,3,1.0,3,3,1.0,0,8,8,4,1,0,2,3,28,18.6,20.0,DeMar DeRozan,8,21,0.38095238095238093
6018,11/23/2022,33.295890410958904,W,1,37.55,14,24,0.583,2,3,0.667,6,7,0.857,0,4,4,8,1,2,2,0,36,31.6,15.0,DeMar DeRozan,12,21,0.5714285714285714
6019,11/25/2022,33.3013698630137,L,1,42.266666666666666,12,27,0.444,0,1,0.0,6,8,0.75,0,4,4,6,2,0,2,5,30,18.5,6.0,DeMar DeRozan,12,26,0.46153846153846156
6020,10/19/2022,31.986301369863014,W,1,33.11666666666667,5,13,0.385,1,5,0.2,4,4,1.0,5,12,17,2,0,3,1,1,15,17.1,16.0,Nikola Vučević,4,8,0.5
6021,10/21/2022,31.991780821917807,L,1,29.983333333333334,5,14,0.357,2,7,0.286,12,12,1.0,2,6,8,1,0,0,1,0,24,19.1,-10.0,Nikola Vučević,3,7,0.42857142857142855
6022,10/22/2022,31.994520547945207,L,1,30.783333333333335,7,12,0.583,2,3,0.667,0,0,,1,3,4,3,0,3,2,3,16,13.0,-10.0,Nikola Vučević,5,9,0.5555555555555556
6023,10/24/2022,32.0,W,1,30.616666666666667,7,19,0.368,0,3,0.0,4,5,0.8,10,13,23,5,0,0,2,3,18,18.3,1.0,Nikola Vučević,7,16,0.4375
6024,10/26/2022,32.00547945205479,W,1,31.25,5,10,0.5,1,3,0.333,3,3,1.0,1,6,7,4,0,0,2,4,14,10.7,-1.0,Nikola Vučević,4,7,0.5714285714285714
6025,10/28/2022,32.010958904109586,L,1,24.516666666666666,4,13,0.308,1,5,0.2,0,0,,3,2,5,2,0,1,2,3,9,3.1,-15.0,Nikola Vučević,3,8,0.375
6026,10/29/2022,32.013698630136986,L,1,36.36666666666667,8,14,0.571,5,7,0.714,2,2,1.0,3,16,19,3,1,0,4,4,23,20.8,-2.0,Nikola Vučević,3,7,0.42857142857142855
6027,11/1/2022,32.02191780821918,W,1,31.933333333333334,3,8,0.375,0,1,0.0,1,2,0.5,3,12,15,2,1,0,1,2,7,8.5,5.0,Nikola Vučević,3,7,0.42857142857142855
6028,11/2/2022,32.02465753424657,W,1,31.566666666666666,5,16,0.313,2,6,0.333,2,2,1.0,2,11,13,3,0,1,4,2,14,7.5,-4.0,Nikola Vučević,3,10,0.3
6029,11/4/2022,32.03013698630137,L,1,35.233333333333334,10,14,0.714,4,5,0.8,0,0,,3,9,12,3,1,0,1,4,24,23.5,10.0,Nikola Vučević,6,9,0.6666666666666666
6030,11/6/2022,32.035616438356165,L,1,35.46666666666667,8,13,0.615,2,5,0.4,0,0,,4,8,12,6,0,1,4,2,18,17.4,-10.0,Nikola Vučević,6,8,0.75
6031,11/7/2022,32.038356164383565,W,1,34.71666666666667,7,14,0.5,1,4,0.25,0,0,,0,13,13,4,0,2,5,3,15,9.9,7.0,Nikola Vučević,6,10,0.6
6032,11/9/2022,32.04383561643836,L,1,27.4,6,9,0.667,2,4,0.5,4,5,0.8,0,7,7,2,0,0,2,2,18,14.4,-13.0,Nikola Vučević,4,5,0.8
6033,11/13/2022,32.054794520547944,L,1,23.066666666666666,4,10,0.4,1,3,0.333,0,0,,0,6,6,0,0,0,3,1,9,2.0,-16.0,Nikola Vučević,3,7,0.42857142857142855
6034,11/16/2022,32.06301369863014,L,1,29.766666666666666,6,13,0.462,2,5,0.4,0,0,,2,8,10,0,1,0,2,1,14,9.7,-10.0,Nikola Vučević,4,8,0.5
6035,11/18/2022,32.06849315068493,L,1,33.4,5,13,0.385,0,2,0.0,4,6,0.667,3,13,16,7,1,3,1,3,14,17.9,9.0,Nikola Vučević,5,11,0.45454545454545453
6036,11/21/2022,32.07671232876712,W,1,35.05,6,7,0.857,0,1,0.0,0,1,0.0,1,12,13,6,0,0,0,0,12,17.6,20.0,Nikola Vučević,6,6,1.0
6037,11/23/2022,32.082191780821915,W,1,29.8,7,14,0.5,4,10,0.4,0,0,,1,4,5,4,0,1,2,1,18,14.0,13.0,Nikola Vučević,3,4,0.75
6038,11/25/2022,32.087671232876716,L,1,39.983333333333334,6,14,0.429,1,7,0.143,0,0,,3,10,13,3,0,0,2,1,13,10.4,5.0,Nikola Vučević,5,7,0.7142857142857143
6039,10/19/2022,21.147945205479452,W,1,28.133333333333333,2,6,0.333,0,2,0.0,0,0,,0,2,2,0,1,0,1,1,4,0.8,-4.0,Patrick Williams,2,4,0.5
6040,10/21/2022,21.153424657534245,L,1,23.95,2,5,0.4,1,3,0.333,2,2,1.0,1,0,1,0,0,1,1,1,7,4.3,-23.0,Patrick Williams,1,2,0.5
6041,10/22/2022,21.156164383561645,L,1,15.516666666666667,2,7,0.286,1,3,0.333,1,2,0.5,1,2,3,0,1,0,1,1,6,2.4,0.0,Patrick Williams,1,4,0.25
6042,10/24/2022,21.161643835616438,W,1,14.65,2,7,0.286,0,2,0.0,0,0,,1,2,3,0,0,1,0,1,4,1.5,-9.0,Patrick Williams,2,5,0.4
6043,10/26/2022,21.167123287671235,W,1,14.933333333333334,4,5,0.8,2,2,1.0,0,0,,0,0,0,2,2,0,2,0,10,9.5,-3.0,Patrick Williams,2,3,0.6666666666666666
6044,10/28/2022,21.172602739726027,L,1,20.183333333333334,4,7,0.571,1,2,0.5,1,1,1.0,0,2,2,1,3,0,1,2,10,9.2,-7.0,Patrick Williams,3,5,0.6
6045,10/29/2022,21.175342465753424,L,1,32.31666666666667,2,5,0.4,1,3,0.333,4,4,1.0,0,3,3,0,1,1,3,3,9,4.7,-1.0,Patrick Williams,1,2,0.5
6046,11/1/2022,21.183561643835617,W,1,29.966666666666665,5,10,0.5,0,3,0.0,2,2,1.0,3,4,7,1,1,2,3,2,12,9.6,-8.0,Patrick Williams,5,7,0.7142857142857143
6047,11/2/2022,21.186301369863013,W,1,32.583333333333336,7,9,0.778,2,3,0.667,0,0,,1,4,5,1,0,1,1,1,16,14.4,19.0,Patrick Williams,5,6,0.8333333333333334
6048,11/4/2022,21.19178082191781,L,1,30.266666666666666,3,9,0.333,1,4,0.25,0,0,,0,5,5,1,0,1,4,6,7,-1.6,-3.0,Patrick Williams,2,5,0.4
6049,11/6/2022,21.197260273972603,L,1,28.533333333333335,5,16,0.313,3,6,0.5,0,0,,5,2,7,1,0,2,0,4,13,8.4,-1.0,Patrick Williams,2,10,0.2
6050,11/7/2022,21.2,W,1,24.783333333333335,4,8,0.5,0,2,0.0,2,2,1.0,3,3,6,2,0,1,1,4,10,8.5,2.0,Patrick Williams,4,6,0.6666666666666666
6051,11/9/2022,21.205479452054796,L,1,26.316666666666666,3,7,0.429,1,2,0.5,0,0,,1,3,4,1,1,4,2,1,7,7.0,-5.0,Patrick Williams,2,5,0.4
6052,11/13/2022,21.216438356164385,L,1,30.3,6,9,0.667,2,3,0.667,1,1,1.0,1,3,4,1,1,2,1,0,15,14.8,-24.0,Patrick Williams,4,6,0.6666666666666666
6053,11/16/2022,21.224657534246575,L,1,23.033333333333335,2,4,0.5,1,2,0.5,0,0,,0,4,4,1,0,0,2,2,5,2.1,-21.0,Patrick Williams,1,2,0.5
6054,11/18/2022,21.23013698630137,L,1,32.56666666666667,3,5,0.6,2,4,0.5,4,4,1.0,2,5,7,1,1,0,1,0,12,13.3,4.0,Patrick Williams,1,1,1.0
6055,11/21/2022,21.23835616438356,W,1,25.666666666666668,6,9,0.667,3,4,0.75,2,2,1.0,0,4,4,0,1,0,1,1,17,13.9,9.0,Patrick Williams,3,5,0.6
6056,11/23/2022,21.243835616438357,W,1,26.083333333333332,3,7,0.429,2,4,0.5,3,4,0.75,0,3,3,3,1,2,3,4,11,7.7,-9.0,Patrick Williams,1,3,0.3333333333333333
6057,11/25/2022,21.24931506849315,L,1,31.966666666666665,4,7,0.571,3,3,1.0,0,0,,2,4,6,1,0,2,2,4,11,8.8,7.0,Patrick Williams,1,4,0.25
6058,10/19/2022,29.24109589041096,W,0,18.266666666666666,1,2,0.5,0,1,0.0,4,4,1.0,0,3,3,1,1,0,0,6,6,5.2,8.0,Javonte Green,1,1,1.0
6059,10/21/2022,29.246575342465754,L,0,15.183333333333334,0,4,0.0,0,2,0.0,0,0,,0,1,1,2,2,0,0,2,0,0.1,2.0,Javonte Green,0,2,0.0
6060,10/22/2022,29.24931506849315,L,0,13.733333333333333,2,5,0.4,0,2,0.0,2,3,0.667,1,2,3,2,2,2,0,0,6,9.0,-11.0,Javonte Green,2,3,0.6666666666666666
6061,10/24/2022,29.254794520547946,W,0,16.6,2,2,1.0,2,2,1.0,0,0,,0,2,2,0,1,2,0,2,6,7.6,2.0,Javonte Green,0,0,
6062,10/26/2022,29.26027397260274,W,0,16.8,4,6,0.667,0,1,0.0,0,0,,2,2,4,1,1,0,0,2,8,8.3,0.0,Javonte Green,4,5,0.8
6063,10/28/2022,29.265753424657536,L,0,24.35,3,7,0.429,0,2,0.0,0,0,,1,3,4,0,3,1,2,2,6,4.8,7.0,Javonte Green,3,5,0.6
6064,10/29/2022,29.268493150684932,L,0,18.616666666666667,3,4,0.75,0,0,,3,4,0.75,5,1,6,1,1,0,1,3,9,10.3,-3.0,Javonte Green,3,4,0.75
6065,11/1/2022,29.276712328767122,W,0,14.533333333333333,0,2,0.0,0,0,,0,0,,1,1,2,0,0,0,0,2,0,-1.2,8.0,Javonte Green,0,2,0.0
6066,11/2/2022,29.279452054794522,W,0,27.0,7,7,1.0,3,3,1.0,0,1,0.0,3,5,8,1,2,3,3,3,17,18.7,13.0,Javonte Green,4,4,1.0
6067,11/4/2022,29.284931506849315,L,0,15.766666666666667,2,4,0.5,1,3,0.333,0,0,,0,3,3,1,2,1,2,4,5,3.7,4.0,Javonte Green,1,1,1.0
6068,11/6/2022,29.29041095890411,L,0,21.233333333333334,4,7,0.571,1,2,0.5,1,1,1.0,0,3,3,1,0,0,0,2,10,7.5,-9.0,Javonte Green,3,5,0.6
6069,11/7/2022,29.293150684931508,W,0,18.55,3,6,0.5,1,3,0.333,2,2,1.0,2,1,3,3,1,0,0,0,9,10.8,12.0,Javonte Green,2,3,0.6666666666666666
6070,11/9/2022,29.2986301369863,L,0,15.616666666666667,1,2,0.5,0,0,,0,0,,0,2,2,0,0,1,1,2,2,0.5,1.0,Javonte Green,1,2,0.5
6071,11/13/2022,29.30958904109589,L,0,7.966666666666667,0,1,0.0,0,0,,0,0,,1,0,1,0,0,0,1,0,0,-1.0,-5.0,Javonte Green,0,1,0.0
6072,11/16/2022,29.317808219178083,L,0,14.766666666666667,1,7,0.143,0,2,0.0,1,2,0.5,2,2,4,0,0,1,0,1,3,0.4,-3.0,Javonte Green,1,5,0.2
6073,11/18/2022,29.323287671232876,L,0,17.866666666666667,4,4,1.0,0,0,,0,0,,0,2,2,1,3,0,0,2,8,10.3,17.0,Javonte Green,4,4,1.0
6074,11/21/2022,29.33150684931507,W,0,12.016666666666667,3,3,1.0,0,0,,2,4,0.5,1,2,3,1,0,0,0,1,8,7.9,-3.0,Javonte Green,3,3,1.0
6075,11/23/2022,29.336986301369862,W,0,18.566666666666666,4,5,0.8,2,3,0.667,1,2,0.5,2,1,3,1,1,2,0,0,11,13.5,5.0,Javonte Green,2,2,1.0
6076,11/25/2022,29.34246575342466,L,0,11.016666666666667,0,0,,0,0,,1,2,0.5,1,4,5,0,0,0,2,0,1,0.5,-9.0,Javonte Green,0,0,
6077,10/19/2022,28.638356164383563,W,1,29.65,2,10,0.2,1,6,0.167,1,2,0.5,2,3,5,4,2,0,4,4,6,0.9,9.0,Alex Caruso,1,4,0.25
6078,10/21/2022,28.643835616438356,L,1,30.75,1,4,0.25,0,2,0.0,1,2,0.5,0,3,3,1,3,1,4,1,3,1.1,-8.0,Alex Caruso,1,2,0.5
6079,10/22/2022,28.646575342465752,L,0,16.6,0,1,0.0,0,1,0.0,2,2,1.0,0,2,2,2,1,1,1,1,2,3.6,-15.0,Alex Caruso,0,0,
6080,10/24/2022,28.65205479452055,W,0,18.35,2,2,1.0,1,1,1.0,2,2,1.0,0,3,3,4,0,2,2,2,7,8.7,29.0,Alex Caruso,1,1,1.0
6081,10/26/2022,28.65753424657534,W,0,23.266666666666666,3,4,0.75,2,3,0.667,0,0,,0,2,2,3,3,2,1,3,8,11.3,18.0,Alex Caruso,1,1,1.0
6082,10/28/2022,28.663013698630138,L,1,23.533333333333335,1,5,0.2,1,3,0.333,0,0,,3,0,3,4,1,0,1,1,3,4.4,-11.0,Alex Caruso,0,2,0.0
6083,10/29/2022,28.665753424657535,L,1,35.166666666666664,2,5,0.4,1,2,0.5,4,4,1.0,0,3,3,6,3,1,1,1,9,13.7,7.0,Alex Caruso,1,3,0.3333333333333333
6084,11/1/2022,28.673972602739727,W,0,25.016666666666666,1,4,0.25,1,2,0.5,1,2,0.5,0,4,4,4,0,0,0,1,4,4.8,11.0,Alex Caruso,0,2,0.0
6085,11/2/2022,28.676712328767124,W,0,24.183333333333334,2,3,0.667,1,2,0.5,1,2,0.5,0,0,0,3,1,1,1,3,6,5.9,12.0,Alex Caruso,1,1,1.0
6086,11/4/2022,28.682191780821917,L,0,22.65,2,3,0.667,1,2,0.5,0,0,,0,1,1,3,0,1,3,3,5,2.6,-14.0,Alex Caruso,1,1,1.0
6087,11/6/2022,28.687671232876713,L,1,32.233333333333334,1,11,0.091,0,6,0.0,2,2,1.0,3,8,11,11,2,2,2,2,4,9.5,15.0,Alex Caruso,1,5,0.2
6088,11/7/2022,28.69041095890411,W,0,28.016666666666666,1,2,0.5,1,1,1.0,1,2,0.5,0,6,6,5,2,2,3,1,4,7.9,16.0,Alex Caruso,0,1,0.0
6089,11/9/2022,28.695890410958903,L,0,22.833333333333332,0,1,0.0,0,1,0.0,0,0,,0,3,3,1,1,0,0,4,0,0.3,1.0,Alex Caruso,0,0,
6090,11/13/2022,28.706849315068492,L,0,21.233333333333334,0,1,0.0,0,1,0.0,0,0,,0,0,0,2,3,1,3,1,0,1.0,-2.0,Alex Caruso,0,0,
6091,11/16/2022,28.715068493150685,L,0,27.266666666666666,5,7,0.714,3,4,0.75,0,0,,0,2,2,2,0,0,0,2,13,11.3,-4.0,Alex Caruso,2,3,0.6666666666666666
6092,11/18/2022,28.720547945205478,L,0,22.866666666666667,3,5,0.6,1,2,0.5,0,0,,1,0,1,5,0,0,1,5,7,5.9,-8.0,Alex Caruso,2,3,0.6666666666666666
6093,11/21/2022,28.72876712328767,W,0,28.566666666666666,4,7,0.571,2,4,0.5,0,0,,0,1,1,4,4,0,0,3,10,12.6,6.0,Alex Caruso,2,3,0.6666666666666666
6094,11/23/2022,28.734246575342464,W,0,27.3,0,2,0.0,0,2,0.0,0,0,,0,1,1,3,2,0,1,3,0,0.8,14.0,Alex Caruso,0,0,
6095,11/25/2022,28.73972602739726,L,0,28.183333333333334,4,5,0.8,2,2,1.0,2,2,1.0,0,2,2,4,1,1,1,3,12,13.0,1.0,Alex Caruso,2,3,0.6666666666666666
6096,10/19/2022,22.753424657534246,W,1,36.416666666666664,7,14,0.5,3,6,0.5,0,0,,1,5,6,4,2,1,2,2,17,14.9,15.0,Ayo Dosunmu,4,8,0.5
6097,10/21/2022,22.75890410958904,L,1,31.0,3,9,0.333,1,4,0.25,0,0,,1,4,5,2,1,0,0,3,7,5.0,-19.0,Ayo Dosunmu,2,5,0.4
6098,10/22/2022,22.76164383561644,L,1,27.5,2,7,0.286,1,4,0.25,0,0,,1,3,4,3,0,0,0,3,5,3.4,-5.0,Ayo Dosunmu,1,3,0.3333333333333333
6099,10/24/2022,22.767123287671232,W,1,33.61666666666667,9,10,0.9,4,4,1.0,0,0,,0,6,6,2,1,0,2,3,22,19.6,2.0,Ayo Dosunmu,5,6,0.8333333333333334
6100,10/26/2022,22.77260273972603,W,1,30.8,4,9,0.444,0,2,0.0,4,4,1.0,1,3,4,7,2,1,1,2,12,14.7,-1.0,Ayo Dosunmu,4,7,0.5714285714285714
6101,10/28/2022,22.778082191780822,L,1,20.3,5,10,0.5,2,4,0.5,0,0,,0,3,3,1,0,0,2,1,12,6.2,-22.0,Ayo Dosunmu,3,6,0.5
6102,11/1/2022,22.78904109589041,W,1,33.016666666666666,7,11,0.636,1,4,0.25,2,2,1.0,0,3,3,4,3,0,2,2,17,16.0,12.0,Ayo Dosunmu,6,7,0.8571428571428571
6103,11/2/2022,22.791780821917808,W,1,30.883333333333333,3,10,0.3,0,3,0.0,2,2,1.0,0,4,4,3,0,0,2,3,8,2.3,4.0,Ayo Dosunmu,3,7,0.42857142857142855
6104,11/4/2022,22.797260273972604,L,1,29.383333333333333,5,8,0.625,1,1,1.0,0,0,,0,3,3,3,0,0,1,3,11,8.2,5.0,Ayo Dosunmu,4,7,0.5714285714285714
6105,11/6/2022,22.802739726027397,L,1,38.0,6,15,0.4,3,8,0.375,0,0,,0,3,3,3,0,0,3,4,15,5.3,-30.0,Ayo Dosunmu,3,7,0.42857142857142855
6106,11/7/2022,22.805479452054794,W,1,27.35,5,10,0.5,2,7,0.286,0,0,,0,4,4,2,0,2,3,2,12,7.2,-3.0,Ayo Dosunmu,3,3,1.0
6107,11/9/2022,22.81095890410959,L,1,25.9,2,3,0.667,0,0,,3,3,1.0,1,2,3,4,0,0,2,1,7,7.4,-15.0,Ayo Dosunmu,2,3,0.6666666666666666
6108,11/13/2022,22.82191780821918,L,1,29.55,3,9,0.333,0,4,0.0,1,2,0.5,1,1,2,4,2,0,2,3,7,4.1,-27.0,Ayo Dosunmu,3,5,0.6
6109,11/16/2022,22.83013698630137,L,1,27.583333333333332,2,5,0.4,0,3,0.0,0,0,,1,2,3,1,1,0,2,1,4,1.9,-8.0,Ayo Dosunmu,2,2,1.0
6110,11/18/2022,22.835616438356166,L,1,24.133333333333333,6,8,0.75,1,2,0.5,0,0,,0,0,0,2,1,3,2,3,13,11.1,-5.0,Ayo Dosunmu,5,6,0.8333333333333334
6111,11/21/2022,22.843835616438355,W,1,36.083333333333336,5,8,0.625,0,1,0.0,0,0,,0,3,3,2,0,0,1,5,10,5.7,16.0,Ayo Dosunmu,5,7,0.7142857142857143
6112,11/23/2022,22.84931506849315,W,1,24.4,3,5,0.6,1,2,0.5,1,1,1.0,0,3,3,3,0,2,3,4,8,5.5,-3.0,Ayo Dosunmu,2,3,0.6666666666666666
6113,11/25/2022,22.854794520547944,L,1,25.0,3,7,0.429,0,2,0.0,1,1,1.0,1,2,3,4,1,0,0,4,7,6.8,-2.0,Ayo Dosunmu,3,5,0.6
6114,10/19/2022,36.45479452054794,W,0,18.833333333333332,4,8,0.5,4,5,0.8,0,2,0.0,0,0,0,2,2,0,1,2,12,8.8,-9.0,Goran Dragić,0,3,0.0
6115,10/21/2022,36.46027397260274,L,0,23.283333333333335,3,8,0.375,1,3,0.333,0,0,,2,0,2,5,0,0,0,4,7,5.9,22.0,Goran Dragić,2,5,0.4
6116,10/22/2022,36.463013698630135,L,0,11.416666666666666,2,4,0.5,0,1,0.0,0,0,,0,2,2,3,0,0,1,1,4,3.3,-16.0,Goran Dragić,2,3,0.6666666666666666
6117,10/24/2022,36.46849315068493,W,0,17.2,2,7,0.286,0,1,0.0,3,4,0.75,0,0,0,6,0,0,0,1,7,6.3,21.0,Goran Dragić,2,6,0.3333333333333333
6118,10/26/2022,36.47397260273973,W,0,15.766666666666667,5,9,0.556,3,3,1.0,0,0,,0,2,2,5,0,0,2,1,13,10.4,19.0,Goran Dragić,2,6,0.3333333333333333
6119,10/28/2022,36.47945205479452,L,0,21.816666666666666,3,8,0.375,1,3,0.333,2,2,1.0,0,3,3,5,0,0,2,1,9,6.6,6.0,Goran Dragić,2,5,0.4
6120,10/29/2022,36.48219178082192,L,0,13.416666666666666,1,6,0.167,0,2,0.0,0,0,,0,1,1,1,0,0,0,2,2,-1.6,-12.0,Goran Dragić,1,4,0.25
6121,11/1/2022,36.49041095890411,W,0,19.5,4,8,0.5,4,6,0.667,3,4,0.75,0,2,2,2,0,1,1,0,15,12.3,7.0,Goran Dragić,0,2,0.0
6122,11/2/2022,36.49315068493151,W,0,15.266666666666667,6,9,0.667,2,4,0.5,2,2,1.0,0,3,3,3,0,1,3,1,16,12.4,14.0,Goran Dragić,4,5,0.8
6123,11/4/2022,36.4986301369863,L,0,19.416666666666668,2,9,0.222,1,4,0.25,0,0,,0,1,1,2,0,1,1,0,5,0.9,-6.0,Goran Dragić,1,5,0.2
6124,11/6/2022,36.50410958904109,L,0,20.783333333333335,6,10,0.6,4,6,0.667,0,0,,2,0,2,2,0,0,2,3,16,11.0,1.0,Goran Dragić,2,4,0.5
6125,11/7/2022,36.50684931506849,W,0,25.033333333333335,4,9,0.444,0,2,0.0,2,2,1.0,2,3,5,2,1,0,2,2,10,7.2,18.0,Goran Dragić,4,7,0.5714285714285714
6126,11/9/2022,36.512328767123286,L,0,25.55,6,11,0.545,1,5,0.2,1,1,1.0,2,0,2,6,0,0,2,0,14,12.3,9.0,Goran Dragić,5,6,0.8333333333333334
6127,11/13/2022,36.52328767123288,L,0,22.633333333333333,5,10,0.5,1,2,0.5,0,0,,0,1,1,6,1,0,3,2,11,7.7,-2.0,Goran Dragić,4,8,0.5
6128,11/16/2022,36.53150684931507,L,0,20.416666666666668,3,7,0.429,0,2,0.0,0,2,0.0,0,2,2,7,0,0,2,2,6,4.2,-6.0,Goran Dragić,3,5,0.6
6129,11/18/2022,36.536986301369865,L,0,16.483333333333334,0,2,0.0,0,1,0.0,1,2,0.5,0,2,2,4,0,0,0,1,1,2.2,4.0,Goran Dragić,0,1,0.0
6130,11/21/2022,36.54520547945206,W,0,7.183333333333334,0,1,0.0,0,0,,0,0,,0,0,0,0,1,0,1,0,0,-0.7,-3.0,Goran Dragić,0,1,0.0
6131,11/25/2022,36.556164383561644,L,0,10.733333333333333,1,5,0.2,0,1,0.0,0,0,,0,0,0,0,0,0,1,1,2,-2.5,-10.0,Goran Dragić,1,4,0.25
6132,10/22/2022,27.61917808219178,L,1,28.333333333333332,9,17,0.529,2,6,0.333,3,4,0.75,0,3,3,4,2,0,0,2,23,19.2,-19.0,Zach LaVine,7,11,0.6363636363636364
6133,10/24/2022,27.624657534246577,W,1,32.31666666666667,5,15,0.333,3,5,0.6,6,7,0.857,0,2,2,2,1,1,3,0,19,10.8,4.0,Zach LaVine,2,10,0.2
6134,10/26/2022,27.63013698630137,W,1,34.61666666666667,6,13,0.462,6,8,0.75,10,12,0.833,0,6,6,5,1,0,5,1,28,21.4,12.0,Zach LaVine,0,5,0.0
6135,10/29/2022,27.638356164383563,L,1,33.75,8,19,0.421,2,9,0.222,2,2,1.0,0,2,2,3,0,0,2,4,20,9.0,-10.0,Zach LaVine,6,10,0.6
6136,11/1/2022,27.646575342465752,W,1,37.21666666666667,10,21,0.476,5,11,0.455,4,4,1.0,1,2,3,5,0,0,1,2,29,21.3,7.0,Zach LaVine,5,10,0.5
6137,11/2/2022,27.649315068493152,W,1,31.95,4,16,0.25,2,7,0.286,0,0,,0,4,4,6,2,0,0,0,10,7.8,19.0,Zach LaVine,2,9,0.2222222222222222
6138,11/4/2022,27.654794520547945,L,1,36.666666666666664,6,13,0.462,2,6,0.333,2,3,0.667,1,6,7,3,2,0,2,4,16,11.9,-11.0,Zach LaVine,4,7,0.5714285714285714
6139,11/7/2022,27.663013698630138,W,1,32.2,11,20,0.55,4,8,0.5,4,5,0.8,1,2,3,5,2,0,5,5,30,19.8,4.0,Zach LaVine,7,12,0.5833333333333334
6140,11/9/2022,27.66849315068493,L,1,36.416666666666664,9,22,0.409,3,12,0.25,2,2,1.0,1,3,4,4,2,0,1,4,23,15.0,1.0,Zach LaVine,6,10,0.6
6141,11/13/2022,27.67945205479452,L,1,34.06666666666667,8,15,0.533,1,6,0.167,4,5,0.8,1,4,5,4,1,0,3,3,21,14.8,-18.0,Zach LaVine,7,9,0.7777777777777778
6142,11/16/2022,27.687671232876713,L,1,36.11666666666667,9,22,0.409,4,11,0.364,3,4,0.75,0,3,3,5,0,0,3,2,25,13.4,-7.0,Zach LaVine,5,11,0.45454545454545453
6143,11/18/2022,27.693150684931506,L,1,25.216666666666665,1,14,0.071,0,5,0.0,2,2,1.0,1,4,5,2,0,0,1,0,4,-3.1,-19.0,Zach LaVine,1,9,0.1111111111111111
6144,11/21/2022,27.7013698630137,W,1,33.71666666666667,8,20,0.4,5,10,0.5,1,2,0.5,2,3,5,5,2,0,3,5,22,13.6,14.0,Zach LaVine,3,10,0.3
6145,11/23/2022,27.706849315068492,W,1,33.93333333333333,6,17,0.353,3,11,0.273,3,4,0.75,1,4,5,5,1,0,1,4,18,11.9,-13.0,Zach LaVine,3,6,0.5
6146,11/25/2022,27.71232876712329,L,1,45.05,9,23,0.391,4,11,0.364,5,6,0.833,2,3,5,5,1,0,4,4,27,15.3,-4.0,Zach LaVine,5,12,0.4166666666666667
6147,10/22/2022,25.682191780821917,L,0,16.933333333333334,2,3,0.667,1,1,1.0,3,4,0.75,1,1,2,0,2,1,1,1,8,8.6,-12.0,Derrick Jones Jr.,1,2,0.5
6148,10/24/2022,25.687671232876713,W,0,14.75,2,4,0.5,0,1,0.0,6,6,1.0,1,1,2,1,0,0,0,2,10,8.9,16.0,Derrick Jones Jr.,2,3,0.6666666666666666
6149,10/26/2022,25.693150684931506,W,0,9.966666666666667,0,3,0.0,0,1,0.0,0,0,,1,1,2,0,0,0,0,1,0,-1.5,16.0,Derrick Jones Jr.,0,2,0.0
6150,10/28/2022,25.698630136986303,L,0,16.4,1,3,0.333,0,0,,4,4,1.0,1,2,3,0,1,1,0,0,6,7.3,1.0,Derrick Jones Jr.,1,3,0.3333333333333333
6151,10/29/2022,25.7013698630137,L,0,11.633333333333333,2,4,0.5,0,1,0.0,2,3,0.667,1,2,3,1,0,1,0,1,6,5.9,-3.0,Derrick Jones Jr.,2,3,0.6666666666666666
6152,11/1/2022,25.70958904109589,W,0,16.066666666666666,1,4,0.25,0,1,0.0,2,2,1.0,3,1,4,1,0,1,0,0,4,5.4,4.0,Derrick Jones Jr.,1,3,0.3333333333333333
6153,11/2/2022,25.71232876712329,W,0,16.433333333333334,2,6,0.333,2,2,1.0,4,4,1.0,3,2,5,3,0,1,0,3,10,10.9,22.0,Derrick Jones Jr.,0,4,0.0
6154,11/4/2022,25.71780821917808,L,0,14.75,0,0,,0,0,,0,0,,0,2,2,0,1,0,1,1,0,0.2,-15.0,Derrick Jones Jr.,0,0,
6155,11/6/2022,25.723287671232878,L,0,16.5,1,5,0.2,0,2,0.0,2,4,0.5,0,2,2,0,1,3,0,1,4,3.4,-4.0,Derrick Jones Jr.,1,3,0.3333333333333333
6156,11/7/2022,25.726027397260275,W,0,13.066666666666666,5,5,1.0,0,0,,2,3,0.667,1,1,2,0,0,0,0,0,12,11.1,7.0,Derrick Jones Jr.,5,5,1.0
6157,11/9/2022,25.731506849315068,L,0,11.2,2,4,0.5,0,1,0.0,1,1,1.0,1,1,2,1,0,2,0,3,5,4.9,-7.0,Derrick Jones Jr.,2,3,0.6666666666666666
6158,11/13/2022,25.742465753424657,L,0,15.016666666666667,2,4,0.5,0,1,0.0,0,0,,0,3,3,0,0,0,0,2,4,2.1,9.0,Derrick Jones Jr.,2,3,0.6666666666666666
6159,11/16/2022,25.75068493150685,L,0,11.4,0,2,0.0,0,1,0.0,0,0,,0,0,0,1,0,0,1,2,0,-2.5,-2.0,Derrick Jones Jr.,0,1,0.0
6160,11/18/2022,25.756164383561643,L,0,4.9,0,2,0.0,0,2,0.0,0,0,,1,1,2,0,0,0,0,1,0,-0.8,-10.0,Derrick Jones Jr.,0,0,
6161,11/25/2022,25.775342465753425,L,0,6.466666666666667,2,4,0.5,0,1,0.0,2,2,1.0,1,1,2,0,0,1,0,0,6,5.7,1.0,Derrick Jones Jr.,2,3,0.6666666666666666
6162,10/19/2022,29.19178082191781,W,0,14.883333333333333,2,7,0.286,0,1,0.0,5,5,1.0,3,2,5,1,1,1,3,4,9,5.4,-8.0,Andre Drummond,2,6,0.3333333333333333
6163,10/21/2022,29.197260273972603,L,0,18.016666666666666,5,6,0.833,0,0,,0,2,0.0,3,7,10,1,0,1,3,2,10,8.8,8.0,Andre Drummond,5,6,0.8333333333333334
6164,10/22/2022,29.2,L,0,13.1,3,8,0.375,0,1,0.0,2,2,1.0,3,4,7,0,2,0,3,2,8,5.1,-16.0,Andre Drummond,3,7,0.42857142857142855
6165,10/24/2022,29.205479452054796,W,0,15.283333333333333,1,2,0.5,0,0,,0,0,,2,10,12,0,0,0,1,2,2,3.6,16.0,Andre Drummond,1,2,0.5
6166,10/26/2022,29.21095890410959,W,0,16.75,4,8,0.5,0,0,,0,0,,4,9,13,1,0,1,0,4,8,9.3,16.0,Andre Drummond,4,8,0.5
6167,10/28/2022,29.216438356164385,L,0,22.5,8,12,0.667,0,0,,1,3,0.333,7,7,14,2,3,0,1,3,17,20.2,13.0,Andre Drummond,8,12,0.6666666666666666
6168,11/9/2022,29.24931506849315,L,0,12.133333333333333,1,2,0.5,0,0,,0,0,,0,5,5,1,0,0,2,1,2,0.8,11.0,Andre Drummond,1,2,0.5
6169,11/13/2022,29.26027397260274,L,0,21.516666666666666,5,8,0.625,0,0,,3,3,1.0,4,7,11,1,1,0,1,3,13,13.8,-8.0,Andre Drummond,5,8,0.625
6170,11/16/2022,29.268493150684932,L,0,14.966666666666667,4,6,0.667,0,0,,0,0,,1,3,4,0,0,0,0,2,8,6.2,-1.0,Andre Drummond,4,6,0.6666666666666666
6171,11/18/2022,29.273972602739725,L,0,14.6,3,5,0.6,0,0,,1,2,0.5,4,2,6,1,0,0,2,1,7,6.0,-10.0,Andre Drummond,3,5,0.6
6172,11/21/2022,29.28219178082192,W,0,12.95,1,2,0.5,0,0,,3,4,0.75,4,8,12,1,0,0,2,1,5,7.1,-6.0,Andre Drummond,1,2,0.5
6173,11/23/2022,29.28767123287671,W,0,16.95,1,3,0.333,0,0,,0,0,,1,7,8,1,0,2,0,3,2,4.0,-4.0,Andre Drummond,1,3,0.3333333333333333
6174,11/25/2022,29.293150684931508,L,0,6.55,1,4,0.25,0,0,,2,2,1.0,3,1,4,1,0,0,0,0,4,4.7,-10.0,Andre Drummond,1,4,0.25
6175,10/19/2022,22.671232876712327,W,0,24.533333333333335,4,11,0.364,2,7,0.286,0,0,,0,2,2,0,1,0,1,3,10,3.3,0.0,Coby White,2,4,0.5
6176,10/21/2022,22.676712328767124,L,0,31.05,3,6,0.5,2,4,0.5,2,4,0.5,0,2,2,1,1,0,1,1,10,7.1,17.0,Coby White,1,2,0.5
6177,10/22/2022,22.67945205479452,L,0,23.6,2,8,0.25,0,5,0.0,1,1,1.0,1,0,1,1,0,0,0,3,5,0.4,-30.0,Coby White,2,3,0.6666666666666666
6178,10/24/2022,22.684931506849313,W,0,9.4,0,1,0.0,0,1,0.0,0,0,,0,0,0,4,0,0,0,1,0,1.7,5.0,Coby White,0,0,
6179,10/26/2022,22.69041095890411,W,0,11.933333333333334,2,6,0.333,2,6,0.333,0,0,,0,3,3,0,1,0,0,1,6,4.1,3.0,Coby White,0,0,
6180,10/28/2022,22.695890410958903,L,0,30.85,7,14,0.5,3,7,0.429,2,4,0.5,0,4,4,4,1,0,1,5,19,13.2,18.0,Coby White,4,7,0.5714285714285714
6181,10/29/2022,22.698630136986303,L,0,21.566666666666666,3,9,0.333,1,4,0.25,0,0,,0,0,0,2,1,0,3,0,7,1.3,-2.0,Coby White,2,5,0.4
6182,11/18/2022,22.753424657534246,L,0,4.333333333333333,0,1,0.0,0,1,0.0,0,0,,0,1,1,2,0,0,1,1,0,-0.4,0.0,Coby White,0,0,
6183,11/21/2022,22.76164383561644,W,0,13.716666666666667,2,8,0.25,1,6,0.167,4,4,1.0,0,2,2,3,1,1,1,0,9,7.6,-3.0,Coby White,1,2,0.5
6184,11/23/2022,22.767123287671232,W,0,25.416666666666668,5,10,0.5,4,7,0.571,0,0,,0,3,3,2,3,1,1,1,14,13.6,7.0,Coby White,1,3,0.3333333333333333
6185,11/25/2022,22.77260273972603,L,0,17.783333333333335,2,5,0.4,2,5,0.4,0,0,,1,2,3,1,0,0,1,2,6,3.5,-5.0,Coby White,0,0,
6186,10/22/2022,20.279452054794522,L,0,4.116666666666666,0,1,0.0,0,0,,0,0,,0,0,0,0,0,0,1,0,0,-1.7,-6.0,Dalen Terry,0,1,0.0
6187,10/24/2022,20.284931506849315,W,0,2.1,0,1,0.0,0,1,0.0,0,0,,0,0,0,0,0,0,0,0,0,-0.7,1.0,Dalen Terry,0,0,
6188,10/26/2022,20.29041095890411,W,0,0.9833333333333333,0,0,,0,0,,0,0,,0,0,0,0,0,1,1,1,0,-0.7,1.0,Dalen Terry,0,0,
6189,10/29/2022,20.2986301369863,L,0,2.9166666666666665,0,2,0.0,0,1,0.0,0,0,,0,0,0,1,0,0,0,0,0,-0.7,-1.0,Dalen Terry,0,1,0.0
6190,11/2/2022,20.30958904109589,W,0,1.85,0,1,0.0,0,0,,0,0,,0,1,1,0,0,0,0,0,0,-0.4,0.0,Dalen Terry,0,1,0.0
6191,11/6/2022,20.32054794520548,L,0,9.766666666666667,2,2,1.0,0,0,,0,0,,0,1,1,1,1,1,1,0,4,5.1,1.0,Dalen Terry,2,2,1.0
6192,11/7/2022,20.323287671232876,W,0,0.21666666666666667,0,0,,0,0,,0,0,,0,0,0,0,0,0,0,0,0,0.0,0.0,Dalen Terry,0,0,
6193,11/13/2022,20.339726027397262,L,0,5.566666666666666,1,3,0.333,1,1,1.0,2,2,1.0,0,0,0,2,0,0,1,1,5,3.3,3.0,Dalen Terry,0,2,0.0
6194,11/16/2022,20.34794520547945,L,0,1.9,0,0,,0,0,,1,2,0.5,0,0,0,1,0,0,0,0,1,1.3,3.0,Dalen Terry,0,0,
6195,10/22/2022,24.786301369863015,L,0,4.116666666666666,0,1,0.0,0,1,0.0,0,0,,1,1,2,0,0,0,0,0,0,0.3,-6.0,Tony Bradley,0,0,
6196,10/24/2022,24.791780821917808,W,0,2.1,0,0,,0,0,,0,0,,0,1,1,0,0,0,0,0,0,0.3,1.0,Tony Bradley,0,0,
6197,11/7/2022,24.83013698630137,W,0,0.21666666666666667,0,0,,0,0,,0,0,,0,1,1,0,0,0,0,0,0,0.3,0.0,Tony Bradley,0,0,
6198,11/13/2022,24.846575342465755,L,0,3.4166666666666665,0,0,,0,0,,2,2,1.0,0,1,1,0,0,0,0,0,2,2.3,1.0,Tony Bradley,0,0,
6199,11/16/2022,24.854794520547944,L,0,1.9,1,1,1.0,1,1,1.0,0,0,,0,1,1,0,0,0,0,0,3,3.0,3.0,Tony Bradley,0,0,
6200,10/24/2022,26.994520547945207,W,0,0.26666666666666666,0,0,,0,0,,0,0,,0,1,1,0,0,0,0,0,0,0.3,0.0,Malcolm Hill,0,0,
6201,10/26/2022,27.0,W,0,0.65,0,0,,0,0,,0,0,,0,0,0,0,0,0,0,0,0,0.0,-2.0,Malcolm Hill,0,0,
6202,11/7/2022,27.03287671232877,W,0,0.21666666666666667,0,0,,0,0,,0,0,,0,0,0,0,0,0,0,0,0,0.0,0.0,Malcolm Hill,0,0,
6203,10/22/2022,23.019178082191782,L,0,1.7333333333333334,0,1,0.0,0,1,0.0,0,0,,0,0,0,0,0,0,0,0,0,-0.7,-8.0,Marko Simonovic,0,0,
6204,10/19/2022,21.23013698630137,W,0,16.183333333333334,1,9,0.111,0,3,0.0,1,1,1.0,0,5,5,5,3,1,0,1,3,5.4,6.0,Killian Hayes,1,6,0.16666666666666666
6205,10/21/2022,21.235616438356164,L,0,17.516666666666666,0,5,0.0,0,3,0.0,1,2,0.5,0,1,1,5,0,0,1,4,1,-1.7,-14.0,Killian Hayes,0,2,0.0
6206,10/22/2022,21.23835616438356,L,0,17.483333333333334,2,4,0.5,1,3,0.333,0,0,,0,0,0,2,0,1,0,2,5,4.3,-12.0,Killian Hayes,1,1,1.0
6207,10/25/2022,21.246575342465754,L,0,16.95,0,6,0.0,0,1,0.0,0,0,,0,2,2,0,0,0,4,1,0,-8.0,-3.0,Killian Hayes,0,5,0.0
6208,10/26/2022,21.24931506849315,L,0,15.7,2,6,0.333,1,2,0.5,0,0,,1,0,1,4,1,1,0,4,5,5.2,-8.0,Killian Hayes,1,4,0.25
6209,10/28/2022,21.254794520547946,L,0,18.6,1,6,0.167,0,1,0.0,0,0,,2,3,5,4,0,0,2,2,2,0.5,-10.0,Killian Hayes,1,5,0.2
6210,10/30/2022,21.26027397260274,W,0,17.883333333333333,2,7,0.286,0,1,0.0,0,0,,0,2,2,5,1,0,2,4,4,1.4,-1.0,Killian Hayes,2,6,0.3333333333333333
6211,10/31/2022,21.263013698630136,L,0,16.55,0,4,0.0,0,1,0.0,0,0,,0,4,4,3,0,0,1,2,0,-1.3,7.0,Killian Hayes,0,3,0.0
6212,11/2/2022,21.268493150684932,L,0,22.483333333333334,1,5,0.2,1,2,0.5,2,2,1.0,0,0,0,1,1,1,3,2,5,0.5,-3.0,Killian Hayes,0,3,0.0
6213,11/4/2022,21.273972602739725,L,0,18.233333333333334,1,3,0.333,0,1,0.0,0,0,,1,0,1,2,1,0,2,3,2,0.2,-17.0,Killian Hayes,1,2,0.5
6214,11/7/2022,21.28219178082192,W,0,17.466666666666665,2,5,0.4,0,0,,1,2,0.5,0,0,0,4,0,0,2,0,5,2.7,-11.0,Killian Hayes,2,5,0.4
6215,11/9/2022,21.28767123287671,L,0,22.383333333333333,7,12,0.583,1,2,0.5,1,1,1.0,1,1,2,1,1,0,0,3,16,11.9,-7.0,Killian Hayes,6,10,0.6
6216,11/11/2022,21.293150684931508,L,0,34.18333333333333,4,12,0.333,1,6,0.167,2,2,1.0,0,6,6,7,3,0,4,3,11,8.7,6.0,Killian Hayes,3,6,0.5
6217,11/12/2022,21.295890410958904,L,1,35.15,6,14,0.429,3,6,0.5,0,0,,2,4,6,7,0,0,3,2,15,11.3,-2.0,Killian Hayes,3,8,0.375
6218,11/14/2022,21.301369863013697,L,1,24.4,3,6,0.5,0,1,0.0,0,0,,1,2,3,2,3,1,1,1,6,8.0,-9.0,Killian Hayes,3,5,0.6
6219,11/17/2022,21.30958904109589,L,1,27.616666666666667,1,8,0.125,0,2,0.0,3,4,0.75,0,3,3,1,3,2,1,5,5,2.4,-17.0,Killian Hayes,1,6,0.16666666666666666
6220,11/18/2022,21.312328767123287,L,1,34.7,7,14,0.5,4,6,0.667,0,0,,0,2,2,9,1,1,0,6,18,17.2,-21.0,Killian Hayes,3,8,0.375
6221,11/20/2022,21.317808219178083,L,1,28.916666666666668,3,9,0.333,2,3,0.667,1,1,1.0,0,1,1,6,0,1,1,3,9,6.9,-10.0,Killian Hayes,1,6,0.16666666666666666
6222,11/22/2022,21.323287671232876,W,1,28.066666666666666,3,9,0.333,1,5,0.2,2,2,1.0,0,1,1,9,0,0,4,4,9,4.9,-6.0,Killian Hayes,2,4,0.5
6223,11/23/2022,21.326027397260273,W,1,16.566666666666666,1,5,0.2,0,0,,0,0,,0,3,3,3,0,0,1,2,2,0.1,2.0,Killian Hayes,1,5,0.2
6224,11/25/2022,21.33150684931507,L,1,37.766666666666666,7,18,0.389,1,4,0.25,2,2,1.0,2,6,8,9,3,0,3,5,17,14.7,-8.0,Killian Hayes,6,14,0.42857142857142855
6225,11/27/2022,21.336986301369862,L,1,32.63333333333333,7,13,0.538,2,5,0.4,0,0,,1,2,3,8,2,1,3,5,16,14.3,-4.0,Killian Hayes,5,8,0.625
6226,10/19/2022,24.21917808219178,W,0,14.466666666666667,1,3,0.333,0,1,0.0,0,0,,2,0,2,1,0,0,0,3,2,1.2,0.0,Hamidou Diallo,1,2,0.5
6227,10/21/2022,24.224657534246575,L,0,15.016666666666667,1,5,0.2,0,0,,2,7,0.286,0,2,2,0,1,0,0,1,4,0.1,-21.0,Hamidou Diallo,1,5,0.2
6228,10/22/2022,24.22739726027397,L,0,6.15,0,2,0.0,0,0,,0,0,,0,2,2,2,0,0,0,0,0,0.6,-8.0,Hamidou Diallo,0,2,0.0
6229,10/25/2022,24.235616438356164,L,0,17.433333333333334,3,5,0.6,0,0,,1,3,0.333,2,5,7,0,0,0,0,3,7,5.6,0.0,Hamidou Diallo,3,5,0.6
6230,10/26/2022,24.23835616438356,L,0,15.366666666666667,2,8,0.25,0,0,,0,0,,1,0,1,1,1,0,1,2,4,-0.2,6.0,Hamidou Diallo,2,8,0.25
6231,10/28/2022,24.243835616438357,L,0,14.566666666666666,3,4,0.75,0,1,0.0,2,2,1.0,1,4,5,3,0,0,1,1,8,9.0,-3.0,Hamidou Diallo,3,3,1.0
6232,10/30/2022,24.24931506849315,W,0,12.216666666666667,1,3,0.333,0,0,,2,2,1.0,1,1,2,1,2,0,2,2,4,3.2,-6.0,Hamidou Diallo,1,3,0.3333333333333333
6233,10/31/2022,24.252054794520546,L,0,20.133333333333333,4,9,0.444,0,1,0.0,5,6,0.833,2,3,5,0,1,0,0,3,13,10.0,6.0,Hamidou Diallo,4,8,0.5
6234,11/2/2022,24.257534246575343,L,0,11.383333333333333,2,4,0.5,0,0,,0,0,,0,2,2,0,0,0,1,5,4,-0.4,-8.0,Hamidou Diallo,2,4,0.5
6235,11/4/2022,24.263013698630136,L,0,3.7,0,3,0.0,0,1,0.0,0,0,,0,0,0,0,0,1,0,1,0,-1.8,-9.0,Hamidou Diallo,0,2,0.0
6236,11/7/2022,24.27123287671233,W,0,17.816666666666666,4,6,0.667,0,0,,3,4,0.75,5,3,8,0,1,0,2,2,11,10.6,-10.0,Hamidou Diallo,4,6,0.6666666666666666
6237,11/9/2022,24.276712328767122,L,0,14.45,2,8,0.25,0,1,0.0,0,0,,0,2,2,0,1,0,2,4,4,-2.8,-7.0,Hamidou Diallo,2,7,0.2857142857142857
6238,11/11/2022,24.28219178082192,L,0,15.3,4,5,0.8,0,0,,5,6,0.833,1,1,2,1,0,1,1,1,13,11.7,3.0,Hamidou Diallo,4,5,0.8
6239,11/12/2022,24.284931506849315,L,0,15.166666666666666,2,9,0.222,1,3,0.333,0,0,,1,1,2,1,0,0,0,2,5,0.4,-6.0,Hamidou Diallo,1,6,0.16666666666666666
6240,11/14/2022,24.29041095890411,L,0,16.616666666666667,2,3,0.667,0,0,,4,5,0.8,1,0,1,1,1,0,1,2,8,6.9,6.0,Hamidou Diallo,2,3,0.6666666666666666
6241,11/17/2022,24.2986301369863,L,0,16.383333333333333,2,4,0.5,0,1,0.0,1,2,0.5,0,3,3,2,0,2,0,3,5,5.1,3.0,Hamidou Diallo,2,3,0.6666666666666666
6242,11/18/2022,24.301369863013697,L,0,20.166666666666668,5,6,0.833,0,1,0.0,3,5,0.6,1,1,2,1,1,0,1,1,13,11.3,6.0,Hamidou Diallo,5,5,1.0
6243,11/20/2022,24.306849315068494,L,0,17.9,2,3,0.667,0,0,,0,0,,1,1,2,0,1,0,1,1,4,3.3,4.0,Hamidou Diallo,2,3,0.6666666666666666
6244,11/22/2022,24.312328767123287,W,0,15.566666666666666,3,5,0.6,0,1,0.0,0,0,,1,1,2,0,0,0,0,2,6,3.9,12.0,Hamidou Diallo,3,4,0.75
6245,11/23/2022,24.315068493150687,W,0,22.566666666666666,4,8,0.5,0,0,,1,1,1.0,1,4,5,2,2,0,1,4,9,7.7,5.0,Hamidou Diallo,4,8,0.5
6246,11/25/2022,24.32054794520548,L,0,21.783333333333335,4,6,0.667,0,0,,2,2,1.0,0,6,6,1,0,0,5,2,10,4.1,9.0,Hamidou Diallo,4,6,0.6666666666666666
6247,11/27/2022,24.326027397260273,L,0,19.383333333333333,1,3,0.333,1,2,0.5,1,4,0.25,0,3,3,1,1,0,1,4,4,1.1,-6.0,Hamidou Diallo,0,1,0.0
6248,10/19/2022,33.50410958904109,W,1,34.833333333333336,8,16,0.5,6,10,0.6,2,2,1.0,1,4,5,2,1,0,1,3,24,18.1,6.0,Bojan Bogdanović,2,6,0.3333333333333333
6249,10/21/2022,33.50958904109589,L,1,26.033333333333335,7,9,0.778,1,2,0.5,3,4,0.75,0,4,4,1,0,0,1,0,18,15.0,-6.0,Bojan Bogdanović,6,7,0.8571428571428571
6250,10/22/2022,33.512328767123286,L,1,32.483333333333334,5,16,0.313,4,10,0.4,2,2,1.0,1,2,3,5,0,0,0,1,16,11.2,-4.0,Bojan Bogdanović,1,6,0.16666666666666666
6251,10/25/2022,33.52054794520548,L,1,29.3,8,13,0.615,4,7,0.571,5,5,1.0,1,2,3,1,0,0,2,2,25,18.3,-11.0,Bojan Bogdanović,4,6,0.6666666666666666
6252,10/26/2022,33.52328767123288,L,1,33.68333333333333,12,21,0.571,6,12,0.5,3,4,0.75,0,2,2,3,0,0,2,5,33,21.4,-3.0,Bojan Bogdanović,6,9,0.6666666666666666
6253,10/28/2022,33.52876712328767,L,1,30.383333333333333,5,12,0.417,3,6,0.5,9,9,1.0,1,3,4,0,1,0,1,2,22,16.4,-21.0,Bojan Bogdanović,2,6,0.3333333333333333
6254,10/30/2022,33.534246575342465,W,1,34.8,5,8,0.625,3,6,0.5,8,8,1.0,0,3,3,3,0,0,1,1,21,19.0,4.0,Bojan Bogdanović,2,2,1.0
6255,10/31/2022,33.536986301369865,L,1,35.083333333333336,9,16,0.563,3,6,0.5,2,2,1.0,1,3,4,2,2,0,1,2,23,18.6,-5.0,Bojan Bogdanović,6,10,0.6
6256,11/2/2022,33.54246575342466,L,1,27.8,5,12,0.417,3,7,0.429,1,1,1.0,0,3,3,2,0,0,7,3,14,1.7,-24.0,Bojan Bogdanović,2,5,0.4
6257,11/4/2022,33.54794520547945,L,1,26.7,2,9,0.222,1,4,0.25,1,1,1.0,1,1,2,0,1,0,2,3,6,-0.7,-4.0,Bojan Bogdanović,1,5,0.2
6258,11/7/2022,33.556164383561644,W,1,30.066666666666666,3,11,0.273,2,7,0.286,4,4,1.0,0,2,2,0,0,0,0,0,12,6.1,15.0,Bojan Bogdanović,1,4,0.25
6259,11/9/2022,33.56164383561644,L,1,26.183333333333334,6,11,0.545,1,4,0.25,4,6,0.667,0,2,2,1,1,0,2,0,17,11.2,-19.0,Bojan Bogdanović,5,7,0.7142857142857143
6260,11/11/2022,33.56712328767123,L,1,34.28333333333333,9,15,0.6,0,5,0.0,7,7,1.0,0,5,5,3,0,0,2,3,25,18.5,-11.0,Bojan Bogdanović,9,10,0.9
6261,11/12/2022,33.56986301369863,L,1,32.983333333333334,9,15,0.6,3,7,0.429,7,8,0.875,0,6,6,4,0,0,4,3,28,20.1,-2.0,Bojan Bogdanović,6,8,0.75
6262,11/14/2022,33.57534246575342,L,1,32.916666666666664,5,12,0.417,2,8,0.25,6,10,0.6,0,5,5,5,0,0,5,2,18,9.2,-1.0,Bojan Bogdanović,3,4,0.75
6263,11/17/2022,33.583561643835615,L,1,34.88333333333333,10,18,0.556,2,4,0.5,4,5,0.8,0,3,3,3,2,0,2,2,26,19.2,4.0,Bojan Bogdanović,8,14,0.5714285714285714
6264,11/18/2022,33.586301369863016,L,1,35.083333333333336,7,15,0.467,0,2,0.0,6,7,0.857,2,4,6,5,0,0,2,1,20,15.6,-7.0,Bojan Bogdanović,7,13,0.5384615384615384
6265,11/20/2022,33.59178082191781,L,1,33.71666666666667,8,12,0.667,2,5,0.4,3,3,1.0,0,3,3,2,0,0,3,3,21,13.9,-23.0,Bojan Bogdanović,6,7,0.8571428571428571
6266,11/22/2022,33.5972602739726,W,1,35.333333333333336,8,17,0.471,1,5,0.2,5,6,0.833,2,7,9,4,0,0,3,1,22,15.8,-7.0,Bojan Bogdanović,7,12,0.5833333333333334
6267,11/23/2022,33.6,W,1,34.21666666666667,7,18,0.389,1,3,0.333,8,8,1.0,1,4,5,3,1,0,1,1,23,16.8,1.0,Bojan Bogdanović,6,15,0.4
6268,11/25/2022,33.605479452054794,L,1,33.21666666666667,9,21,0.429,1,4,0.25,0,0,,1,3,4,3,0,0,5,2,19,5.8,-6.0,Bojan Bogdanović,8,17,0.47058823529411764
6269,10/22/2022,24.235616438356164,L,0,15.933333333333334,3,6,0.5,2,3,0.667,0,0,,0,2,2,0,2,0,3,3,8,3.4,-12.0,Isaiah Livers,1,3,0.3333333333333333
6270,10/25/2022,24.243835616438357,L,0,20.466666666666665,1,6,0.167,0,5,0.0,3,3,1.0,1,2,3,1,0,0,1,3,5,1.0,-4.0,Isaiah Livers,1,1,1.0
6271,10/26/2022,24.246575342465754,L,0,23.733333333333334,4,7,0.571,4,6,0.667,0,0,,1,1,2,3,1,1,0,4,12,11.9,-1.0,Isaiah Livers,0,1,0.0
6272,10/28/2022,24.252054794520546,L,0,15.183333333333334,0,3,0.0,0,3,0.0,0,0,,2,0,2,0,0,0,0,2,0,-1.5,-5.0,Isaiah Livers,0,0,
6273,10/30/2022,24.257534246575343,W,0,16.916666666666668,2,4,0.5,2,4,0.5,0,0,,1,2,3,0,0,0,0,3,6,4.1,11.0,Isaiah Livers,0,0,
6274,10/31/2022,24.26027397260274,L,0,16.716666666666665,1,2,0.5,1,2,0.5,0,0,,0,1,1,0,0,0,0,1,3,1.9,12.0,Isaiah Livers,0,0,
6275,11/2/2022,24.265753424657536,L,0,16.7,1,4,0.25,1,4,0.25,0,0,,0,3,3,1,0,0,1,1,3,0.8,-8.0,Isaiah Livers,0,0,
6276,11/4/2022,24.27123287671233,L,0,21.3,3,7,0.429,3,5,0.6,2,2,1.0,0,1,1,0,0,1,0,1,11,7.9,-20.0,Isaiah Livers,0,2,0.0
6277,11/7/2022,24.279452054794522,W,0,20.666666666666668,2,6,0.333,1,3,0.333,0,0,,0,5,5,0,1,0,0,1,5,3.7,-14.0,Isaiah Livers,1,3,0.3333333333333333
6278,11/9/2022,24.284931506849315,L,0,18.433333333333334,1,3,0.333,1,3,0.333,0,2,0.0,0,2,2,0,0,1,1,2,3,0.0,-7.0,Isaiah Livers,0,0,
6279,11/11/2022,24.29041095890411,L,0,22.1,3,6,0.5,3,6,0.5,2,2,1.0,2,2,4,1,0,2,0,2,11,11.3,-5.0,Isaiah Livers,0,0,
6280,11/12/2022,24.293150684931508,L,0,18.35,1,5,0.2,0,3,0.0,1,2,0.5,2,3,5,0,0,1,1,3,3,0.3,-7.0,Isaiah Livers,1,2,0.5
6281,11/14/2022,24.2986301369863,L,0,23.433333333333334,1,5,0.2,1,5,0.2,4,5,0.8,1,2,3,2,0,0,0,0,7,6.2,2.0,Isaiah Livers,0,0,
6282,11/17/2022,24.306849315068494,L,0,16.95,2,5,0.4,0,3,0.0,1,1,1.0,0,1,1,0,1,0,0,1,5,3.2,-14.0,Isaiah Livers,2,2,1.0
6283,11/18/2022,24.30958904109589,L,0,15.8,1,4,0.25,1,3,0.333,0,0,,1,1,2,1,2,0,2,4,3,0.7,-4.0,Isaiah Livers,0,1,0.0
6284,11/20/2022,24.315068493150687,L,1,16.3,2,4,0.5,1,3,0.333,0,0,,0,2,2,1,0,0,1,1,5,2.9,3.0,Isaiah Livers,1,1,1.0
6285,11/22/2022,24.32054794520548,W,1,24.35,2,3,0.667,1,2,0.5,0,0,,0,2,2,0,0,3,0,1,5,6.0,-9.0,Isaiah Livers,1,1,1.0
6286,11/23/2022,24.323287671232876,W,1,19.5,3,5,0.6,1,3,0.333,0,0,,0,1,1,1,0,0,1,1,7,4.3,1.0,Isaiah Livers,2,2,1.0
6287,11/25/2022,24.328767123287673,L,1,30.133333333333333,3,7,0.429,1,4,0.25,0,0,,0,1,1,1,1,0,0,2,7,4.5,-15.0,Isaiah Livers,2,3,0.6666666666666666
6288,11/27/2022,24.334246575342465,L,1,27.25,2,5,0.4,1,4,0.25,2,3,0.667,0,2,2,0,1,3,1,5,7,4.6,-7.0,Isaiah Livers,1,1,1.0
6289,10/19/2022,20.67945205479452,W,1,31.733333333333334,8,15,0.533,2,4,0.5,1,1,1.0,1,2,3,4,3,0,2,3,19,15.6,-4.0,Jaden Ivey,6,11,0.5454545454545454
6290,10/21/2022,20.684931506849313,L,1,29.066666666666666,6,12,0.5,1,4,0.25,4,4,1.0,1,1,2,9,0,0,4,4,17,12.7,-5.0,Jaden Ivey,5,8,0.625
6291,10/22/2022,20.687671232876713,L,1,34.46666666666667,6,13,0.462,2,3,0.667,3,6,0.5,2,8,10,5,1,0,5,3,17,11.2,-4.0,Jaden Ivey,4,10,0.4
6292,10/25/2022,20.695890410958903,L,1,28.833333333333332,4,10,0.4,1,3,0.333,2,4,0.5,0,2,2,4,2,0,0,5,11,8.2,-18.0,Jaden Ivey,3,7,0.42857142857142855
6293,10/28/2022,20.704109589041096,L,1,23.383333333333333,4,11,0.364,2,6,0.333,2,2,1.0,1,1,2,0,0,0,0,2,12,6.1,-12.0,Jaden Ivey,2,5,0.4
6294,10/30/2022,20.70958904109589,W,1,31.483333333333334,5,11,0.455,2,5,0.4,3,5,0.6,1,3,4,3,1,1,2,4,15,10.3,16.0,Jaden Ivey,3,6,0.5
6295,10/31/2022,20.71232876712329,L,1,40.266666666666666,8,17,0.471,0,4,0.0,3,4,0.75,2,5,7,1,2,0,3,3,19,11.3,-9.0,Jaden Ivey,8,13,0.6153846153846154
6296,11/2/2022,20.71780821917808,L,1,30.25,3,11,0.273,1,4,0.25,0,0,,0,2,2,1,4,0,2,0,7,3.8,-13.0,Jaden Ivey,2,7,0.2857142857142857
6297,11/4/2022,20.723287671232878,L,1,34.18333333333333,6,13,0.462,1,5,0.2,5,6,0.833,1,5,6,3,0,1,4,4,18,10.3,-21.0,Jaden Ivey,5,8,0.625
6298,11/7/2022,20.731506849315068,W,1,33.85,6,15,0.4,2,7,0.286,1,1,1.0,3,8,11,6,2,3,2,2,15,16.9,13.0,Jaden Ivey,4,8,0.5
6299,11/9/2022,20.736986301369864,L,1,31.383333333333333,6,12,0.5,2,5,0.4,5,7,0.714,3,7,10,6,1,0,0,0,19,21.6,-19.0,Jaden Ivey,4,7,0.5714285714285714
6300,11/11/2022,20.742465753424657,L,1,25.033333333333335,4,11,0.364,0,1,0.0,2,5,0.4,1,2,3,4,2,0,4,1,10,4.4,-17.0,Jaden Ivey,4,10,0.4
6301,11/12/2022,20.745205479452054,L,1,34.166666666666664,8,15,0.533,4,6,0.667,6,6,1.0,2,2,4,3,0,0,4,4,26,17.2,-4.0,Jaden Ivey,4,9,0.4444444444444444
6302,11/14/2022,20.75068493150685,L,1,34.266666666666666,6,16,0.375,1,5,0.2,8,10,0.8,0,4,4,8,1,0,4,6,21,12.8,3.0,Jaden Ivey,5,11,0.45454545454545453
6303,11/17/2022,20.75890410958904,L,1,37.766666666666666,8,21,0.381,1,7,0.143,1,2,0.5,1,3,4,5,0,0,4,5,18,5.2,-3.0,Jaden Ivey,7,14,0.5
6304,11/18/2022,20.76164383561644,L,1,33.53333333333333,5,18,0.278,1,9,0.111,6,8,0.75,1,3,4,5,0,1,1,2,17,9.6,-7.0,Jaden Ivey,4,9,0.4444444444444444
6305,11/20/2022,20.767123287671232,L,1,32.166666666666664,8,14,0.571,4,4,1.0,4,6,0.667,1,3,4,3,0,0,3,5,24,15.3,-14.0,Jaden Ivey,4,10,0.4
6306,11/22/2022,20.77260273972603,W,1,25.583333333333332,3,11,0.273,1,4,0.25,0,0,,1,5,6,5,1,0,4,2,7,2.4,-10.0,Jaden Ivey,2,7,0.2857142857142857
6307,11/23/2022,20.775342465753425,W,1,32.05,5,13,0.385,0,2,0.0,6,7,0.857,1,4,5,6,1,0,1,1,16,14.2,0.0,Jaden Ivey,5,11,0.45454545454545453
6308,10/19/2022,18.91780821917808,W,0,21.716666666666665,7,13,0.538,0,0,,0,4,0.0,5,5,10,1,0,3,3,0,14,10.9,7.0,Jalen Duren,7,13,0.5384615384615384
6309,10/21/2022,18.923287671232877,L,0,22.65,4,8,0.5,0,1,0.0,0,1,0.0,3,7,10,0,1,0,1,4,8,6.2,-12.0,Jalen Duren,4,7,0.5714285714285714
6310,10/22/2022,18.926027397260274,L,0,18.45,3,3,1.0,0,0,,0,0,,2,1,3,0,0,2,0,0,6,8.2,-8.0,Jalen Duren,3,3,1.0
6311,10/25/2022,18.934246575342467,L,0,23.05,3,6,0.5,0,0,,0,1,0.0,4,4,8,0,0,0,0,2,6,5.8,-9.0,Jalen Duren,3,6,0.5
6312,10/26/2022,18.936986301369863,L,0,20.916666666666668,3,4,0.75,0,0,,1,2,0.5,3,6,9,0,0,1,1,2,7,7.8,-2.0,Jalen Duren,3,4,0.75
6313,10/28/2022,18.942465753424656,L,0,23.266666666666666,2,4,0.5,0,0,,4,6,0.667,2,1,3,0,0,2,3,4,8,3.7,-19.0,Jalen Duren,2,4,0.5
6314,10/30/2022,18.947945205479453,W,0,15.066666666666666,1,3,0.333,0,0,,1,2,0.5,3,1,4,0,0,1,1,2,3,2.2,2.0,Jalen Duren,1,3,0.3333333333333333
6315,11/7/2022,18.96986301369863,W,0,21.4,2,5,0.4,0,0,,3,6,0.5,2,2,4,0,0,3,1,3,7,5.0,-11.0,Jalen Duren,2,5,0.4
6316,11/9/2022,18.975342465753425,L,0,29.716666666666665,5,8,0.625,0,0,,0,0,,5,5,10,2,1,1,0,1,10,14.1,-10.0,Jalen Duren,5,8,0.625
6317,11/11/2022,18.980821917808218,L,0,21.166666666666668,0,1,0.0,0,0,,1,4,0.25,2,6,8,0,0,1,1,1,1,1.6,-3.0,Jalen Duren,0,1,0.0
6318,11/12/2022,18.983561643835618,L,0,17.183333333333334,1,1,1.0,0,0,,0,0,,1,11,12,1,2,0,1,2,2,6.6,-9.0,Jalen Duren,1,1,1.0
6319,11/14/2022,18.98904109589041,L,0,19.1,1,1,1.0,0,0,,0,2,0.0,2,4,6,0,0,0,1,3,2,1.3,0.0,Jalen Duren,1,1,1.0
6320,11/17/2022,18.997260273972604,L,0,25.116666666666667,3,6,0.5,0,0,,2,3,0.667,4,5,9,0,0,1,1,3,8,7.4,5.0,Jalen Duren,3,6,0.5
6321,11/18/2022,19.0,L,0,21.783333333333335,5,7,0.714,0,0,,2,2,1.0,3,5,8,0,1,1,1,4,12,11.8,-6.0,Jalen Duren,5,7,0.7142857142857143
6322,11/20/2022,19.005479452054793,L,0,27.066666666666666,6,8,0.75,0,0,,0,0,,5,3,8,1,1,0,1,2,12,13.1,-7.0,Jalen Duren,6,8,0.75
6323,11/22/2022,19.01095890410959,W,0,25.833333333333332,2,3,0.667,0,0,,0,0,,4,3,7,2,1,0,0,4,4,7.2,14.0,Jalen Duren,2,3,0.6666666666666666
6324,11/23/2022,19.013698630136986,W,0,27.183333333333334,2,4,0.5,0,0,,0,0,,2,5,7,0,2,2,1,3,4,6.1,6.0,Jalen Duren,2,4,0.5
6325,11/25/2022,19.019178082191782,L,0,14.416666666666666,0,1,0.0,0,0,,4,4,1.0,3,2,5,2,0,0,1,3,4,5.2,6.0,Jalen Duren,0,1,0.0
6326,11/27/2022,19.024657534246575,L,0,20.266666666666666,0,3,0.0,0,0,,1,2,0.5,2,4,6,1,0,0,0,2,1,1.0,-10.0,Jalen Duren,0,3,0.0
6327,10/19/2022,23.528767123287672,W,1,31.383333333333333,2,5,0.4,0,2,0.0,4,4,1.0,3,3,6,3,1,0,1,2,8,9.6,6.0,Saddiq Bey,2,3,0.6666666666666666
6328,10/21/2022,23.534246575342465,L,1,32.983333333333334,9,15,0.6,4,8,0.5,4,4,1.0,1,6,7,0,1,1,2,1,26,20.9,-3.0,Saddiq Bey,5,7,0.7142857142857143
6329,10/22/2022,23.536986301369865,L,1,36.38333333333333,5,16,0.313,2,8,0.25,8,8,1.0,4,7,11,3,1,0,1,1,20,17.4,5.0,Saddiq Bey,3,8,0.375
6330,10/25/2022,23.545205479452054,L,1,27.05,2,5,0.4,1,3,0.333,1,1,1.0,2,0,2,1,0,1,1,2,6,4.3,-24.0,Saddiq Bey,1,2,0.5
6331,10/26/2022,23.54794520547945,L,1,29.916666666666668,6,11,0.545,2,4,0.5,3,6,0.5,1,3,4,0,0,0,2,0,17,10.1,-11.0,Saddiq Bey,4,7,0.5714285714285714
6332,10/28/2022,23.553424657534247,L,1,29.883333333333333,2,8,0.25,0,4,0.0,3,4,0.75,0,4,4,0,0,0,1,2,7,1.2,-21.0,Saddiq Bey,2,4,0.5
6333,10/30/2022,23.55890410958904,W,1,34.53333333333333,9,17,0.529,4,9,0.444,6,6,1.0,0,6,6,3,0,0,3,2,28,19.8,20.0,Saddiq Bey,5,8,0.625
6334,10/31/2022,23.561643835616437,L,1,26.85,4,9,0.444,1,4,0.25,1,1,1.0,0,1,1,2,2,0,0,5,10,7.0,-12.0,Saddiq Bey,3,5,0.6
6335,11/2/2022,23.567123287671233,L,1,35.11666666666667,5,12,0.417,3,7,0.429,9,10,0.9,0,3,3,1,1,1,3,2,22,14.7,-22.0,Saddiq Bey,2,5,0.4
6336,11/4/2022,23.572602739726026,L,1,32.3,6,13,0.462,3,7,0.429,3,3,1.0,0,4,4,2,3,0,2,0,18,14.9,-13.0,Saddiq Bey,3,6,0.5
6337,11/7/2022,23.58082191780822,W,1,36.61666666666667,8,17,0.471,1,7,0.143,8,8,1.0,1,4,5,2,0,0,1,2,25,17.8,29.0,Saddiq Bey,7,10,0.7
6338,11/9/2022,23.586301369863016,L,1,32.8,4,12,0.333,1,6,0.167,9,10,0.9,1,3,4,0,1,0,1,2,18,11.6,-20.0,Saddiq Bey,3,6,0.5
6339,11/11/2022,23.59178082191781,L,1,27.183333333333334,4,10,0.4,0,3,0.0,3,3,1.0,2,3,5,1,1,0,1,1,11,8.2,-8.0,Saddiq Bey,4,7,0.5714285714285714
6340,11/12/2022,23.594520547945205,L,1,30.483333333333334,3,13,0.231,2,6,0.333,2,2,1.0,0,2,2,2,1,0,0,3,10,3.9,-3.0,Saddiq Bey,1,7,0.14285714285714285
6341,11/14/2022,23.6,L,0,30.8,3,10,0.3,1,5,0.2,2,2,1.0,2,4,6,3,1,0,2,1,9,6.5,-10.0,Saddiq Bey,2,5,0.4
6342,11/17/2022,23.60821917808219,L,1,31.616666666666667,4,11,0.364,2,8,0.25,1,1,1.0,2,6,8,2,1,0,1,2,11,8.7,-8.0,Saddiq Bey,2,3,0.6666666666666666
6343,11/18/2022,23.610958904109587,L,1,21.366666666666667,2,7,0.286,0,2,0.0,0,0,,1,2,3,2,0,0,2,2,4,-0.2,-3.0,Saddiq Bey,2,5,0.4
6344,11/27/2022,23.635616438356166,L,1,34.96666666666667,6,15,0.4,1,5,0.2,2,3,0.667,0,5,5,0,2,1,2,1,15,8.3,-3.0,Saddiq Bey,5,10,0.5
6345,10/19/2022,31.164383561643834,W,0,15.116666666666667,3,3,1.0,2,2,1.0,0,0,,0,1,1,2,0,0,0,3,8,7.6,-1.0,Cory Joseph,1,1,1.0
6346,10/21/2022,31.16986301369863,L,0,12.3,0,1,0.0,0,0,,0,0,,1,1,2,3,0,0,1,1,0,1.0,-26.0,Cory Joseph,0,1,0.0
6347,10/22/2022,31.172602739726027,L,0,16.05,3,6,0.5,2,3,0.667,2,2,1.0,0,1,1,3,0,0,0,2,10,8.6,-5.0,Cory Joseph,1,3,0.3333333333333333
6348,10/25/2022,31.18082191780822,L,0,14.333333333333334,2,5,0.4,1,2,0.5,0,0,,0,1,1,1,2,0,2,0,5,3.3,0.0,Cory Joseph,1,3,0.3333333333333333
6349,10/26/2022,31.183561643835617,L,1,31.633333333333333,0,3,0.0,0,1,0.0,2,2,1.0,0,3,3,6,0,0,0,4,2,3.4,2.0,Cory Joseph,0,2,0.0
6350,10/28/2022,31.18904109589041,L,0,16.083333333333332,0,3,0.0,0,2,0.0,1,2,0.5,0,0,0,2,0,1,1,0,1,-0.4,-5.0,Cory Joseph,0,1,0.0
6351,10/30/2022,31.194520547945206,W,0,4.933333333333334,0,0,,0,0,,0,0,,0,0,0,0,0,0,0,0,0,0.0,-4.0,Cory Joseph,0,0,
6352,11/2/2022,31.202739726027396,L,0,10.45,1,2,0.5,0,1,0.0,0,0,,1,1,2,6,0,0,0,2,2,5.4,-6.0,Cory Joseph,1,1,1.0
6353,11/4/2022,31.208219178082192,L,0,6.083333333333333,1,3,0.333,1,3,0.333,0,0,,0,1,1,1,0,0,1,1,3,0.9,-1.0,Cory Joseph,0,0,
6354,11/9/2022,31.221917808219178,L,0,5.6,1,2,0.5,0,1,0.0,2,2,1.0,0,0,0,2,1,0,0,0,4,5.4,8.0,Cory Joseph,1,1,1.0
6355,11/11/2022,31.22739726027397,L,1,5.916666666666667,0,1,0.0,0,1,0.0,0,0,,0,0,0,1,0,0,0,4,0,-1.6,-5.0,Cory Joseph,0,0,
6356,11/12/2022,31.23013698630137,L,0,10.683333333333334,2,4,0.5,1,2,0.5,2,3,0.667,0,0,0,2,0,0,0,1,7,5.6,-5.0,Cory Joseph,1,2,0.5
6357,11/20/2022,31.252054794520546,L,0,15.833333333333334,5,10,0.5,2,3,0.667,0,0,,1,0,1,5,0,0,0,1,12,10.8,6.0,Cory Joseph,3,7,0.42857142857142855
6358,11/22/2022,31.257534246575343,W,0,17.883333333333333,2,8,0.25,1,2,0.5,0,0,,1,1,2,4,1,0,0,3,5,3.8,8.0,Cory Joseph,1,6,0.16666666666666666
6359,11/23/2022,31.26027397260274,W,0,22.533333333333335,3,8,0.375,0,2,0.0,0,0,,0,0,0,6,0,0,0,1,6,5.4,5.0,Cory Joseph,3,6,0.5
6360,11/27/2022,31.27123287671233,L,0,16.8,5,8,0.625,0,1,0.0,0,3,0.0,0,0,0,1,0,0,1,0,10,4.9,-9.0,Cory Joseph,5,7,0.7142857142857143
6361,10/19/2022,21.410958904109588,W,1,26.3,3,6,0.5,1,4,0.25,7,8,0.875,0,5,5,3,2,0,0,2,14,15.4,-1.0,Isaiah Stewart,2,2,1.0
6362,10/21/2022,21.416438356164385,L,1,30.333333333333332,3,9,0.333,1,6,0.167,1,4,0.25,2,8,10,1,1,1,1,3,8,5.7,-7.0,Isaiah Stewart,2,3,0.6666666666666666
6363,10/22/2022,21.41917808219178,L,1,29.55,2,10,0.2,1,4,0.25,6,10,0.6,6,11,17,2,0,0,2,5,11,8.1,-1.0,Isaiah Stewart,1,6,0.16666666666666666
6364,10/25/2022,21.427397260273974,L,1,27.25,5,11,0.455,1,4,0.25,2,2,1.0,1,9,10,1,0,0,0,2,13,10.6,-13.0,Isaiah Stewart,4,7,0.5714285714285714
6365,10/26/2022,21.43013698630137,L,1,27.083333333333332,2,6,0.333,0,4,0.0,3,4,0.75,3,6,9,0,0,1,0,0,7,7.8,-3.0,Isaiah Stewart,2,2,1.0
6366,10/28/2022,21.435616438356163,L,1,29.4,6,11,0.545,2,5,0.4,3,5,0.6,4,4,8,1,0,1,0,2,17,15.5,-11.0,Isaiah Stewart,4,6,0.6666666666666666
6367,10/30/2022,21.44109589041096,W,1,32.93333333333333,6,10,0.6,2,5,0.4,10,11,0.909,5,8,13,0,0,0,0,3,24,23.7,12.0,Isaiah Stewart,4,5,0.8
6368,10/31/2022,21.443835616438356,L,1,29.5,4,9,0.444,0,2,0.0,3,4,0.75,5,6,11,2,0,1,2,5,11,9.3,-3.0,Isaiah Stewart,4,7,0.5714285714285714
6369,11/2/2022,21.44931506849315,L,1,32.5,6,9,0.667,2,3,0.667,2,2,1.0,1,9,10,1,0,1,2,1,16,14.5,-21.0,Isaiah Stewart,4,6,0.6666666666666666
6370,11/4/2022,21.454794520547946,L,1,23.666666666666668,3,5,0.6,0,1,0.0,0,0,,3,1,4,1,2,1,2,4,6,5.9,-16.0,Isaiah Stewart,3,4,0.75
6371,11/7/2022,21.463013698630135,W,1,26.45,4,7,0.571,1,2,0.5,2,4,0.5,4,8,12,1,2,2,1,5,11,13.2,22.0,Isaiah Stewart,3,5,0.6
6372,11/9/2022,21.46849315068493,L,1,20.483333333333334,3,6,0.5,1,4,0.25,5,6,0.833,3,7,10,1,0,0,1,4,12,10.9,-2.0,Isaiah Stewart,2,2,1.0
6373,11/11/2022,21.473972602739725,L,1,29.483333333333334,4,7,0.571,2,4,0.5,3,4,0.75,4,4,8,3,0,2,2,4,13,13.2,-5.0,Isaiah Stewart,2,3,0.6666666666666666
6374,11/12/2022,21.476712328767125,L,1,27.7,3,8,0.375,2,4,0.5,0,0,,1,8,9,2,1,0,1,3,8,6.9,2.0,Isaiah Stewart,1,4,0.25
6375,11/14/2022,21.482191780821918,L,1,12.666666666666666,3,6,0.5,2,2,1.0,1,1,1.0,1,3,4,0,0,1,2,2,9,5.5,3.0,Isaiah Stewart,1,4,0.25
6376,10/19/2022,23.18904109589041,W,0,13.166666666666666,1,8,0.125,1,6,0.167,0,0,,0,3,3,0,0,0,2,2,3,-4.1,-2.0,Kevin Knox,0,2,0.0
6377,10/21/2022,23.194520547945206,L,0,11.366666666666667,1,6,0.167,0,3,0.0,0,0,,1,1,2,0,0,0,0,0,2,-0.8,-22.0,Kevin Knox,1,3,0.3333333333333333
6378,10/25/2022,23.205479452054796,L,0,3.3166666666666664,1,2,0.5,0,1,0.0,0,0,,0,0,0,0,1,0,0,3,2,0.8,-5.0,Kevin Knox,1,1,1.0
6379,10/26/2022,23.208219178082192,L,0,5.433333333333334,0,0,,0,0,,0,0,,0,1,1,0,0,0,0,2,0,-0.5,3.0,Kevin Knox,0,0,
6380,10/28/2022,23.213698630136985,L,0,3.05,0,1,0.0,0,1,0.0,0,0,,0,0,0,0,0,0,0,0,0,-0.7,0.0,Kevin Knox,0,0,
6381,11/2/2022,23.22739726027397,L,0,5.066666666666666,2,3,0.667,0,1,0.0,0,0,,0,0,0,0,0,0,0,0,4,2.7,3.0,Kevin Knox,2,2,1.0
6382,11/4/2022,23.232876712328768,L,0,17.616666666666667,1,3,0.333,1,3,0.333,0,0,,1,1,2,1,0,1,1,2,3,1.9,0.0,Kevin Knox,0,0,
6383,11/9/2022,23.246575342465754,L,0,5.6,0,1,0.0,0,1,0.0,0,0,,0,0,0,0,0,0,1,1,0,-2.1,8.0,Kevin Knox,0,0,
6384,11/17/2022,23.268493150684932,L,0,8.916666666666666,1,4,0.25,1,3,0.333,0,0,,1,1,2,0,1,2,0,1,3,3.6,6.0,Kevin Knox,0,1,0.0
6385,11/18/2022,23.27123287671233,L,0,4.816666666666666,0,1,0.0,0,1,0.0,0,0,,0,1,1,1,0,0,1,0,0,-0.7,2.0,Kevin Knox,0,0,
6386,11/20/2022,23.276712328767122,L,0,22.6,4,7,0.571,3,5,0.6,0,0,,0,5,5,1,0,0,0,1,11,9.5,13.0,Kevin Knox,1,2,0.5
6387,11/22/2022,23.28219178082192,W,0,24.6,8,11,0.727,1,4,0.25,0,0,,1,7,8,1,1,0,1,3,17,14.8,12.0,Kevin Knox,7,7,1.0
6388,11/23/2022,23.284931506849315,W,0,25.783333333333335,6,8,0.75,6,8,0.75,3,4,0.75,0,3,3,0,0,0,1,2,21,16.5,9.0,Kevin Knox,0,0,
6389,11/25/2022,23.29041095890411,L,0,29.316666666666666,3,7,0.429,1,3,0.333,0,0,,2,2,4,1,1,2,0,2,7,7.6,5.0,Kevin Knox,2,4,0.5
6390,11/27/2022,23.295890410958904,L,0,17.366666666666667,1,3,0.333,1,2,0.5,0,0,,1,1,2,0,0,0,1,2,3,0.5,-9.0,Kevin Knox,0,1,0.0
6391,10/19/2022,21.065753424657533,W,1,35.1,6,16,0.375,2,6,0.333,4,4,1.0,0,1,1,10,1,0,3,2,18,13.7,3.0,Cade Cunningham,4,10,0.4
6392,10/21/2022,21.07123287671233,L,1,32.45,6,16,0.375,1,6,0.167,2,4,0.5,4,4,8,7,2,0,4,3,15,11.1,0.0,Cade Cunningham,5,10,0.5
6393,10/22/2022,21.073972602739726,L,1,33.05,8,19,0.421,4,8,0.5,2,2,1.0,2,2,4,4,1,0,2,3,22,14.5,4.0,Cade Cunningham,4,11,0.36363636363636365
6394,10/25/2022,21.08219178082192,L,1,32.016666666666666,7,19,0.368,0,2,0.0,5,6,0.833,0,3,3,3,1,0,3,3,19,7.9,-18.0,Cade Cunningham,7,17,0.4117647058823529
6395,10/26/2022,21.084931506849315,L,1,36.53333333333333,11,25,0.44,1,3,0.333,3,4,0.75,0,8,8,6,1,2,7,2,26,13.7,-8.0,Cade Cunningham,10,22,0.45454545454545453
6396,10/28/2022,21.09041095890411,L,1,33.13333333333333,14,23,0.609,0,3,0.0,7,8,0.875,1,8,9,8,1,0,1,5,35,30.8,-13.0,Cade Cunningham,14,20,0.7
6397,10/30/2022,21.095890410958905,W,1,39.233333333333334,9,20,0.45,1,3,0.333,4,4,1.0,1,9,10,9,0,1,4,4,23,17.4,16.0,Cade Cunningham,8,17,0.47058823529411764
6398,10/31/2022,21.0986301369863,L,1,36.4,11,23,0.478,3,9,0.333,2,2,1.0,1,5,6,7,1,1,5,2,27,18.3,-7.0,Cade Cunningham,8,14,0.5714285714285714
6399,11/2/2022,21.104109589041094,L,1,31.233333333333334,5,13,0.385,0,2,0.0,0,0,,0,6,6,4,1,0,2,3,10,5.3,-24.0,Cade Cunningham,5,11,0.45454545454545453
6400,11/4/2022,21.10958904109589,L,1,31.416666666666668,7,18,0.389,3,6,0.5,2,3,0.667,1,4,5,5,1,1,1,1,19,14.5,-8.0,Cade Cunningham,4,12,0.3333333333333333
6401,11/7/2022,21.117808219178084,W,1,35.63333333333333,8,21,0.381,2,7,0.286,3,4,0.75,1,10,11,7,0,1,5,4,21,11.8,12.0,Cade Cunningham,6,14,0.42857142857142855
6402,11/9/2022,21.123287671232877,L,1,23.966666666666665,1,11,0.091,0,6,0.0,2,2,1.0,1,2,3,2,0,1,2,2,4,-2.7,-17.0,Cade Cunningham,1,5,0.2
6403,11/11/2022,31.312328767123287,L,0,25.333333333333332,5,12,0.417,1,5,0.2,6,8,0.75,0,2,2,1,0,0,0,3,17,9.9,0.0,Alec Burks,4,7,0.5714285714285714
6404,11/14/2022,31.32054794520548,L,0,16.9,5,7,0.714,2,3,0.667,3,5,0.6,0,2,2,2,1,0,1,3,15,12.1,-10.0,Alec Burks,3,4,0.75
6405,11/17/2022,31.328767123287673,L,0,18.233333333333334,1,6,0.167,0,2,0.0,4,4,1.0,0,2,2,2,1,0,1,1,6,3.8,10.0,Alec Burks,1,4,0.25
6406,11/18/2022,31.33150684931507,L,0,24.2,6,10,0.6,5,8,0.625,6,8,0.75,1,2,3,3,1,0,1,4,23,19.4,8.0,Alec Burks,1,2,0.5
6407,11/20/2022,31.336986301369862,L,0,24.566666666666666,4,13,0.308,1,5,0.2,7,8,0.875,0,3,3,1,1,1,1,2,16,9.6,-11.0,Alec Burks,3,8,0.375
6408,11/22/2022,31.34246575342466,W,0,20.583333333333332,7,13,0.538,2,5,0.4,5,6,0.833,0,0,0,2,3,0,3,2,21,14.9,8.0,Alec Burks,5,8,0.625
6409,11/23/2022,31.345205479452055,W,0,18.783333333333335,4,10,0.4,4,6,0.667,6,6,1.0,1,2,3,1,1,0,0,4,18,14.0,13.0,Alec Burks,0,4,0.0
6410,11/25/2022,31.350684931506848,L,0,17.633333333333333,4,12,0.333,2,4,0.5,7,8,0.875,0,2,2,1,0,0,3,3,17,6.9,6.0,Alec Burks,2,8,0.25
6411,11/27/2022,31.356164383561644,L,0,25.25,7,13,0.538,1,4,0.25,2,3,0.667,1,1,2,0,0,0,0,3,17,10.1,-8.0,Alec Burks,6,9,0.6666666666666666
6412,11/12/2022,23.665753424657535,L,0,18.133333333333333,2,5,0.4,0,1,0.0,0,0,,2,2,4,1,0,2,0,0,4,5.4,-9.0,Marvin Bagley III,2,4,0.5
6413,11/14/2022,23.671232876712327,L,1,28.9,6,11,0.545,1,2,0.5,3,3,1.0,3,2,5,0,1,0,2,3,16,11.2,-4.0,Marvin Bagley III,5,9,0.5555555555555556
6414,11/17/2022,23.67945205479452,L,1,22.516666666666666,1,5,0.2,0,1,0.0,2,2,1.0,2,6,8,0,0,0,2,3,4,0.9,-11.0,Marvin Bagley III,1,4,0.25
6415,11/18/2022,23.682191780821917,L,1,22.683333333333334,5,10,0.5,0,2,0.0,1,2,0.5,0,3,3,0,1,0,0,3,11,6.3,-9.0,Marvin Bagley III,5,8,0.625
6416,11/20/2022,23.687671232876713,L,1,20.933333333333334,5,9,0.556,0,1,0.0,5,5,1.0,2,4,6,0,1,1,1,5,15,12.0,-1.0,Marvin Bagley III,5,8,0.625
6417,11/22/2022,23.693150684931506,W,1,22.2,7,8,0.875,0,0,,0,0,,2,1,3,0,0,2,1,2,14,12.5,-12.0,Marvin Bagley III,7,8,0.875
6418,11/23/2022,23.695890410958903,W,1,20.816666666666666,9,10,0.9,0,0,,1,1,1.0,2,4,6,2,2,0,0,1,19,21.2,3.0,Marvin Bagley III,9,10,0.9
6419,11/25/2022,23.7013698630137,L,1,31.316666666666666,6,12,0.5,1,1,1.0,0,0,,7,5,12,1,1,1,1,2,13,14.0,-9.0,Marvin Bagley III,5,11,0.45454545454545453
6420,11/27/2022,23.706849315068492,L,1,27.733333333333334,6,12,0.5,1,2,0.5,6,8,0.75,1,9,10,0,3,1,3,3,19,15.1,2.0,Marvin Bagley III,5,10,0.5
6421,10/21/2022,31.23013698630137,L,0,4.65,1,3,0.333,1,3,0.333,0,0,,0,1,1,0,0,0,0,0,3,1.6,-3.0,Rodney McGruder,0,0,
6422,10/28/2022,31.24931506849315,L,0,3.05,0,0,,0,0,,0,0,,0,0,0,0,0,0,0,0,0,0.0,0.0,Rodney McGruder,0,0,
6423,11/2/2022,31.263013698630136,L,0,1.5,0,0,,0,0,,0,0,,0,0,0,0,0,0,0,1,0,-0.4,5.0,Rodney McGruder,0,0,
6424,11/4/2022,31.268493150684932,L,0,6.083333333333333,0,3,0.0,0,1,0.0,0,0,,1,1,2,1,0,0,0,0,0,-0.4,-1.0,Rodney McGruder,0,2,0.0
6425,11/9/2022,31.28219178082192,L,0,5.6,0,1,0.0,0,0,,2,2,1.0,1,0,1,0,0,0,0,0,2,2.0,8.0,Rodney McGruder,0,1,0.0
6426,11/25/2022,31.326027397260273,L,1,19.95,3,7,0.429,2,6,0.333,0,0,,3,3,6,2,0,0,0,0,8,8.7,-12.0,Rodney McGruder,1,1,1.0
6427,11/27/2022,31.33150684931507,L,1,18.35,1,4,0.25,0,3,0.0,0,0,,1,2,3,3,0,0,1,1,2,1.6,14.0,Rodney McGruder,1,1,1.0
6428,10/31/2022,28.55890410958904,L,0,18.5,0,3,0.0,0,0,,2,2,1.0,2,2,4,2,1,1,0,1,2,4.6,1.0,Nerlens Noel,0,3,0.0
6429,11/2/2022,28.564383561643837,L,0,13.25,2,4,0.5,0,0,,0,0,,0,3,3,1,0,0,0,2,4,2.8,-7.0,Nerlens Noel,2,4,0.5
6430,11/4/2022,28.56986301369863,L,0,18.716666666666665,1,3,0.333,0,0,,0,0,,0,6,6,0,2,0,3,2,2,0.3,-10.0,Nerlens Noel,1,3,0.3333333333333333
6431,11/9/2022,28.583561643835615,L,0,3.4,1,2,0.5,0,0,,1,2,0.5,0,2,2,0,0,0,0,0,3,2.2,4.0,Nerlens Noel,1,2,0.5
6432,11/18/2022,28.60821917808219,L,0,5.866666666666667,0,0,,0,0,,0,0,,0,3,3,0,2,1,0,3,0,2.4,6.0,Nerlens Noel,0,0,
6433,11/25/2022,28.627397260273973,L,0,2.2666666666666666,0,1,0.0,0,0,,0,0,,1,0,1,0,0,0,0,1,0,-0.4,-3.0,Nerlens Noel,0,1,0.0
6434,10/21/2022,22.942465753424656,L,0,0.95,0,0,,0,0,,0,0,,0,0,0,0,0,0,0,0,0,0.0,2.0,Buddy Boeheim,0,0,
